user_id,previous rating,rating,rating delta,prev rating time,rating time,time delta,previous movie id,movie id,movie average
196,4,3,-1,881251021,881251045,24,306,340,3.7419354838709675
196,3,4,1,881251045,881251143,98,340,1022,3.727272727272727
196,4,3,-1,881251143,881251274,131,1022,251,3.8333333333333335
196,3,3,0,881251274,881251642,368,251,1241,2.6666666666666665
196,3,4,1,881251642,881251702,60,1241,428,3.744186046511628
196,4,3,-1,881251702,881251728,26,428,202,3.730337078651685
196,3,5,2,881251728,881251753,25,202,8,3.903225806451613
196,5,4,-1,881251753,881251793,40,8,111,3.5106382978723403
196,4,4,0,881251793,881251820,27,111,238,3.888888888888889
196,4,3,-1,881251820,881251842,22,238,70,3.5833333333333335
196,3,4,1,881251842,881251843,1,70,382,3.764705882352941
196,4,3,-1,881251843,881251884,41,382,287,3.4516129032258065
196,3,5,2,881251884,881251911,27,287,663,3.948717948717949
196,5,4,-1,881251911,881251954,43,663,845,3.661290322580645
196,4,3,-1,881251954,881251955,1,845,762,3.3962264150943398
196,3,5,2,881251955,881252017,62,762,67,3.106382978723404
196,5,2,-3,881252017,881252056,39,67,580,3.625
196,2,4,2,881252056,881252128,72,580,1118,3.533333333333333
196,4,3,-1,881252128,881252172,44,1118,94,2.8823529411764706
196,3,1,-2,881252172,881252305,133,94,110,2.25
186,5,4,-1,879022927,879023073,146,322,291,3.2
186,4,2,-2,879023073,879023074,1,291,121,3.521212121212121
186,2,4,2,879023074,879023115,41,121,100,4.0162162162162165
186,4,3,-1,879023115,879023152,37,100,983,2.5
186,3,2,-1,879023152,879023242,90,983,118,3.2764227642276422
186,2,3,1,879023242,879023273,31,118,977,2.473684210526316
186,3,4,1,879023273,879023390,117,977,281,3.2
186,4,3,-1,879023390,879023460,70,281,56,4.051724137931035
186,3,5,2,879023460,879023529,69,56,939,3.6333333333333333
186,5,4,-1,879023529,879023556,27,939,55,4.051282051282051
186,4,3,-1,879023556,879023571,15,55,263,2.2
186,3,1,-2,879023571,879023599,28,263,1083,2.3333333333333335
186,1,1,0,879023599,879023607,8,1083,250,3.4698795180722892
186,1,5,4,879023607,879023632,25,250,1042,3.625
186,5,5,0,879023632,879023643,11,1042,1016,3.559322033898305
186,5,5,0,879023643,879023663,20,1016,566,3.543859649122807
186,5,5,0,879023663,879023664,1,566,226,3.378787878787879
186,5,5,0,879023664,879023693,29,226,470,3.72
186,5,5,0,879023693,879023694,1,470,77,3.3857142857142857
186,5,5,0,879023694,879023723,29,77,159,3.3902439024390243
186,5,3,-2,879023723,879023751,28,159,1046,3.3529411764705883
186,3,2,-1,879023751,879023819,68,1046,770,3.25
186,2,3,1,879023819,879023882,63,770,1213,2.0
186,3,4,1,879023882,879023894,12,1213,385,3.6129032258064515
186,4,2,-2,879023894,879023934,40,385,237,3.7315436241610738
186,2,3,1,879023934,879023968,34,237,934,3.0294117647058822
186,3,4,1,879023968,879023985,17,934,550,3.272727272727273
186,4,4,0,879023985,879024014,29,550,540,2.4615384615384617
186,4,3,-1,879024014,879024099,85,540,294,3.1052631578947367
186,3,3,0,879024099,879024212,113,294,1033,3.0
186,3,2,-1,879024212,879024345,133,1033,820,3.0444444444444443
186,2,3,1,879024345,879024346,1,820,1336,1.75
186,3,4,1,879024346,879024459,113,1336,596,3.180327868852459
186,4,3,-1,879024459,879720962,696503,596,299,3.0
186,3,3,0,879720962,891717742,11996780,299,302,4.133333333333334
186,3,4,1,891717742,891717761,19,302,887,3.5789473684210527
186,4,4,0,891717761,891718038,277,887,330,2.625
186,4,3,-1,891718038,891718820,782,330,333,3.546666666666667
186,3,4,1,891718820,891719775,955,333,988,2.5555555555555554
186,4,5,1,891719775,891719859,84,988,98,4.240875912408759
22,1,1,0,878886262,878886307,45,294,683,2.176470588235294
22,1,3,2,878886307,878886333,26,683,1000,3.3333333333333335
22,3,5,2,878886333,878886368,35,1000,186,3.905263157894737
22,5,4,-1,878886368,878886423,55,186,154,3.6031746031746033
22,4,4,0,878886423,878886449,26,154,201,3.75
22,4,4,0,878886449,878886480,31,201,692,3.56
22,4,5,1,878886480,878886517,37,692,168,4.0476190476190474
22,5,4,-1,878886517,878886518,1,168,209,3.8275862068965516
22,4,5,1,878886518,878886571,53,209,4,3.5538461538461537
22,5,5,0,878886571,878886607,36,4,208,3.8125
22,5,4,-1,878886607,878886647,40,208,792,3.793103448275862
22,4,4,0,878886647,878886682,35,792,216,3.8454545454545452
22,4,4,0,878886682,878886710,28,216,109,3.282608695652174
22,4,4,0,878886710,878886750,40,109,21,2.9210526315789473
22,4,4,0,878886750,878886902,152,21,999,2.75
22,4,5,1,878886902,878886989,87,999,85,3.3157894736842106
22,5,3,-2,878886989,878887023,34,85,167,2.8181818181818183
22,3,1,-2,878887023,878887062,39,167,926,2.7857142857142856
22,1,3,2,878887062,878887112,50,926,376,2.9166666666666665
22,3,1,-2,878887112,878887116,4,376,377,1.75
22,1,4,3,878887116,878887157,41,377,399,3.317073170731707
22,4,1,-3,878887157,878887158,1,399,996,2.1666666666666665
22,1,4,3,878887158,878887186,28,996,712,3.0434782608695654
22,4,1,-3,878887186,878887347,161,712,105,2.6176470588235294
22,1,3,2,878887347,878887413,66,105,384,2.7941176470588234
22,3,5,2,878887413,878887443,30,384,358,2.6551724137931036
22,5,1,-4,878887443,878887476,33,358,687,2.1481481481481484
22,1,1,0,878887476,878887553,77,687,948,2.2962962962962963
22,1,5,4,878887553,878887810,257,948,403,3.298507462686567
22,5,4,-1,878887810,878887869,59,403,117,3.689189189189189
22,4,2,-2,878887869,878887983,114,117,231,2.938775510204082
22,2,3,1,878887983,878888025,42,231,241,3.5625
22,3,4,1,878888025,878888026,1,241,230,3.3518518518518516
22,4,3,-1,878888026,878888066,40,230,233,3.323529411764706
22,3,4,1,878888066,878888067,1,233,227,3.169811320754717
22,4,3,-1,878888067,878888106,39,227,636,3.4146341463414633
22,3,4,1,878888106,878888145,39,636,226,3.378787878787879
22,4,1,-3,878888145,878888228,83,226,29,2.5714285714285716
22,1,5,4,878888228,878888251,23,29,250,3.4698795180722892
244,4,4,0,880601905,880601937,32,324,772,3.3333333333333335
244,4,5,1,880601937,880602002,65,772,856,4.142857142857143
244,5,5,0,880602002,880602031,29,856,721,3.4583333333333335
244,5,5,0,880602031,880602058,27,721,42,3.893617021276596
244,5,5,0,880602058,880602083,25,42,317,3.774193548387097
244,5,5,0,880602083,880602132,49,317,1045,3.2
244,5,5,0,880602132,880602170,38,1045,68,3.5714285714285716
244,5,5,0,880602170,880602210,40,68,89,3.9615384615384617
244,5,1,-4,880602210,880602264,54,89,226,3.378787878787879
244,1,5,4,880602264,880602334,70,226,237,3.7315436241610738
244,5,4,-1,880602334,880602478,144,237,92,3.7142857142857144
244,4,4,0,880602478,880602517,39,92,156,4.017857142857143
244,4,4,0,880602517,880602558,41,156,7,3.76056338028169
244,4,5,1,880602558,880602593,35,7,537,3.5
244,5,4,-1,880602593,880602843,250,537,780,3.08
244,4,4,0,880602843,880602893,50,780,241,3.5625
244,4,5,1,880602893,880603082,189,241,318,4.5046728971962615
244,5,4,-1,880603082,880603219,137,318,114,4.3478260869565215
244,4,4,0,880603219,880603242,23,114,215,3.662921348314607
244,4,4,0,880603242,880603411,169,215,1428,3.2857142857142856
244,4,1,-3,880603411,880603442,31,1428,367,3.4242424242424243
244,1,4,3,880603442,880603512,70,367,77,3.3857142857142857
244,4,4,0,880603512,880603582,70,77,475,3.956043956043956
244,4,4,0,880603582,880603618,36,475,941,3.5
244,4,4,0,880603618,880603645,27,941,69,3.8015873015873014
244,4,5,1,880603645,880603683,38,69,433,3.8035714285714284
244,5,5,0,880603683,880603833,150,433,179,3.8823529411764706
244,5,4,-1,880603833,880603960,127,179,754,3.5789473684210527
244,4,3,-1,880603960,880604004,44,754,739,3.391304347826087
244,3,2,-1,880604004,880604077,73,739,255,3.2027027027027026
244,2,4,2,880604077,880604119,42,255,157,3.5714285714285716
244,4,1,-3,880604119,880604148,29,157,732,3.6266666666666665
244,1,5,4,880604148,880604179,31,732,9,3.8878504672897196
244,5,4,-1,880604179,880604195,16,9,1150,3.0
244,4,4,0,880604195,880604252,57,1150,100,4.0162162162162165
244,4,4,0,880604252,880604276,24,100,508,3.6923076923076925
244,4,4,0,880604276,880604302,26,508,126,3.8620689655172415
244,4,5,1,880604302,880604326,24,126,151,3.6544117647058822
244,5,4,-1,880604326,880604346,20,151,628,3.573529411764706
244,4,4,0,880604346,880604379,33,628,13,3.5454545454545454
244,4,4,0,880604379,880604583,204,13,1017,3.0
244,4,3,-1,880604583,880604616,33,1017,762,3.3962264150943398
244,3,2,-1,880604616,880604642,26,762,685,3.2666666666666666
244,2,2,0,880604642,880604698,56,685,117,3.689189189189189
244,2,4,2,880604698,880604735,37,117,596,3.180327868852459
244,4,4,0,880604735,880604798,63,596,411,2.911764705882353
244,4,1,-3,880604798,880604910,112,411,235,3.106382978723404
244,1,4,3,880604910,880604930,20,235,249,3.3275862068965516
244,4,2,-2,880604930,880604981,51,249,118,3.2764227642276422
244,2,2,0,880604981,880605071,90,118,148,3.2131147540983607
244,2,5,3,880605071,880605131,60,148,866,3.3962264150943398
244,5,4,-1,880605131,880605132,1,866,1132,2.588235294117647
244,4,5,1,880605132,880605158,26,1132,764,3.1176470588235294
244,5,4,-1,880605158,880605185,27,764,815,3.135135135135135
244,4,2,-2,880605185,880605264,79,815,1047,2.6923076923076925
244,2,5,3,880605264,880605416,152,1047,196,3.9404761904761907
244,5,3,-2,880605416,880605438,22,196,58,3.543859649122807
244,3,4,1,880605438,880605458,20,58,173,4.1441441441441444
244,4,4,0,880605458,880605485,27,173,209,3.8275862068965516
244,4,2,-2,880605485,880605514,29,209,97,3.7282608695652173
244,2,5,3,880605514,880605553,39,97,1467,5.0
244,5,5,0,880605553,880605638,85,1467,64,4.373737373737374
244,5,5,0,880605638,880605766,128,64,191,4.168674698795181
244,5,4,-1,880605766,880605838,72,191,197,4.112676056338028
244,4,4,0,880605838,880605869,31,197,216,3.8454545454545452
244,4,3,-1,880605869,880605896,27,216,174,4.253521126760563
244,3,5,2,880605896,880606017,121,174,509,3.7058823529411766
244,5,4,-1,880606017,880606069,52,509,651,3.8627450980392157
244,4,5,1,880606069,880606118,49,651,238,3.888888888888889
244,5,3,-2,880606118,880606180,62,238,746,3.7560975609756095
244,3,4,1,880606180,880606243,63,746,707,3.909090909090909
244,4,1,-3,880606243,880606274,31,707,950,2.625
244,1,5,4,880606274,880606385,111,950,171,4.090909090909091
244,5,4,-1,880606385,880606418,33,171,95,3.8194444444444446
244,4,4,0,880606418,880606476,58,95,52,3.727272727272727
244,4,5,1,880606476,880606533,57,52,652,3.9642857142857144
244,5,4,-1,880606533,880606567,34,652,1048,2.857142857142857
244,4,3,-1,880606567,880606634,67,1048,845,3.661290322580645
244,3,5,2,880606634,880606698,64,845,200,3.8157894736842106
244,5,4,-1,880606698,880606760,62,200,631,3.581818181818182
244,4,4,0,880606760,880606874,114,631,71,3.6575342465753424
244,4,2,-2,880606874,880606923,49,71,51,3.5277777777777777
244,2,1,-1,880606923,880606947,24,51,468,3.380952380952381
244,1,4,3,880606947,880606993,46,468,162,3.4651162790697674
244,4,3,-1,880606993,880607034,41,162,710,3.41025641025641
244,3,4,1,880607034,880607116,82,710,1109,3.4545454545454546
244,4,3,-1,880607116,880607154,38,1109,164,3.6140350877192984
244,3,4,1,880607154,880607231,77,164,708,3.3157894736842106
244,4,2,-2,880607231,880607335,104,708,54,3.3714285714285714
244,2,4,2,880607335,880607365,30,54,72,3.175438596491228
244,4,3,-1,880607365,880607424,59,72,401,2.6774193548387095
244,3,4,1,880607424,880607489,65,401,738,3.0
244,4,4,0,880607489,880607570,81,738,1039,3.9583333333333335
244,4,4,0,880607570,880607683,113,1039,66,3.4705882352941178
244,4,4,0,880607683,880607684,1,66,88,3.433734939759036
244,4,3,-1,880607684,880607878,194,88,833,2.9444444444444446
244,3,4,1,880607878,880607903,25,833,581,3.130434782608696
244,4,3,-1,880607903,880607925,22,581,712,3.0434782608695654
244,3,2,-1,880607925,880608016,91,712,40,2.7037037037037037
244,2,4,2,880608016,880608037,21,40,790,2.8518518518518516
244,4,4,0,880608037,880608087,50,790,1118,3.533333333333333
244,4,4,0,880608087,880608112,25,1118,451,3.207792207792208
244,4,4,0,880608112,880608133,21,451,380,3.4878048780487805
244,4,3,-1,880608133,880608162,29,380,1136,3.3076923076923075
244,3,3,0,880608162,880608315,153,1136,1209,2.3333333333333335
244,3,4,1,880608315,880608670,355,1209,232,3.0789473684210527
244,4,2,-2,880608670,880608699,29,232,1107,2.9
244,2,3,1,880608699,880608733,34,1107,554,2.9555555555555557
244,3,4,1,880608733,880608820,87,554,67,3.106382978723404
244,4,3,-1,880608820,880608904,84,67,158,2.7027027027027026
244,3,3,0,880608904,880608957,53,158,383,2.5
244,3,4,1,880608957,880608992,35,383,1057,2.7142857142857144
244,4,3,-1,880608992,880609089,97,1057,1054,2.5454545454545454
244,3,2,-1,880609089,880609193,104,1054,926,2.7857142857142856
166,3,4,1,886397510,886397562,52,288,258,3.7547169811320753
166,4,1,-3,886397562,886397596,34,258,346,3.5128205128205128
166,1,4,3,886397596,886397665,69,346,751,3.3896103896103895
166,4,5,1,886397665,886397722,57,751,328,3.4895833333333335
166,5,5,0,886397722,886397723,1,328,322,3.0476190476190474
166,5,2,-3,886397723,886397751,28,322,748,3.1043478260869564
166,2,1,-1,886397751,886397777,26,748,687,2.1481481481481484
166,1,5,4,886397777,886397802,25,687,984,2.6666666666666665
166,5,3,-2,886397802,886397827,25,984,243,2.357142857142857
166,3,3,0,886397827,886397855,28,243,688,2.111111111111111
166,3,4,1,886397855,886397882,27,688,343,3.0
166,4,4,0,886397882,886397905,23,343,894,2.0
298,4,4,0,884125022,884125058,36,588,69,3.8015873015873014
298,4,5,1,884125058,884125093,35,69,211,3.958904109589041
298,5,3,-2,884125093,884125553,460,211,742,3.5555555555555554
298,3,5,2,884125553,884125578,25,742,50,4.306532663316583
298,5,4,-1,884125578,884125629,51,50,282,3.610526315789474
298,4,3,-1,884125629,884125672,43,282,275,4.087912087912088
298,3,3,0,884125672,884125912,240,275,125,3.5555555555555554
298,3,5,2,884125912,884126061,149,125,1,3.902439024390244
298,5,4,-1,884126061,884126202,141,1,121,3.521212121212121
298,4,4,0,884126202,884126240,38,121,257,3.7154471544715446
298,4,3,-1,884126240,884126288,48,257,596,3.180327868852459
298,3,3,0,884126288,884127369,1081,596,153,3.7865168539325844
298,3,4,1,884127369,884127690,321,153,199,4.191489361702128
298,4,4,0,884127690,884127720,30,199,265,3.710144927536232
298,4,4,0,884127720,884182148,54428,265,204,3.6744186046511627
298,4,5,1,884182148,884182600,452,204,530,4.125
298,5,4,-1,884182600,884182627,27,530,484,4.116279069767442
298,4,5,1,884182627,884182685,58,484,479,4.25
298,5,5,0,884182685,884182774,89,479,419,3.8208955223880596
298,5,4,-1,884182774,884182806,32,419,317,3.774193548387097
298,4,3,-1,884182806,884182838,32,317,660,3.71875
298,3,3,0,884182838,884182868,30,660,946,3.1153846153846154
298,3,5,2,884182868,884182891,23,946,210,3.921259842519685
298,5,2,-3,884182891,884182932,41,210,91,3.6
298,2,5,3,884182932,884182933,1,91,168,4.0476190476190474
298,5,4,-1,884182933,884182965,32,168,22,4.215909090909091
298,4,5,1,884182965,884182966,1,22,143,3.56
298,5,4,-1,884182966,884182989,23,143,514,4.033333333333333
298,4,5,1,884182989,884183016,27,514,71,3.6575342465753424
298,5,5,0,884183016,884183063,47,71,423,3.7016129032258065
298,5,3,-2,884183063,884183099,36,423,679,3.2432432432432434
298,3,4,1,884183099,884183130,31,679,951,2.6666666666666665
298,4,4,0,884183130,884183237,107,951,503,3.6363636363636362
298,4,4,0,884183237,884183256,19,503,186,3.905263157894737
298,4,4,0,884183256,884183307,51,186,549,3.4871794871794872
298,4,4,0,884183307,884183406,99,549,418,3.825
298,4,4,0,884183406,884183572,166,418,1142,4.0476190476190474
298,4,3,-1,884183572,884183640,68,1142,274,3.5609756097560976
298,3,2,-1,884183640,884183833,193,274,276,3.6036036036036037
298,2,4,2,884183833,884183897,64,276,820,3.0444444444444443
298,4,3,-1,884183897,884183912,15,820,864,3.2142857142857144
298,3,3,0,884183912,884183930,18,864,866,3.3962264150943398
298,3,3,0,884183930,884183952,22,866,473,2.9166666666666665
298,3,3,0,884183952,884184024,72,473,294,3.1052631578947367
115,5,4,-1,881169883,881169984,101,628,696,3.138888888888889
115,4,3,-1,881169984,881170332,348,696,93,3.5641025641025643
115,3,5,2,881170332,881170438,106,93,508,3.6923076923076925
115,5,4,-1,881170438,881170508,70,508,762,3.3962264150943398
115,4,1,-3,881170508,881170663,155,762,596,3.180327868852459
115,1,2,1,881170663,881170725,62,596,763,3.347826086956522
115,2,2,0,881170725,881170791,66,763,471,3.5714285714285716
115,2,4,2,881170791,881170844,53,471,847,3.7333333333333334
115,4,2,-2,881170844,881170902,58,847,284,3.1547619047619047
115,2,5,3,881170902,881170998,96,284,952,3.3529411764705883
115,5,4,-1,881170998,881171009,11,952,117,3.689189189189189
115,4,2,-2,881171009,881171075,66,117,237,3.7315436241610738
115,2,5,3,881171075,881171137,62,237,174,4.253521126760563
115,5,1,-4,881171137,881171203,66,174,496,4.094594594594595
115,1,5,4,881171203,881171409,206,496,654,4.119047619047619
115,5,3,-2,881171409,881171488,79,654,657,4.341463414634147
115,3,5,2,881171488,881171558,70,657,466,3.5
115,5,4,-1,881171558,881171622,64,466,443,3.8421052631578947
115,4,3,-1,881171622,881171623,1,443,218,3.5555555555555554
115,3,2,-1,881171623,881171694,71,218,470,3.72
115,2,5,3,881171694,881171760,66,470,127,4.162790697674419
115,5,1,-4,881171760,881171825,65,127,69,3.8015873015873014
115,1,5,4,881171825,881171983,158,69,13,3.5454545454545454
115,5,4,-1,881171983,881172049,66,13,92,3.7142857142857144
115,4,3,-1,881172049,881172183,134,92,83,4.204081632653061
115,3,5,2,881172183,881172246,63,83,178,4.378378378378378
115,5,2,-3,881172246,881172303,57,178,543,4.166666666666667
253,4,5,1,891627724,891627775,51,300,689,3.1538461538461537
253,5,4,-1,891627775,891627790,15,689,328,3.4895833333333335
253,4,4,0,891627790,891627815,25,328,343,3.0
253,4,4,0,891627815,891627829,14,343,294,3.1052631578947367
253,4,3,-1,891627829,891627878,49,294,1025,2.95
253,3,4,1,891627878,891627893,15,1025,895,3.142857142857143
253,4,4,0,891627893,891628002,109,895,237,3.7315436241610738
253,4,4,0,891628002,891628019,17,237,15,3.725663716814159
253,4,3,-1,891628019,891628033,14,15,125,3.5555555555555554
253,3,5,2,891628033,891628060,27,125,127,4.162790697674419
253,5,3,-2,891628060,891628074,14,127,298,3.779220779220779
253,3,3,0,891628074,891628094,20,298,1016,3.559322033898305
253,3,5,2,891628094,891628122,28,1016,483,4.475609756097561
253,5,4,-1,891628122,891628159,37,483,83,4.204081632653061
253,4,5,1,891628159,891628181,22,83,966,4.7
253,5,4,-1,891628181,891628199,18,966,1039,3.9583333333333335
253,4,3,-1,891628199,891628229,30,1039,56,4.051724137931035
253,3,4,1,891628229,891628252,23,56,234,3.7674418604651163
253,4,3,-1,891628252,891628278,26,234,153,3.7865168539325844
253,3,3,0,891628278,891628295,17,153,82,3.6741573033707864
253,3,4,1,891628295,891628323,28,82,487,4.043478260869565
253,4,5,1,891628323,891628341,18,487,183,3.951219512195122
253,5,5,0,891628341,891628358,17,183,659,4.027777777777778
253,5,3,-2,891628358,891628374,16,659,182,3.842857142857143
253,3,5,2,891628374,891628435,61,182,485,3.717948717948718
253,5,5,0,891628435,891628451,16,485,482,3.9444444444444446
253,5,5,0,891628451,891628467,16,482,465,3.75
253,5,5,0,891628467,891628483,16,465,173,4.1441441441441444
253,5,4,-1,891628483,891628501,18,173,97,3.7282608695652173
253,4,5,1,891628501,891628518,17,97,79,3.956989247311828
253,5,5,0,891628518,891628535,17,79,117,3.689189189189189
253,5,4,-1,891628535,891628578,43,117,566,3.543859649122807
253,4,3,-1,891628578,891628614,36,566,156,4.017857142857143
253,3,3,0,891628614,891628651,37,156,1404,3.875
253,3,4,1,891628651,891628670,19,1404,4,3.5538461538461537
253,4,1,-3,891628670,891628884,214,4,192,4.090909090909091
305,3,4,1,886307860,886307948,88,268,269,4.085106382978723
305,4,5,1,886307948,886307971,23,269,311,3.761904761904762
305,5,4,-1,886307971,886308064,93,311,258,3.7547169811320753
305,4,2,-2,886308064,886308111,47,258,749,3.2777777777777777
305,2,3,1,886308111,886308147,36,749,748,3.1043478260869564
305,3,5,2,886308147,886308168,21,748,315,4.15
305,5,3,-2,886308168,886308252,84,315,338,2.75
305,3,4,1,886308252,886321799,13547,338,181,3.98974358974359
305,4,4,0,886321799,886322150,351,181,298,3.779220779220779
305,4,3,-1,886322150,886322174,24,298,249,3.3275862068965516
305,3,2,-1,886322174,886322212,38,249,1513,2.0
305,2,3,1,886322212,886322560,348,1513,318,4.5046728971962615
305,3,4,1,886322560,886322635,75,318,963,3.9285714285714284
305,4,4,0,886322635,886322670,35,963,154,3.6031746031746033
305,4,4,0,886322670,886322691,21,154,170,4.242424242424242
305,4,3,-1,886322691,886322720,29,170,806,3.6666666666666665
305,3,4,1,886322720,886322758,38,806,223,4.108695652173913
305,4,4,0,886322758,886322838,80,223,947,2.6666666666666665
305,4,4,0,886322838,886322893,55,947,14,4.101694915254237
305,4,5,1,886322893,886322930,37,14,12,4.358974358974359
305,5,4,-1,886322930,886322966,36,12,178,4.378378378378378
305,4,3,-1,886322966,886323006,40,178,195,3.9072164948453607
305,3,5,2,886323006,886323090,84,195,427,4.2025316455696204
305,5,4,-1,886323090,886323115,25,427,713,3.5
305,4,3,-1,886323115,886323153,38,713,153,3.7865168539325844
305,3,5,2,886323153,886323237,84,153,171,4.090909090909091
305,5,2,-3,886323237,886323303,66,171,91,3.6
305,2,3,1,886323303,886323335,32,91,845,3.661290322580645
305,3,4,1,886323335,886323378,43,845,61,4.190476190476191
305,4,4,0,886323378,886323406,28,61,792,3.793103448275862
305,4,3,-1,886323406,886323440,34,792,961,3.4545454545454546
305,3,2,-1,886323440,886323464,24,961,215,3.662921348314607
305,2,2,0,886323464,886323506,42,215,52,3.727272727272727
305,2,5,3,886323506,886323525,19,52,462,3.7954545454545454
305,5,5,0,886323525,886323591,66,462,48,4.055555555555555
305,5,3,-2,886323591,886323648,57,48,100,4.0162162162162165
305,3,3,0,886323648,886323684,36,100,71,3.6575342465753424
305,3,4,1,886323684,886323713,29,71,317,3.774193548387097
305,4,4,0,886323713,886323757,44,317,86,3.869565217391304
305,4,4,0,886323757,886323779,22,86,1104,2.5
305,4,4,0,886323779,886323839,60,1104,176,3.967032967032967
305,4,3,-1,886323839,886323902,63,176,428,3.744186046511628
305,3,4,1,886323902,886323937,35,428,655,3.7857142857142856
305,4,2,-2,886323937,886323966,29,655,88,3.433734939759036
305,2,3,1,886323966,886323998,32,88,201,3.75
305,3,3,0,886323998,886324058,60,201,602,3.533333333333333
305,3,4,1,886324058,886324128,70,602,735,3.58
305,4,4,0,886324128,886324199,71,735,475,3.956043956043956
305,4,5,1,886324199,886324221,22,475,709,4.171428571428572
305,5,3,-2,886324221,886324276,55,709,79,3.956989247311828
305,3,3,0,886324276,886324299,23,79,69,3.8015873015873014
305,3,3,0,886324299,886324330,31,69,686,3.9
305,3,1,-2,886324330,886324362,32,686,960,3.0
305,1,4,3,886324362,886324387,25,960,863,3.727272727272727
305,4,2,-2,886324387,886324462,75,863,664,3.15
305,2,3,1,886324462,886324486,24,664,566,3.543859649122807
305,3,3,0,886324486,886324521,35,566,770,3.25
305,3,2,-1,886324521,886324551,30,770,597,3.2771084337349397
305,2,2,0,886324551,886324580,29,597,2,3.0851063829787235
305,2,4,2,886324580,886324608,28,2,971,4.0
305,4,3,-1,886324608,886324661,53,971,200,3.8157894736842106
305,3,5,2,886324661,886324687,26,200,1286,3.5714285714285716
305,5,5,0,886324687,886324712,25,1286,793,3.0
305,5,3,-2,886324712,886324817,105,793,451,3.207792207792208
305,3,3,0,886324817,886324865,48,451,1411,2.4615384615384617
305,3,3,0,886324865,886324898,33,1411,121,3.521212121212121
305,3,4,1,886324898,886324962,64,121,1456,3.5
305,4,3,-1,886324962,886324963,1,1456,708,3.3157894736842106
305,3,3,0,886324963,886325023,60,708,550,3.272727272727273
6,4,4,0,883268222,883268246,24,302,306,4.033333333333333
6,4,2,-2,883268246,883268278,32,306,340,3.7419354838709675
6,2,3,1,883268278,883268321,43,340,303,3.75
6,3,4,1,883268321,883268322,1,303,304,3.5306122448979593
6,4,3,-1,883268322,883268353,31,304,321,3.0172413793103448
6,3,3,0,883268353,883268406,53,321,268,3.9838709677419355
6,3,2,-1,883268406,883268430,24,268,309,2.3333333333333335
6,2,2,0,883268430,883268483,53,309,538,3.25
6,2,4,2,883268483,883599075,330592,538,408,4.4772727272727275
6,4,2,-2,883599075,883599102,27,408,7,3.76056338028169
6,2,2,0,883599102,883599134,32,7,276,3.6036036036036037
6,2,5,3,883599134,883599176,42,276,100,4.0162162162162165
6,5,4,-1,883599176,883599205,29,100,9,3.8878504672897196
6,4,2,-2,883599205,883599228,23,9,459,3.875
6,2,5,3,883599228,883599249,21,459,14,4.101694915254237
6,5,4,-1,883599249,883599273,24,14,515,4.202898550724638
6,4,3,-1,883599273,883599302,29,515,15,3.725663716814159
6,3,5,2,883599302,883599327,25,15,137,3.9545454545454546
6,5,4,-1,883599327,883599354,27,137,534,4.0
6,4,2,-2,883599354,883599400,46,534,13,3.5454545454545454
6,2,4,2,883599400,883599431,31,13,221,3.6923076923076925
6,4,4,0,883599431,883599478,47,221,1,3.902439024390244
6,4,3,-1,883599478,883599509,31,1,246,4.0
6,3,3,0,883599509,883599530,21,246,508,3.6923076923076925
6,3,3,0,883599530,883599558,28,508,298,3.779220779220779
6,3,2,-1,883599558,883599590,32,298,284,3.1547619047619047
6,2,4,2,883599590,883599707,117,284,410,3.0434782608695654
6,4,4,0,883599707,883599830,123,410,533,3.6
6,4,2,-2,883599830,883599914,84,533,237,3.7315436241610738
6,2,1,-1,883599914,883600003,89,237,472,2.984375
6,1,2,1,883600003,883600004,1,472,460,3.0
6,2,2,0,883600004,883600030,26,460,535,3.380952380952381
6,2,1,-1,883600030,883600066,36,535,405,3.25
6,1,2,1,883600066,883600111,45,405,473,2.9166666666666665
6,2,3,1,883600111,883600152,41,473,21,2.9210526315789473
6,3,1,-2,883600152,883600175,23,21,476,3.1216216216216215
6,1,3,2,883600175,883600445,270,476,308,3.6153846153846154
6,3,4,1,883600445,883600597,152,308,64,4.373737373737374
6,4,3,-1,883600597,883600632,35,64,524,4.166666666666667
6,3,4,1,883600632,883600657,25,524,8,3.903225806451613
6,4,4,0,883600657,883600707,50,8,427,4.2025316455696204
6,4,4,0,883600707,883600747,40,427,531,3.7435897435897436
6,4,5,1,883600747,883600785,38,531,487,4.043478260869565
6,5,4,-1,883600785,883600818,33,487,177,3.875
6,4,4,0,883600818,883600877,59,177,527,3.823529411764706
6,4,3,-1,883600877,883600878,1,527,205,3.717391304347826
6,3,4,1,883600878,883600943,65,205,169,4.548387096774194
6,4,4,0,883600943,883600985,42,169,174,4.253521126760563
6,4,5,1,883600985,883601011,26,174,489,4.076923076923077
6,5,4,-1,883601011,883601053,42,489,12,4.358974358974359
6,4,4,0,883601053,883601088,35,12,191,4.168674698795181
6,4,5,1,883601088,883601089,1,191,492,4.117647058823529
6,5,4,-1,883601089,883601155,66,492,496,4.094594594594595
6,4,4,0,883601155,883601203,48,496,530,4.125
6,4,4,0,883601203,883601277,74,530,537,3.5
6,4,4,0,883601277,883601311,34,537,32,3.7222222222222223
6,4,3,-1,883601311,883601365,54,32,189,3.88
6,3,4,1,883601365,883601366,1,189,495,3.65
6,4,5,1,883601366,883601393,27,495,511,4.096153846153846
6,5,4,-1,883601393,883601459,66,511,529,4.142857142857143
6,4,5,1,883601459,883601500,41,529,483,4.475609756097561
6,5,5,0,883601500,883601528,28,483,523,4.159090909090909
6,5,4,-1,883601528,883601529,1,523,435,3.8933333333333335
6,4,4,0,883601529,883601713,184,435,209,3.8275862068965516
6,4,2,-2,883601713,883602133,420,209,95,3.8194444444444446
6,2,4,2,883602133,883602283,150,95,195,3.9072164948453607
6,4,4,0,883602283,883602422,139,195,505,4.0625
6,4,3,-1,883602422,883602462,40,505,188,3.625
6,3,4,1,883602462,883602501,39,188,274,3.5609756097560976
6,4,4,0,883602501,883602574,73,274,170,4.242424242424242
6,4,3,-1,883602574,883602596,22,170,526,3.909090909090909
6,3,5,2,883602596,883602664,68,526,485,3.717948717948718
6,5,3,-2,883602664,883602690,26,485,470,3.72
6,3,5,2,883602690,883602730,40,470,501,3.289473684210526
6,5,4,-1,883602730,883602762,32,501,478,4.161290322580645
6,4,3,-1,883602762,883602864,102,478,203,3.826923076923077
6,3,3,0,883602864,883602865,1,203,425,3.7027027027027026
6,3,4,1,883602865,883602965,100,425,19,3.9615384615384617
6,4,4,0,883602965,883603013,48,19,153,3.7865168539325844
6,4,3,-1,883603013,883603042,29,153,518,3.5833333333333335
62,4,5,1,879371980,879372060,80,475,1129,3.4444444444444446
62,5,5,0,879372060,879372182,122,1129,276,3.6036036036036037
62,5,5,0,879372182,879372216,34,276,50,4.306532663316583
62,5,4,-1,879372216,879372276,60,50,100,4.0162162162162165
62,4,4,0,879372276,879372277,1,100,508,3.6923076923076925
62,4,4,0,879372277,879372347,70,508,125,3.5555555555555554
62,4,3,-1,879372347,879372383,36,125,845,3.661290322580645
62,3,4,1,879372383,879372418,35,845,181,3.98974358974359
62,4,2,-2,879372418,879372434,16,181,257,3.7154471544715446
62,2,4,2,879372434,879372455,21,257,285,4.181818181818182
62,4,2,-2,879372455,879372479,24,285,249,3.3275862068965516
62,2,5,3,879372479,879372480,1,249,222,3.578125
62,5,3,-2,879372480,879372505,25,222,952,3.3529411764705883
62,3,4,1,879372505,879372563,58,952,117,3.689189189189189
62,4,4,0,879372563,879372598,35,117,283,3.901639344262295
62,4,3,-1,879372598,879372633,35,283,1012,3.2916666666666665
62,3,4,1,879372633,879372634,1,1012,13,3.5454545454545454
62,4,5,1,879372634,879372651,17,13,151,3.6544117647058822
62,5,3,-2,879372651,879372670,19,151,111,3.5106382978723403
62,3,4,1,879372670,879372696,26,111,20,3.375
62,4,2,-2,879372696,879372813,117,20,1,3.902439024390244
62,2,2,0,879372813,879372831,18,1,1128,3.0
62,2,4,2,879372831,879372869,38,1128,1009,3.2962962962962963
62,4,3,-1,879372869,879372870,1,1009,147,3.3142857142857145
62,3,4,1,879372870,879372916,46,147,121,3.521212121212121
62,4,2,-2,879372916,879372936,20,121,1134,2.888888888888889
62,2,2,0,879372936,879372965,29,1134,742,3.5555555555555554
62,2,1,-1,879372965,879373007,42,742,1060,3.235294117647059
62,1,4,3,879373007,879373008,1,1060,1016,3.559322033898305
62,4,4,0,879373008,879373046,38,1016,473,2.9166666666666665
62,4,2,-2,879373046,879373195,149,473,866,3.3962264150943398
62,2,1,-1,879373195,879373215,20,866,294,3.1052631578947367
62,1,2,1,879373215,879373254,39,294,597,3.2771084337349397
62,2,3,1,879373254,879373287,33,597,225,3.0714285714285716
62,3,2,-1,879373287,879373404,117,225,1132,2.588235294117647
62,2,3,1,879373404,879373460,56,1132,21,2.9210526315789473
62,3,1,-2,879373460,879373522,62,21,931,2.2758620689655173
62,1,4,3,879373522,879373543,21,931,98,4.240875912408759
62,4,4,0,879373543,879373568,25,98,114,4.3478260869565215
62,4,4,0,879373568,879373586,18,114,511,4.096153846153846
62,4,5,1,879373586,879373613,27,511,191,4.168674698795181
62,5,5,0,879373613,879373659,46,191,318,4.5046728971962615
62,5,5,0,879373659,879373711,52,318,56,4.051724137931035
62,5,2,-3,879373711,879373737,26,56,462,3.7954545454545454
62,2,4,2,879373737,879373768,31,462,134,4.174603174603175
62,4,5,1,879373768,879373794,26,134,172,4.225225225225225
62,5,2,-3,879373794,879373795,1,172,97,3.7282608695652173
62,2,5,3,879373795,879373820,25,97,8,3.903225806451613
62,5,4,-1,879373820,879373821,1,8,59,4.0
62,4,4,0,879373821,879373848,27,59,498,4.290909090909091
62,4,4,0,879373848,879373849,1,498,209,3.8275862068965516
62,4,5,1,879373849,879373960,111,209,195,3.9072164948453607
62,5,4,-1,879373960,879373984,24,195,180,3.9473684210526314
62,4,4,0,879373984,879374015,31,180,69,3.8015873015873014
62,4,4,0,879374015,879374045,30,69,76,3.1875
62,4,4,0,879374045,879374072,27,76,955,3.2666666666666666
62,4,3,-1,879374072,879374142,70,955,44,3.1333333333333333
62,3,5,2,879374142,879374640,498,44,89,3.9615384615384617
62,5,4,-1,879374640,879374661,21,89,71,3.6575342465753424
62,4,5,1,879374661,879374732,71,71,173,4.1441441441441444
62,5,4,-1,879374732,879374752,20,173,1073,3.6315789473684212
62,4,4,0,879374752,879374753,1,1073,582,3.7457627118644066
62,4,3,-1,879374753,879374785,32,582,466,3.5
62,3,3,0,879374785,879374813,28,466,514,4.033333333333333
62,3,4,1,879374813,879374835,22,514,96,3.9130434782608696
62,4,2,-2,879374835,879374866,31,96,128,3.45
62,2,4,2,879374866,879374893,27,128,183,3.951219512195122
62,4,4,0,879374893,879374894,1,183,512,3.888888888888889
62,4,4,0,879374894,879374916,22,512,174,4.253521126760563
62,4,5,1,879374916,879374946,30,174,164,3.6140350877192984
62,5,2,-3,879374946,879374969,23,164,431,3.422222222222222
62,2,5,3,879374969,879375000,31,431,83,4.204081632653061
62,5,4,-1,879375000,879375022,22,83,699,3.736842105263158
62,4,5,1,879375022,879375080,58,699,528,4.241379310344827
62,5,3,-2,879375080,879375247,167,528,1131,3.6666666666666665
62,3,4,1,879375247,879375269,22,1131,959,3.4583333333333335
62,4,2,-2,879375269,879375287,18,959,921,3.611111111111111
62,2,4,2,879375287,879375323,36,921,213,3.943396226415094
62,4,3,-1,879375323,879375364,41,213,605,3.3333333333333335
62,3,3,0,879375364,879375391,27,605,815,3.135135135135135
62,3,4,1,879375391,879375414,23,815,82,3.6741573033707864
62,4,3,-1,879375414,879375453,39,82,710,3.41025641025641
62,3,2,-1,879375453,879375454,1,710,739,3.391304347826087
62,2,2,0,879375454,879375477,23,739,704,3.125
62,2,3,1,879375477,879375537,60,704,1118,3.533333333333333
62,3,1,-2,879375537,879375562,25,1118,554,2.9555555555555557
62,1,4,3,879375562,879375588,26,554,403,3.298507462686567
62,4,3,-1,879375588,879375606,18,403,1018,3.0714285714285716
62,3,3,0,879375606,879375676,70,1018,207,3.4761904761904763
62,3,2,-1,879375676,879375738,62,207,230,3.3518518518518516
62,2,3,1,879375738,879375762,24,230,159,3.3902439024390243
62,3,4,1,879375762,879375843,81,159,162,3.4651162790697674
62,4,2,-2,879375843,879375883,40,162,448,3.466666666666667
62,2,3,1,879375883,879375912,29,448,708,3.3157894736842106
62,3,3,0,879375912,879375977,65,708,232,3.0789473684210527
62,3,4,1,879375977,879376079,102,232,664,3.15
62,4,2,-2,879376079,879376096,17,664,365,2.95
62,2,1,-1,879376096,879376158,62,365,569,2.4285714285714284
62,1,1,0,879376158,879376159,1,569,1107,2.9
62,1,4,3,879376159,879376210,51,1107,949,3.392857142857143
62,4,2,-2,879376210,879376270,60,949,53,2.9523809523809526
62,2,4,2,879376270,879376299,29,53,1074,2.857142857142857
62,4,2,-2,879376299,879376387,88,1074,217,3.1538461538461537
62,2,1,-1,879376387,879376483,96,217,774,3.0
62,1,3,2,879376483,879376535,52,774,541,2.9473684210526314
62,3,2,-1,879376535,879376612,77,541,78,2.3636363636363638
62,2,1,-1,879376612,879376633,21,78,155,3.0588235294117645
62,1,4,3,879376633,879376686,53,155,1130,4.0
62,4,3,-1,879376686,879376709,23,1130,1091,2.5384615384615383
62,3,2,-1,879376709,879376727,18,1091,167,2.8181818181818183
286,5,3,-2,875806800,875806837,37,248,257,3.7154471544715446
286,3,3,0,875806837,875806869,32,257,596,3.180327868852459
286,3,4,1,875806869,875807003,134,596,235,3.106382978723404
286,4,4,0,875807003,875807004,1,235,298,3.779220779220779
286,4,4,0,875807004,875807074,70,298,475,3.956043956043956
286,4,2,-2,875807074,876521650,714576,475,117,3.689189189189189
286,2,5,3,876521650,876521678,28,117,251,3.8333333333333335
286,5,4,-1,876521678,876521699,21,251,1,3.902439024390244
286,4,5,1,876521699,876521700,1,1,278,3.0357142857142856
286,5,3,-2,876521700,876521773,73,278,477,3.1666666666666665
286,3,3,0,876521773,876521809,36,477,16,3.411764705882353
286,3,3,0,876521809,876521835,26,16,819,2.6666666666666665
286,3,4,1,876521835,876521858,23,819,20,3.375
286,4,4,0,876521858,876521887,29,20,250,3.4698795180722892
286,4,2,-2,876521887,876521917,30,250,274,3.5609756097560976
286,2,2,0,876521917,876521933,16,274,13,3.5454545454545454
286,2,3,1,876521933,876521966,33,13,815,3.135135135135135
286,3,4,1,876521966,876521993,27,815,476,3.1216216216216215
286,4,2,-2,876521993,876522008,15,476,762,3.3962264150943398
286,2,1,-1,876522008,876522026,18,762,1047,2.6923076923076925
286,1,3,2,876522026,876522072,46,1047,290,3.108108108108108
286,3,4,1,876522072,876522098,26,290,929,2.8421052631578947
286,4,2,-2,876522098,876522133,35,929,411,2.911764705882353
286,2,3,1,876522133,876522150,17,411,405,3.25
286,3,3,0,876522150,876522166,16,405,121,3.521212121212121
286,3,3,0,876522166,876522185,19,121,1202,3.6666666666666665
286,3,1,-2,876522185,876522200,15,1202,824,2.590909090909091
286,1,2,1,876522200,876522240,40,824,930,2.793103448275862
286,2,4,2,876522240,876522261,21,930,1051,3.625
286,4,3,-1,876522261,876522340,79,1051,472,2.984375
286,3,3,0,876522340,876522360,20,472,597,3.2771084337349397
286,3,4,1,876522360,877530570,1008210,597,127,4.162790697674419
286,4,2,-2,877530570,877531281,711,127,818,2.769230769230769
286,2,5,3,877531281,877531406,125,818,153,3.7865168539325844
286,5,5,0,877531406,877531407,1,153,95,3.8194444444444446
286,5,2,-3,877531407,877531469,62,95,56,4.051724137931035
286,2,3,1,877531469,877531498,29,56,642,3.4285714285714284
286,3,4,1,877531498,877531537,39,642,174,4.253521126760563
286,4,5,1,877531537,877531574,37,174,367,3.4242424242424243
286,5,5,0,877531574,877531661,87,367,629,3.3333333333333335
286,5,4,-1,877531661,877531691,30,629,209,3.8275862068965516
286,4,5,1,877531691,877531730,39,209,1039,3.9583333333333335
286,5,4,-1,877531730,877531760,30,1039,168,4.0476190476190474
286,4,5,1,877531760,877531830,70,168,382,3.764705882352941
286,5,5,0,877531830,877531899,69,382,4,3.5538461538461537
286,5,4,-1,877531899,877531942,43,4,208,3.8125
286,4,5,1,877531942,877531975,33,208,83,4.204081632653061
286,5,2,-3,877531975,877532013,38,83,425,3.7027027027027026
286,2,3,1,877532013,877532094,81,425,1035,3.03125
286,3,5,2,877532094,877532131,37,1035,588,3.8358208955223883
286,5,3,-2,877532131,877532173,42,588,44,3.1333333333333333
286,3,4,1,877532173,877532204,31,44,202,3.730337078651685
286,4,5,1,877532204,877532303,99,202,428,3.744186046511628
286,5,3,-2,877532303,877532329,26,428,721,3.4583333333333335
286,3,4,1,877532329,877532385,56,721,423,3.7016129032258065
286,4,4,0,877532385,877532419,34,423,737,3.12
286,4,5,1,877532419,877532470,51,737,175,3.8354430379746836
286,5,5,0,877532470,877532715,245,175,1101,3.793103448275862
286,5,4,-1,877532715,877532748,33,1101,709,4.171428571428572
286,4,4,0,877532748,877532777,29,709,781,3.4166666666666665
286,4,4,0,877532777,877532889,112,781,22,4.215909090909091
286,4,2,-2,877532889,877532930,41,22,461,3.3333333333333335
286,2,5,3,877532930,877532965,35,461,73,3.588235294117647
286,5,3,-2,877532965,877533001,36,73,77,3.3857142857142857
286,3,4,1,877533001,877533058,57,77,746,3.7560975609756095
286,4,2,-2,877533058,877533101,43,746,512,3.888888888888889
286,2,3,1,877533101,877533185,84,512,636,3.4146341463414633
286,3,5,2,877533185,877533224,39,636,85,3.3157894736842106
286,5,4,-1,877533224,877533381,157,85,89,3.9615384615384617
286,4,3,-1,877533381,877533447,66,89,217,3.1538461538461537
286,3,3,0,877533447,877533472,25,217,158,2.7027027027027026
286,3,2,-1,877533472,877533506,34,158,53,2.9523809523809526
286,2,4,2,877533506,877533586,80,53,66,3.4705882352941178
286,4,4,0,877533586,877533640,54,66,155,3.0588235294117645
286,4,2,-2,877533640,877533698,58,155,856,4.142857142857143
286,2,5,3,877533698,877533771,73,856,379,3.35
286,5,4,-1,877533771,877533796,25,379,747,3.5526315789473686
286,4,5,1,877533796,877533914,118,747,955,3.2666666666666666
286,5,3,-2,877533914,877534054,140,955,1119,3.5185185185185186
286,3,4,1,877534054,877534081,27,1119,559,3.477272727272727
286,4,3,-1,877534081,877534107,26,559,1113,3.0
286,3,4,1,877534107,877534137,30,1113,1133,3.076923076923077
286,4,3,-1,877534137,877534216,79,1133,402,3.3076923076923075
286,3,4,1,877534216,877534313,97,402,569,2.4285714285714284
286,4,4,0,877534313,877534414,101,569,396,2.84
286,4,3,-1,877534414,877534506,92,396,184,3.393939393939394
286,3,5,2,877534506,877534528,22,184,800,3.2222222222222223
286,5,4,-1,877534528,877534550,22,800,821,3.076923076923077
286,4,4,0,877534550,877534618,68,821,195,3.9072164948453607
286,4,5,1,877534618,877534701,83,195,34,3.2
286,5,5,0,877534701,877534771,70,34,394,3.5714285714285716
286,5,4,-1,877534771,877534793,22,394,142,3.1481481481481484
286,4,4,0,877534793,877534824,31,142,40,2.7037037037037037
286,4,4,0,877534824,877534859,35,40,1091,2.5384615384615383
286,4,3,-1,877534859,877534975,116,1091,386,2.769230769230769
286,3,3,0,877534975,877535072,97,386,552,2.8095238095238093
286,3,2,-1,877535072,877535119,47,552,771,2.5714285714285716
286,2,1,-1,877535119,877535157,38,771,1230,1.8888888888888888
286,1,1,0,877535157,877535208,51,1230,790,2.8518518518518516
286,1,2,1,877535208,877535323,115,790,41,3.0625
286,2,2,0,877535323,877535425,102,41,1411,2.4615384615384617
286,2,2,0,877535425,877535500,75,1411,577,1.7058823529411764
286,2,5,3,877535500,878142001,606501,577,969,3.8947368421052633
286,5,4,-1,878142001,879780905,1638904,969,340,3.7419354838709675
286,4,4,0,879780905,884069337,4288432,340,345,3.4782608695652173
286,4,4,0,884069337,884069415,78,345,312,3.0
286,4,5,1,884069415,884069544,129,312,906,3.8333333333333335
286,5,3,-2,884069544,889651060,5581516,906,749,3.2777777777777777
286,3,5,2,889651060,889651121,61,749,316,4.285714285714286
286,5,5,0,889651121,889651138,17,316,315,4.15
286,5,4,-1,889651138,889651402,264,315,537,3.5
286,4,4,0,889651402,889651549,147,537,172,4.225225225225225
286,4,3,-1,889651549,889651576,27,172,228,3.7246376811594204
286,3,1,-2,889651576,889651605,29,228,214,3.272727272727273
286,1,4,3,889651605,889651672,67,214,710,3.41025641025641
286,4,5,1,889651672,889651698,26,710,465,3.75
286,5,3,-2,889651698,889651746,48,465,655,3.7857142857142856
286,3,5,2,889651746,889651799,53,655,404,3.6578947368421053
286,5,1,-4,889651799,889651848,49,404,421,3.462962962962963
286,1,5,4,889651848,889651990,142,421,419,3.8208955223880596
286,5,1,-4,889651990,889652291,301,419,229,3.185185185185185
286,1,1,0,889652291,889652378,87,229,455,3.1702127659574466
286,1,3,2,889652378,889652740,362,455,728,3.05
286,3,4,1,889652740,889652912,172,728,1074,2.857142857142857
286,4,3,-1,889652912,889652968,56,1074,768,3.238095238095238
286,3,5,2,889652968,889652989,21,768,1060,3.235294117647059
286,5,3,-2,889652989,889653012,23,1060,139,2.7222222222222223
286,3,3,0,889653012,889653107,95,139,934,3.0294117647058822
200,5,5,0,876041719,876041895,176,325,276,3.6036036036036037
200,5,3,-2,876041895,876042204,309,276,410,3.0434782608695654
200,3,4,1,876042204,876042234,30,410,25,3.3185840707964602
200,4,5,1,876042234,876042268,34,25,117,3.689189189189189
200,5,4,-1,876042268,876042299,31,117,225,3.0714285714285716
200,4,4,0,876042299,876042340,41,225,148,3.2131147540983607
200,4,5,1,876042340,876042368,28,148,924,3.3703703703703702
200,5,5,0,876042368,876042451,83,924,147,3.3142857142857145
200,5,3,-2,876042451,876042493,42,147,756,2.6885245901639343
200,3,4,1,876042493,876042525,32,756,840,3.090909090909091
200,4,4,0,876042525,876042556,31,840,826,2.5555555555555554
200,4,4,0,876042556,876042584,28,826,596,3.180327868852459
200,4,4,0,876042584,876042753,169,596,760,2.35
200,4,3,-1,876042753,876042922,169,760,1049,2.5714285714285716
200,3,4,1,876042922,876042979,57,1049,929,2.8421052631578947
200,4,5,1,876042979,884125846,8082867,929,288,3.5214285714285714
200,5,4,-1,884125846,884125953,107,288,286,3.442857142857143
200,4,3,-1,884125953,884125973,20,286,323,3.0
200,3,3,0,884125973,884125996,23,323,984,2.6666666666666665
200,3,3,0,884125996,884127370,1374,984,758,2.2857142857142856
200,3,2,-1,884127370,884127431,61,758,409,2.9615384615384617
200,2,4,2,884127431,884127568,137,409,123,3.297872340425532
200,4,4,0,884127568,884127745,177,123,282,3.610526315789474
200,4,4,0,884127745,884127798,53,282,280,3.103448275862069
200,4,4,0,884127798,884127890,92,280,472,2.984375
200,4,3,-1,884127890,884128022,132,472,107,3.45
200,3,2,-1,884128022,884128176,154,107,1028,2.857142857142857
200,2,4,2,884128176,884128400,224,1028,135,3.7974683544303796
200,4,5,1,884128400,884128426,26,135,174,4.253521126760563
200,5,5,0,884128426,884128458,32,174,318,4.5046728971962615
200,5,5,0,884128458,884128499,41,318,79,3.956989247311828
200,5,5,0,884128499,884128554,55,79,183,3.951219512195122
200,5,5,0,884128554,884128788,234,183,69,3.8015873015873014
200,5,5,0,884128788,884128822,34,69,169,4.548387096774194
200,5,5,0,884128822,884128904,82,169,496,4.094594594594595
200,5,5,0,884128904,884128933,29,496,210,3.921259842519685
200,5,5,0,884128933,884128979,46,210,95,3.8194444444444446
200,5,5,0,884128979,884129006,27,95,431,3.422222222222222
200,5,3,-2,884129006,884129092,86,431,495,3.65
200,3,4,1,884129092,884129112,20,495,465,3.75
200,4,4,0,884129112,884129160,48,465,188,3.625
200,4,3,-1,884129160,884129209,49,188,660,3.71875
200,3,4,1,884129209,884129232,23,660,419,3.8208955223880596
200,4,5,1,884129232,884129275,43,419,423,3.7016129032258065
200,5,5,0,884129275,884129301,26,423,378,3.6904761904761907
200,5,4,-1,884129301,884129346,45,378,215,3.662921348314607
200,4,4,0,884129346,884129381,35,215,234,3.7674418604651163
200,4,5,1,884129381,884129410,29,234,218,3.5555555555555554
200,5,4,-1,884129410,884129504,94,218,501,3.289473684210526
200,4,4,0,884129504,884129567,63,501,549,3.4871794871794872
200,4,4,0,884129567,884129602,35,549,509,3.7058823529411766
200,4,5,1,884129602,884129627,25,509,176,3.967032967032967
200,5,4,-1,884129627,884129656,29,176,177,3.875
200,4,5,1,884129656,884129696,40,177,385,3.6129032258064515
200,5,5,0,884129696,884129729,33,385,755,3.085714285714286
200,5,4,-1,884129729,884129782,53,755,582,3.7457627118644066
200,4,3,-1,884129782,884129814,32,582,43,3.1
200,3,5,2,884129814,884129837,23,43,420,3.5652173913043477
200,5,4,-1,884129837,884129920,83,420,54,3.3714285714285714
200,4,5,1,884129920,884129962,42,54,365,2.95
200,5,5,0,884129962,884130014,52,365,951,2.6666666666666665
200,5,4,-1,884130014,884130046,32,951,94,2.8823529411764706
200,4,2,-2,884130046,884130114,68,94,580,3.625
200,2,5,3,884130114,884130146,32,580,62,3.048780487804878
200,5,3,-2,884130146,884130289,143,62,1411,2.4615384615384617
200,3,4,1,884130289,884130348,59,1411,674,2.6875
200,4,4,0,884130348,884130391,43,674,586,2.875
200,4,4,0,884130391,884130415,24,586,576,3.125
200,4,3,-1,884130415,884130484,69,576,1139,2.611111111111111
200,3,4,1,884130484,884130485,1,1139,802,3.076923076923077
200,4,4,0,884130485,884130592,107,802,768,3.238095238095238
200,4,4,0,884130592,884130621,29,768,665,2.72972972972973
200,4,4,0,884130621,884130655,34,665,560,3.111111111111111
200,4,4,0,884130655,884130679,24,560,231,2.938775510204082
200,4,4,0,884130679,884130721,42,231,771,2.5714285714285716
200,4,4,0,884130721,884130754,33,771,373,3.142857142857143
200,4,5,1,884130754,884130792,38,373,132,3.929411764705882
200,5,2,-3,884130792,891825441,7694649,132,1033,3.0
200,2,4,2,891825441,891825565,124,1033,831,2.6097560975609757
200,4,3,-1,891825565,891825607,42,831,743,1.9545454545454546
200,3,3,0,891825607,891825627,20,743,931,2.2758620689655173
210,5,5,0,887730102,887730297,195,23,153,3.7865168539325844
210,5,4,-1,887730297,887730342,45,153,517,3.625
210,4,4,0,887730342,887730443,101,517,4,3.5538461538461537
210,4,4,0,887730443,887730472,29,4,523,4.159090909090909
210,4,5,1,887730472,887730496,24,523,655,3.7857142857142856
210,5,4,-1,887730496,887730589,93,655,70,3.5833333333333335
210,4,5,1,887730589,887730676,87,70,274,3.5609756097560976
210,5,5,0,887730676,887730789,113,274,257,3.7154471544715446
210,5,3,-2,887730789,887730842,53,257,235,3.106382978723404
210,3,2,-1,887730842,887730909,67,235,926,2.7857142857142856
210,2,3,1,887730909,887730931,22,926,411,2.911764705882353
210,3,5,2,887730931,887731014,83,411,50,4.306532663316583
210,5,5,0,887731014,887731052,38,50,1,3.902439024390244
210,5,5,0,887731052,887731082,30,1,181,3.98974358974359
210,5,5,0,887731082,887731147,65,181,276,3.6036036036036037
210,5,5,0,887731147,887731230,83,276,127,4.162790697674419
210,5,4,-1,887731230,887731305,75,127,65,3.511111111111111
210,4,5,1,887731305,887731391,86,65,708,3.3157894736842106
210,5,5,0,887731391,887731417,26,708,315,4.15
210,5,4,-1,887731417,887731435,18,315,301,3.2465753424657535
210,4,4,0,887731435,887735960,4525,301,568,3.5853658536585367
210,4,5,1,887735960,887736017,57,568,187,4.215189873417722
210,5,5,0,887736017,887736045,28,187,174,4.253521126760563
210,5,5,0,887736045,887736070,25,174,134,4.174603174603175
210,5,4,-1,887736070,887736140,70,134,651,3.8627450980392157
210,4,4,0,887736140,887736175,35,651,28,3.923076923076923
210,4,4,0,887736175,887736206,31,28,132,3.929411764705882
210,4,5,1,887736206,887736261,55,132,172,4.225225225225225
210,5,4,-1,887736261,887736322,61,172,403,3.298507462686567
210,4,4,0,887736322,887736352,30,403,79,3.956989247311828
210,4,4,0,887736352,887736393,41,79,205,3.717391304347826
210,4,3,-1,887736393,887736429,36,205,179,3.8823529411764706
210,3,5,2,887736429,887736454,25,179,97,3.7282608695652173
210,5,5,0,887736454,887736482,28,97,483,4.475609756097561
210,5,4,-1,887736482,887736616,134,483,96,3.9130434782608696
210,4,5,1,887736616,887736739,123,96,404,3.6578947368421053
210,5,4,-1,887736739,887736796,57,404,692,3.56
210,4,3,-1,887736796,887736900,104,692,956,3.5714285714285716
210,3,4,1,887736900,887736937,37,956,99,3.8392857142857144
210,4,4,0,887736937,887736998,61,99,501,3.289473684210526
210,4,5,1,887736998,887737040,42,501,200,3.8157894736842106
210,5,4,-1,887737040,887737108,68,200,234,3.7674418604651163
210,4,3,-1,887737108,887737171,63,234,684,3.847826086956522
210,3,4,1,887737171,887737210,39,684,160,3.4
210,4,4,0,887737210,887737244,34,160,121,3.521212121212121
210,4,4,0,887737244,887737338,94,121,735,3.58
210,4,3,-1,887737338,887737488,150,735,953,3.076923076923077
210,3,4,1,887737488,887737603,115,953,216,3.8454545454545452
210,4,5,1,887737603,887737631,28,216,447,3.46875
210,5,4,-1,887737631,887737678,47,447,419,3.8208955223880596
210,4,3,-1,887737678,887737710,32,419,44,3.1333333333333333
210,3,3,0,887737710,887808619,70909,44,679,3.2432432432432434
210,3,3,0,887808619,891035904,3227285,679,393,3.5125
210,3,3,0,891035904,891035928,24,393,629,3.3333333333333335
210,3,3,0,891035928,891035965,37,629,502,3.272727272727273
210,3,4,1,891035965,891036021,56,502,722,2.9642857142857144
210,4,3,-1,891036021,891036054,33,722,451,3.207792207792208
210,3,3,0,891036054,891036116,62,451,49,3.3
210,3,3,0,891036116,891036310,194,49,72,3.175438596491228
210,3,3,0,891036310,891036331,21,72,105,2.6176470588235294
224,3,3,0,888081913,888081976,63,751,333,3.546666666666667
224,3,2,-1,888081976,888082013,37,333,322,3.0476190476190474
224,2,1,-1,888082013,888082045,32,322,325,2.625
224,1,4,3,888082045,888082071,26,325,326,3.262295081967213
224,4,3,-1,888082071,888082099,28,326,879,3.2291666666666665
224,3,2,-1,888082099,888082134,35,879,321,3.0172413793103448
224,2,2,0,888082134,888082135,1,321,687,2.1481481481481484
224,2,2,0,888082135,888082187,52,687,873,2.7586206896551726
224,2,3,1,888082187,888082246,59,873,689,3.1538461538461537
224,3,3,0,888082246,888082350,104,689,893,2.625
224,3,4,1,888082350,888082468,118,893,178,4.378378378378378
224,4,4,0,888082468,888082495,27,178,526,3.909090909090909
224,4,4,0,888082495,888082552,57,526,193,3.883720930232558
224,4,4,0,888082552,888082612,60,193,215,3.662921348314607
224,4,3,-1,888082612,888082634,22,215,1119,3.5185185185185186
224,3,3,0,888082634,888082658,24,1119,528,4.241379310344827
224,3,4,1,888082658,888082682,24,528,727,3.5517241379310347
224,4,4,0,888082682,888082705,23,727,282,3.610526315789474
224,4,4,0,888082705,888082742,37,282,470,3.72
224,4,2,-2,888082742,888082766,24,470,1045,3.2
224,2,4,2,888082766,888103532,20766,1045,196,3.9404761904761907
224,4,1,-3,888103532,888103671,139,196,135,3.7974683544303796
224,1,4,3,888103671,888103703,32,135,660,3.71875
224,4,3,-1,888103703,888103704,1,660,126,3.8620689655172415
224,3,4,1,888103704,888103729,25,126,222,3.578125
224,4,4,0,888103729,888103775,46,222,378,3.6904761904761907
224,4,3,-1,888103775,888103812,37,378,277,3.6
224,3,1,-2,888103812,888103840,28,277,658,3.393939393939394
224,1,4,3,888103840,888103872,32,658,731,3.4
224,4,1,-3,888103872,888103906,34,731,518,3.5833333333333335
224,1,1,0,888103906,888103942,36,518,556,2.7142857142857144
224,1,4,3,888103942,888103971,29,556,157,3.5714285714285716
224,4,1,-3,888103971,888103999,28,157,149,2.4
224,1,4,3,888103999,888104030,31,149,686,3.9
224,4,3,-1,888104030,888104057,27,686,949,3.392857142857143
224,3,3,0,888104057,888104085,28,949,620,3.0
224,3,3,0,888104085,888104116,31,620,276,3.6036036036036037
224,3,3,0,888104116,888104117,1,276,284,3.1547619047619047
224,3,3,0,888104117,888104153,36,284,26,3.36
224,3,3,0,888104153,888104188,35,26,729,3.3793103448275863
224,3,3,0,888104188,888104219,31,729,1058,3.6
224,3,2,-1,888104219,888104281,62,1058,977,2.473684210526316
224,2,3,1,888104281,888104313,32,977,54,3.3714285714285714
224,3,1,-2,888104313,888104353,40,54,980,3.142857142857143
224,1,4,3,888104353,888104393,40,980,553,3.5
224,4,3,-1,888104393,888104456,63,553,43,3.1
224,3,4,1,888104456,888104457,1,43,51,3.5277777777777777
224,4,1,-3,888104457,888104487,30,51,715,3.257142857142857
224,1,3,2,888104487,888104522,35,715,107,3.45
224,3,4,1,888104522,888104554,32,107,239,3.423076923076923
224,4,3,-1,888104554,888104589,35,239,1381,3.75
303,5,3,-2,879466018,879466065,47,269,324,3.2291666666666665
303,3,5,2,879466065,879466088,23,324,340,3.7419354838709675
303,5,5,0,879466088,879466166,78,340,268,3.9838709677419355
303,5,3,-2,879466166,879466184,18,268,334,3.4210526315789473
303,3,3,0,879466184,879466214,30,334,264,2.65
303,3,5,2,879466214,879466420,206,264,100,4.0162162162162165
303,5,3,-2,879466420,879466421,1,100,87,3.9
303,3,5,2,879466421,879466457,36,87,1039,3.9583333333333335
303,5,5,0,879466457,879466491,34,1039,435,3.8933333333333335
303,5,5,0,879466491,879466523,32,435,127,4.162790697674419
303,5,5,0,879466523,879466572,49,127,98,4.240875912408759
303,5,5,0,879466572,879466604,32,98,216,3.8454545454545452
303,5,5,0,879466604,879466631,27,216,187,4.215189873417722
303,5,5,0,879466631,879466667,36,187,514,4.033333333333333
303,5,5,0,879466667,879466717,50,514,357,4.063291139240507
303,5,5,0,879466717,879466742,25,357,194,4.029411764705882
303,5,4,-1,879466742,879466771,29,194,693,3.6285714285714286
303,4,5,1,879466771,879466795,24,693,483,4.475609756097561
303,5,4,-1,879466795,879466830,35,483,17,3.032258064516129
303,4,5,1,879466830,879466866,36,17,50,4.306532663316583
303,5,4,-1,879466866,879466891,25,50,773,3.1666666666666665
303,4,4,0,879466891,879466937,46,773,653,4.0
303,4,4,0,879466937,879466966,29,653,421,3.462962962962963
303,4,5,1,879466966,879467035,69,421,144,3.9545454545454546
303,5,4,-1,879467035,879467105,70,144,186,3.905263157894737
303,4,4,0,879467105,879467131,26,186,109,3.282608695652174
303,4,4,0,879467131,879467155,24,109,475,3.956043956043956
303,4,5,1,879467155,879467190,35,475,150,3.803921568627451
303,5,4,-1,879467190,879467191,1,150,1073,3.6315789473684212
303,4,5,1,879467191,879467223,32,1073,93,3.5641025641025643
303,5,4,-1,879467223,879467260,37,93,11,3.8904109589041096
303,4,4,0,879467260,879467295,35,11,226,3.378787878787879
303,4,4,0,879467295,879467328,33,226,55,4.051282051282051
303,4,4,0,879467328,879467413,85,55,1286,3.5714285714285716
303,4,4,0,879467413,879467436,23,1286,65,3.511111111111111
303,4,4,0,879467436,879467514,78,65,7,3.76056338028169
303,4,5,1,879467514,879467542,28,7,69,3.8015873015873014
303,5,5,0,879467542,879467573,31,69,201,3.75
303,5,2,-3,879467573,879467638,65,201,125,3.5555555555555554
303,2,2,0,879467638,879467639,1,125,716,3.1904761904761907
303,2,5,3,879467639,879467669,30,716,203,3.826923076923077
303,5,4,-1,879467669,879467670,1,203,559,3.477272727272727
303,4,3,-1,879467670,879467706,36,559,46,3.6666666666666665
303,3,3,0,879467706,879467739,33,46,939,3.6333333333333333
303,3,2,-1,879467739,879467815,76,939,943,3.6666666666666665
303,2,4,2,879467815,879467816,1,943,147,3.3142857142857145
303,4,4,0,879467816,879467895,79,147,276,3.6036036036036037
303,4,5,1,879467895,879467959,64,276,134,4.174603174603175
303,5,4,-1,879467959,879468047,88,134,25,3.3185840707964602
303,4,4,0,879468047,879468082,35,25,591,3.7169811320754715
303,4,4,0,879468082,879468149,67,591,123,3.297872340425532
303,4,3,-1,879468149,879468179,30,123,416,3.3846153846153846
303,3,4,1,879468179,879468414,235,416,568,3.5853658536585367
303,4,4,0,879468414,879468459,45,568,200,3.8157894736842106
303,4,3,-1,879468459,879468513,54,200,1222,2.6363636363636362
303,3,5,2,879468513,879468547,34,1222,739,3.391304347826087
303,5,5,0,879468547,879468581,34,739,451,3.207792207792208
303,5,5,0,879468581,879483480,14899,451,91,3.6
303,5,4,-1,879483480,879483510,30,91,418,3.825
303,4,3,-1,879483510,879483511,1,418,230,3.3518518518518516
303,3,4,1,879483511,879483535,24,230,423,3.7016129032258065
303,4,4,0,879483535,879483567,32,423,735,3.58
303,4,5,1,879483567,879483568,1,735,655,3.7857142857142856
303,5,4,-1,879483568,879483617,49,655,631,3.581818181818182
303,4,4,0,879483617,879483680,63,631,143,3.56
303,4,4,0,879483680,879483802,122,143,411,2.911764705882353
303,4,3,-1,879483802,879483827,25,411,477,3.1666666666666665
303,3,5,2,879483827,879483900,73,477,780,3.08
303,5,3,-2,879483900,879483901,1,780,824,2.590909090909091
303,3,4,1,879483901,879483978,77,824,77,3.3857142857142857
303,4,3,-1,879483978,879484159,181,77,155,3.0588235294117645
303,3,4,1,879484159,879484213,54,155,979,3.1
303,4,2,-2,879484213,879484282,69,979,1011,3.1
303,2,1,-1,879484282,879484327,45,1011,63,3.125
303,1,3,2,879484327,879484373,46,63,867,4.0
303,3,4,1,879484373,879484421,48,867,502,3.272727272727273
303,4,4,0,879484421,879484441,20,502,715,3.257142857142857
303,4,4,0,879484441,879484480,39,715,44,3.1333333333333333
303,4,2,-2,879484480,879484500,20,44,554,2.9555555555555557
303,2,2,0,879484500,879484534,34,554,5,3.1481481481481484
303,2,4,2,879484534,879484563,29,5,420,3.5652173913043477
303,4,3,-1,879484563,879484588,25,420,85,3.3157894736842106
303,3,4,1,879484588,879484643,55,85,1021,3.8666666666666667
303,4,3,-1,879484643,879484695,52,1021,159,3.3902439024390243
303,3,3,0,879484695,879484733,38,159,627,3.3823529411764706
303,3,3,0,879484733,879484804,71,627,291,3.2
303,3,4,1,879484804,879484846,42,291,396,2.84
303,4,3,-1,879484846,879484918,72,396,73,3.588235294117647
303,3,3,0,879484918,879484948,30,73,1232,2.6666666666666665
303,3,4,1,879484948,879484981,33,1232,501,3.289473684210526
303,4,3,-1,879484981,879485016,35,501,953,3.076923076923077
303,3,3,0,879485016,879485048,32,953,1335,2.25
303,3,1,-2,879485048,879485089,41,1335,685,3.2666666666666666
303,1,4,3,879485089,879485111,22,685,473,2.9166666666666665
303,4,2,-2,879485111,879485134,23,473,29,2.5714285714285716
303,2,3,1,879485134,879485165,31,29,384,2.7941176470588234
303,3,3,0,879485165,879485184,19,384,3,3.0625
303,3,4,1,879485184,879485203,19,3,287,3.4516129032258065
303,4,4,0,879485203,879485204,1,287,1188,2.45
303,4,4,0,879485204,879485221,17,1188,845,3.661290322580645
303,4,4,0,879485221,879485250,29,845,402,3.3076923076923075
303,4,2,-2,879485250,879485278,28,402,1273,2.5714285714285716
303,2,4,2,879485278,879485292,14,1273,231,2.938775510204082
303,4,3,-1,879485292,879485318,26,231,94,2.8823529411764706
303,3,4,1,879485318,879485319,1,94,763,3.347826086956522
303,4,3,-1,879485319,879485352,33,763,800,3.2222222222222223
303,3,2,-1,879485352,879485372,20,800,722,2.9642857142857144
303,2,5,3,879485372,879485401,29,722,387,3.5357142857142856
303,5,3,-2,879485401,879485417,16,387,576,3.125
303,3,1,-2,879485417,879485447,30,576,564,2.0
303,1,3,2,879485447,879485532,85,564,815,3.135135135135135
303,3,4,1,879485532,879485546,14,815,379,3.35
303,4,3,-1,879485546,879485589,43,379,928,3.142857142857143
303,3,3,0,879485589,879485608,19,928,765,3.0
303,3,2,-1,879485608,879485659,51,765,940,2.4
303,2,4,2,879485659,879485685,26,940,449,2.9069767441860463
303,4,1,-3,879485685,879485686,1,449,1090,2.3529411764705883
303,1,2,1,879485686,879485703,17,1090,869,3.0
303,2,1,-1,879485703,879485747,44,869,391,2.4285714285714284
303,1,2,1,879485747,879485814,67,391,926,2.7857142857142856
303,2,1,-1,879485814,879485844,30,926,1040,2.2666666666666666
303,1,3,2,879485844,879543003,57159,1040,401,2.6774193548387095
303,3,3,0,879543003,879543375,372,401,281,3.2
303,3,1,-2,879543375,879543418,43,281,779,2.2
303,1,2,1,879543418,879543459,41,779,1228,2.5
303,2,2,0,879543459,879543524,65,1228,809,2.7058823529411766
303,2,1,-1,879543524,879543573,49,809,145,2.3636363636363638
303,1,4,3,879543573,879543600,27,145,460,3.0
303,4,2,-2,879543600,879543617,17,460,376,2.9166666666666665
303,2,1,-1,879543617,879543679,62,376,801,2.2
303,1,2,1,879543679,879543711,32,801,1157,3.142857142857143
303,2,3,1,879543711,879543756,45,1157,412,2.272727272727273
303,3,1,-2,879543756,879543773,17,412,1210,2.7142857142857144
303,1,2,1,879543773,879543796,23,1210,106,2.8125
303,2,3,1,879543796,879543831,35,106,1303,2.857142857142857
303,3,1,-2,879543831,879543939,108,1303,1110,2.85
303,1,3,2,879543939,879543959,20,1110,158,2.7027027027027026
303,3,2,-1,879543959,879543988,29,158,840,3.090909090909091
303,2,1,-1,879543988,879544020,32,840,1239,2.25
303,1,2,1,879544020,879544021,1,1239,1209,2.3333333333333335
303,2,2,0,879544021,879544062,41,1209,670,2.9375
303,2,1,-1,879544062,879544063,1,670,1407,2.375
303,1,2,1,879544063,879544099,36,1407,120,2.3421052631578947
303,2,1,-1,879544099,879544130,31,120,1508,1.0
303,1,2,1,879544130,879544153,23,1508,364,2.8095238095238093
303,2,1,-1,879544153,879544184,31,364,574,2.0
303,1,4,3,879544184,879544219,35,574,575,2.619047619047619
303,4,3,-1,879544219,879544365,146,575,390,4.0
303,3,1,-2,879544365,879544385,20,390,759,2.6
303,1,3,2,879544385,879544386,1,759,450,2.2758620689655173
303,3,2,-1,879544386,879544400,14,450,545,1.7142857142857142
303,2,3,1,879544400,879544435,35,545,998,2.7777777777777777
303,3,4,1,879544435,879544515,80,998,293,3.630434782608696
303,4,4,0,879544515,879544533,18,293,251,3.8333333333333335
303,4,2,-2,879544533,879544576,43,251,993,3.4838709677419355
303,2,2,0,879544576,879544629,53,993,1160,4.1
303,2,2,0,879544629,879544680,51,1160,248,3.746268656716418
303,2,4,2,879544680,879544712,32,248,250,3.4698795180722892
303,4,4,0,879544712,879544713,1,250,1226,3.5454545454545454
303,4,3,-1,879544713,879544727,14,1226,1016,3.559322033898305
303,3,4,1,879544727,879544739,12,1016,249,3.3275862068965516
303,4,2,-2,879544739,879544756,17,249,1258,2.3333333333333335
303,2,3,1,879544756,879544791,35,1258,252,2.911392405063291
303,3,3,0,879544791,879544843,52,252,1511,3.3333333333333335
303,3,1,-2,879544843,879544860,17,1511,1013,2.388888888888889
303,1,1,0,879544860,879544923,63,1013,687,2.1481481481481484
303,1,1,0,879544923,879544946,23,687,678,2.8181818181818183
303,1,1,0,879544946,879544978,32,678,1089,2.1363636363636362
122,5,4,-1,879270128,879270129,1,191,519,4.291666666666667
122,4,4,0,879270129,879270327,198,519,510,3.823529411764706
122,4,1,-3,879270327,879270424,97,510,11,3.8904109589041096
122,1,5,4,879270424,879270458,34,11,86,3.869565217391304
122,5,5,0,879270458,879270482,24,86,197,4.112676056338028
122,5,4,-1,879270482,879270511,29,197,509,3.7058823529411766
122,4,5,1,879270511,879270541,30,509,464,3.8
122,5,5,0,879270541,879270567,26,464,46,3.6666666666666665
122,5,4,-1,879270567,879270605,38,46,193,3.883720930232558
122,4,3,-1,879270605,879270644,39,193,660,3.71875
122,3,4,1,879270644,879270677,33,660,724,3.64
122,4,3,-1,879270677,879270711,34,724,382,3.764705882352941
122,3,3,0,879270711,879270741,30,382,553,3.5
122,3,4,1,879270741,879270769,28,553,1267,2.909090909090909
122,4,4,0,879270769,879270805,36,1267,423,3.7016129032258065
122,4,4,0,879270805,879270849,44,423,727,3.5517241379310347
122,4,4,0,879270849,879270850,1,727,956,3.5714285714285716
122,4,4,0,879270850,879270874,24,956,737,3.12
122,4,3,-1,879270874,879270901,27,737,470,3.72
122,3,4,1,879270901,879270902,1,470,1168,3.4166666666666665
122,4,5,1,879270902,879270923,21,1168,1044,3.2777777777777777
194,2,4,2,879520306,879520813,507,991,187,4.215189873417722
194,4,4,0,879520813,879520916,103,187,357,4.063291139240507
194,4,3,-1,879520916,879520991,75,357,86,3.869565217391304
194,3,4,1,879520991,879521087,96,86,526,3.909090909090909
194,4,2,-2,879521087,879521088,1,526,419,3.8208955223880596
194,2,3,1,879521088,879521167,79,419,479,4.25
194,3,5,2,879521167,879521254,87,479,168,4.0476190476190474
194,5,3,-2,879521254,879521328,74,168,89,3.9615384615384617
194,3,3,0,879521328,879521475,147,89,488,4.277777777777778
194,3,4,1,879521475,879521595,120,488,69,3.8015873015873014
194,4,5,1,879521595,879521596,1,69,523,4.159090909090909
194,5,4,-1,879521596,879521657,61,523,317,3.774193548387097
194,4,3,-1,879521657,879521719,62,317,8,3.903225806451613
194,3,3,0,879521719,879521856,137,8,517,3.625
194,3,3,0,879521856,879521936,80,517,209,3.8275862068965516
194,3,2,-1,879521936,879521937,1,209,559,3.477272727272727
194,2,3,1,879521937,879522021,84,559,198,4.04
194,3,3,0,879522021,879522085,64,198,509,3.7058823529411766
194,3,4,1,879522085,879522158,73,509,188,3.625
194,4,2,-2,879522158,879522240,82,188,425,3.7027027027027026
194,2,5,3,879522240,879522324,84,425,28,3.923076923076923
194,5,2,-3,879522324,879522445,121,28,654,4.119047619047619
194,2,4,2,879522445,879522916,471,654,503,3.6363636363636362
194,4,4,0,879522916,879522917,1,503,58,3.543859649122807
194,4,3,-1,879522917,879523104,187,58,443,3.8421052631578947
194,3,3,0,879523104,879523243,139,443,616,3.1052631578947367
194,3,4,1,879523243,879523576,333,616,161,3.5844155844155843
194,4,3,-1,879523576,879524008,432,161,402,3.3076923076923075
194,3,4,1,879524008,879524216,208,402,693,3.6285714285714286
194,4,4,0,879524216,879524291,75,693,71,3.6575342465753424
194,4,4,0,879524291,879524292,1,71,663,3.948717948717949
194,4,3,-1,879524292,879524643,351,663,99,3.8392857142857144
194,3,2,-1,879524643,879524644,1,99,1045,3.2
194,2,4,2,879524644,879524718,74,1045,735,3.58
194,4,4,0,879524718,879524790,72,735,193,3.883720930232558
194,4,4,0,879524790,879524892,102,193,218,3.5555555555555554
194,4,2,-2,879524892,879525695,803,218,417,3.0588235294117645
194,2,2,0,879525695,879527146,1451,417,387,3.5357142857142856
194,2,3,1,879527146,879527263,117,387,739,3.391304347826087
194,3,3,0,879527263,879527264,1,739,66,3.4705882352941178
194,3,3,0,879527264,879527421,157,66,77,3.3857142857142857
194,3,3,0,879527421,879527513,92,77,465,3.75
194,3,3,0,879527513,879527514,1,465,946,3.1153846153846154
194,3,3,0,879527514,879527584,70,946,371,3.0
194,3,2,-1,879527584,879527725,141,371,403,3.298507462686567
194,2,2,0,879527725,879527865,140,403,783,2.388888888888889
194,2,3,1,879527865,879527999,134,783,1112,2.9
194,3,3,0,879527999,879528000,1,1112,94,2.8823529411764706
194,3,3,0,879528000,879528106,106,94,708,3.3157894736842106
194,3,2,-1,879528106,879528454,348,708,399,3.317073170731707
194,2,1,-1,879528454,879535549,7095,399,78,2.3636363636363638
194,1,4,3,879535549,879535704,155,78,9,3.8878504672897196
194,4,3,-1,879535704,879538959,3255,9,237,3.7315436241610738
194,3,1,-2,879538959,879538960,1,237,222,3.578125
194,1,2,1,879538960,879539305,345,222,864,3.2142857142857144
194,2,3,1,879539305,879539410,105,864,284,3.1547619047619047
194,3,2,-1,879539410,879541148,1738,284,1028,2.857142857142857
194,2,3,1,879541148,879541806,658,1028,546,2.9789473684210526
194,3,3,0,879541806,879546498,4692,546,604,3.8181818181818183
194,3,2,-1,879546498,879546551,53,604,631,3.581818181818182
194,2,3,1,879546551,879546723,172,631,153,3.7865168539325844
194,3,3,0,879546723,879547130,407,153,744,3.5714285714285716
194,3,3,0,879547130,879548121,991,744,423,3.7016129032258065
194,3,2,-1,879548121,879548122,1,423,736,4.083333333333333
194,2,3,1,879548122,879548319,197,736,501,3.289473684210526
194,3,2,-1,879548319,879549503,1184,501,76,3.1875
194,2,1,-1,879549503,879549899,396,76,756,2.6885245901639343
194,1,2,1,879549899,879549900,1,756,167,2.8181818181818183
194,2,3,1,879549900,879549996,96,167,152,3.6785714285714284
194,3,3,0,879549996,879550737,741,152,155,3.0588235294117645
194,3,2,-1,879550737,879551921,1184,155,1412,1.5
194,2,2,0,879551921,879551999,78,1412,944,2.75
194,2,2,0,879551999,879552662,663,944,1409,2.5
194,2,3,1,879552662,879552841,179,1409,90,3.0
194,3,4,1,879552841,879553003,162,90,737,3.12
194,4,2,-2,879553003,879553591,588,737,1041,3.3333333333333335
194,2,2,0,879553591,879553731,140,1041,636,3.4146341463414633
194,2,2,0,879553731,879553883,152,636,720,3.2
194,2,3,1,879553883,879553988,105,720,997,2.7142857142857144
194,3,3,0,879553988,879554383,395,997,1066,3.2
194,3,1,-2,879554383,879554453,70,1066,575,2.619047619047619
194,1,2,1,879554453,879554603,150,575,871,2.3823529411764706
194,2,1,-1,879554603,879554897,294,871,449,2.9069767441860463
194,1,1,0,879554897,879554950,53,449,540,2.4615384615384617
194,1,1,0,879554950,879555001,51,540,450,2.2758620689655173
194,1,3,2,879555001,879555147,146,450,712,3.0434782608695654
194,3,1,-2,879555147,879555267,120,712,1408,1.0
194,1,1,0,879555267,879555410,143,1408,1207,2.125
291,2,4,2,874805577,874805610,33,245,325,2.625
291,4,5,1,874805610,874805804,194,325,844,3.8333333333333335
291,5,4,-1,874805804,874805892,88,844,1012,3.2916666666666665
291,4,4,0,874805892,874805893,1,1012,249,3.3275862068965516
291,4,3,-1,874805893,874805927,34,249,742,3.5555555555555554
291,3,5,2,874805927,874805958,31,742,455,3.1702127659574466
291,5,4,-1,874805958,874806006,48,455,123,3.297872340425532
291,4,3,-1,874806006,874833705,27699,123,273,3.5238095238095237
291,3,4,1,874833705,874833726,21,273,240,3.0350877192982457
291,4,4,0,874833726,874833746,20,240,285,4.181818181818182
291,4,4,0,874833746,874833788,42,285,282,3.610526315789474
291,4,4,0,874833788,874833827,39,282,1016,3.559322033898305
291,4,4,0,874833827,874833841,14,1016,763,3.347826086956522
291,4,3,-1,874833841,874833857,16,763,597,3.2771084337349397
291,3,3,0,874833857,874833878,21,597,756,2.6885245901639343
291,3,4,1,874833878,874833911,33,756,1017,3.0
291,4,3,-1,874833911,874833936,25,1017,3,3.0625
291,3,4,1,874833936,874833983,47,3,825,2.914285714285714
291,4,4,0,874833983,874834001,18,825,290,3.108108108108108
291,4,4,0,874834001,874834019,18,290,1277,3.5555555555555554
291,4,2,-2,874834019,874834037,18,1277,760,2.35
291,2,5,3,874834037,874834054,17,760,291,3.2
291,5,2,-3,874834054,874834071,17,291,977,2.473684210526316
291,2,4,2,874834071,874834128,57,977,236,3.2666666666666666
291,4,2,-2,874834128,874834146,18,236,975,3.411764705882353
291,2,2,0,874834146,874834165,19,975,1047,2.6923076923076925
291,2,4,2,874834165,874834220,55,1047,411,2.911764705882353
291,4,3,-1,874834220,874834236,16,411,833,2.9444444444444446
291,3,5,2,874834236,874834254,18,833,460,3.0
291,5,3,-2,874834254,874834289,35,460,122,2.282608695652174
291,3,3,0,874834289,874834323,34,122,1376,2.0
291,3,4,1,874834323,874834345,22,1376,1059,2.764705882352941
291,4,3,-1,874834345,874834358,13,1059,834,2.0
291,3,3,0,874834358,874834388,30,834,369,2.5714285714285716
291,3,5,2,874834388,874834481,93,369,246,4.0
291,5,4,-1,874834481,874834735,254,246,943,3.6666666666666665
291,4,4,0,874834735,874834768,33,943,31,3.642857142857143
291,4,4,0,874834768,874834799,31,31,218,3.5555555555555554
291,4,4,0,874834799,874834850,51,218,33,3.2941176470588234
291,4,4,0,874834850,874834875,25,33,1046,3.3529411764705883
291,4,3,-1,874834875,874834876,1,1046,1083,2.3333333333333335
291,3,5,2,874834876,874834895,19,1083,226,3.378787878787879
291,5,3,-2,874834895,874834914,19,226,1471,2.75
291,3,3,0,874834914,874834944,30,1471,572,2.857142857142857
291,3,4,1,874834944,874834963,19,572,1077,3.3333333333333335
291,4,5,1,874834963,874835091,128,1077,144,3.9545454545454546
291,5,3,-2,874835091,874835116,25,144,89,3.9615384615384617
291,3,4,1,874835116,874835141,25,89,385,3.6129032258064515
291,4,5,1,874835141,874835165,24,385,686,3.9
291,5,4,-1,874835165,874835198,33,686,184,3.393939393939394
291,4,4,0,874835198,874835242,44,184,562,3.2941176470588234
291,4,2,-2,874835242,874835279,37,562,1239,2.25
291,2,3,1,874835279,874867741,32462,1239,672,2.7222222222222223
291,3,4,1,874867741,874867757,16,672,558,3.75
291,4,5,1,874867757,874867785,28,558,670,2.9375
291,5,5,0,874867785,874867786,1,670,567,3.272727272727273
291,5,3,-2,874867786,874867852,66,567,774,3.0
291,3,5,2,874867852,874867912,60,774,223,4.108695652173913
291,5,2,-3,874867912,874867966,54,223,175,3.8354430379746836
291,2,5,3,874867966,874867994,28,175,64,4.373737373737374
291,5,4,-1,874867994,874868027,33,64,735,3.58
291,4,4,0,874868027,874868097,70,735,732,3.6266666666666665
291,4,5,1,874868097,874868146,49,732,69,3.8015873015873014
291,5,4,-1,874868146,874868169,23,69,772,3.3333333333333335
291,4,4,0,874868169,874868210,41,772,423,3.7016129032258065
291,4,3,-1,874868210,874868255,45,423,366,3.4285714285714284
291,3,4,1,874868255,874868304,49,366,427,4.2025316455696204
291,4,4,0,874868304,874868382,78,427,215,3.662921348314607
291,4,3,-1,874868382,874868580,198,215,569,2.4285714285714284
291,3,4,1,874868580,874868629,49,569,655,3.7857142857142856
291,4,4,0,874868629,874868647,18,655,1505,4.0
291,4,1,-3,874868647,874868791,144,1505,375,2.076923076923077
291,1,5,4,874868791,874871479,2688,375,631,3.581818181818182
291,5,4,-1,874871479,874871498,19,631,402,3.3076923076923075
291,4,3,-1,874871498,874871551,53,402,1206,2.8333333333333335
291,3,2,-1,874871551,874871585,34,1206,1478,2.7
291,2,4,2,874871585,874871655,70,1478,798,3.3333333333333335
291,4,3,-1,874871655,874871671,16,798,1139,2.611111111111111
291,3,5,2,874871671,874871736,65,1139,238,3.888888888888889
291,5,5,0,874871736,874871766,30,238,428,3.744186046511628
291,5,5,0,874871766,874871800,34,428,173,4.1441441441441444
291,5,4,-1,874871800,875086185,214385,173,66,3.4705882352941178
291,4,2,-2,875086185,875086208,23,66,158,2.7027027027027026
291,2,3,1,875086208,875086235,27,158,393,3.5125
291,3,4,1,875086235,875086308,73,393,785,3.4375
291,4,4,0,875086308,875086330,22,785,1098,3.533333333333333
291,4,4,0,875086330,875086354,24,1098,80,2.967741935483871
291,4,4,0,875086354,875086460,106,80,722,2.9642857142857144
291,4,5,1,875086460,875086491,31,722,210,3.921259842519685
291,5,3,-2,875086491,875086534,43,210,376,2.9166666666666665
291,3,3,0,875086534,875086561,27,376,1028,2.857142857142857
291,3,4,1,875086561,875086562,1,1028,384,2.7941176470588234
291,4,2,-2,875086562,875086608,46,384,571,2.5
291,2,5,3,875086608,875086636,28,571,780,3.08
291,5,3,-2,875086636,875086669,33,780,412,2.272727272727273
291,3,3,0,875086669,875086699,30,412,364,2.8095238095238093
291,3,1,-2,875086699,875086728,29,364,998,2.7777777777777777
291,1,3,2,875086728,875086766,38,998,1305,2.3333333333333335
291,3,4,1,875086766,875086887,121,1305,140,3.238095238095238
291,4,3,-1,875086887,875086921,34,140,143,3.56
291,3,4,1,875086921,875086958,37,143,417,3.0588235294117645
291,4,4,0,875086958,875087100,142,417,501,3.289473684210526
291,4,4,0,875087100,875087125,25,501,820,3.0444444444444443
291,4,4,0,875087125,875087198,73,820,101,3.4827586206896552
291,4,4,0,875087198,875087221,23,101,1219,3.142857142857143
291,4,4,0,875087221,875087264,43,1219,97,3.7282608695652173
291,4,4,0,875087264,875087334,70,97,794,3.6
291,4,4,0,875087334,875087352,18,794,421,3.462962962962963
291,4,3,-1,875087352,875087371,19,421,155,3.0588235294117645
291,3,2,-1,875087371,875087432,61,155,783,2.388888888888889
291,2,4,2,875087432,875087488,56,783,159,3.3902439024390243
291,4,4,0,875087488,875087656,168,159,1210,2.7142857142857144
291,4,1,-3,875087656,875087673,17,1210,769,2.2222222222222223
291,1,4,3,875087673,875087720,47,769,582,3.7457627118644066
234,3,2,-1,891033314,891033393,79,286,321,3.0172413793103448
234,2,2,0,891033393,891033394,1,321,751,3.3896103896103895
234,2,2,0,891033394,891033427,33,751,307,3.6031746031746033
234,2,3,1,891033427,891033591,164,307,304,3.5306122448979593
234,3,3,0,891033591,891033627,36,304,300,3.6861313868613137
234,3,2,-1,891033627,891033686,59,300,259,2.492063492063492
234,2,3,1,891033686,891033715,29,259,294,3.1052631578947367
234,3,3,0,891033715,891033738,23,294,288,3.5214285714285714
234,3,4,1,891033738,891033821,83,288,292,3.6666666666666665
234,4,4,0,891033821,891033851,30,292,289,2.988888888888889
234,4,2,-2,891033851,891033922,71,289,329,3.25
234,2,2,0,891033922,891033966,44,329,984,2.6666666666666665
234,2,3,1,891033966,891034007,41,984,873,2.7586206896551726
234,3,3,0,891034007,891034078,71,873,887,3.5789473684210527
234,3,1,-2,891034078,891034107,29,887,243,2.357142857142857
234,1,3,2,891034107,891227771,193664,243,93,3.5641025641025643
234,3,2,-1,891227771,891227813,42,93,7,3.76056338028169
234,2,3,1,891227813,891227814,1,7,283,3.901639344262295
234,3,1,-2,891227814,891227851,37,283,546,2.9789473684210526
234,1,2,1,891227851,891227979,128,546,596,3.180327868852459
234,2,3,1,891227979,891228196,217,596,276,3.6036036036036037
234,3,4,1,891228196,892078342,850146,276,675,3.625
234,4,3,-1,892078342,892078343,1,675,1330,2.0
234,3,4,1,892078343,892078386,43,1330,488,4.277777777777778
234,4,3,-1,892078386,892078424,38,488,431,3.422222222222222
234,3,4,1,892078424,892078485,61,431,504,4.085714285714285
234,4,2,-2,892078485,892078521,36,504,844,3.8333333333333335
234,2,3,1,892078521,892078605,84,844,154,3.6031746031746033
234,3,3,0,892078605,892078660,55,154,659,4.027777777777778
234,3,5,2,892078660,892078699,39,659,498,4.290909090909091
234,5,3,-2,892078699,892078741,42,498,1039,3.9583333333333335
234,3,4,1,892078741,892078837,96,1039,494,3.8333333333333335
234,4,5,1,892078837,892078890,53,494,178,4.378378378378378
234,5,4,-1,892078890,892078983,93,178,64,4.373737373737374
234,4,3,-1,892078983,892078984,1,64,531,3.7435897435897436
234,3,3,0,892078984,892079040,56,531,238,3.888888888888889
234,3,5,2,892079040,892079076,36,238,481,3.8421052631578947
234,5,3,-2,892079076,892079077,1,481,521,3.787878787878788
234,3,3,0,892079077,892079140,63,521,612,4.0
234,3,3,0,892079140,892079190,50,612,213,3.943396226415094
234,3,2,-1,892079190,892079237,47,213,1184,2.5
234,2,3,1,892079237,892079288,51,1184,205,3.717391304347826
234,3,4,1,892079288,892079337,49,205,709,4.171428571428572
234,4,4,0,892079337,892079434,97,709,921,3.611111111111111
234,4,3,-1,892079434,892079475,41,921,727,3.5517241379310347
234,3,4,1,892079475,892079538,63,727,491,3.55
234,4,4,0,892079538,892079585,47,491,558,3.75
234,4,2,-2,892079585,892079617,32,558,204,3.6744186046511627
234,2,3,1,892079617,892079689,72,204,95,3.8194444444444446
234,3,3,0,892079689,892079722,33,95,215,3.662921348314607
234,3,4,1,892079722,892079840,118,215,462,3.7954545454545454
234,4,4,0,892079840,892079910,70,462,1203,4.0
234,4,4,0,892079910,892318002,238092,1203,208,3.8125
234,4,3,-1,892318002,892318060,58,208,111,3.5106382978723403
234,3,4,1,892318060,892318107,47,111,506,3.566666666666667
234,4,2,-2,892318107,892318158,51,506,1455,2.0
234,2,2,0,892318158,892333653,15495,1455,503,3.6363636363636362
234,2,4,2,892333653,892333765,112,503,1021,3.8666666666666667
234,4,5,1,892333765,892333798,33,1021,170,4.242424242424242
234,5,3,-2,892333798,892333865,67,170,1200,3.5
234,3,3,0,892333865,892333890,25,1200,77,3.3857142857142857
234,3,3,0,892333890,892333980,90,77,290,3.108108108108108
234,3,5,2,892333980,892334107,127,290,479,4.25
234,5,4,-1,892334107,892334141,34,479,499,4.0
234,4,3,-1,892334141,892334189,48,499,945,3.4
234,3,2,-1,892334189,892334267,78,945,1003,2.8
234,2,3,1,892334267,892334338,71,1003,5,3.1481481481481484
234,3,3,0,892334338,892334400,62,5,1400,3.5
234,3,4,1,892334400,892334543,143,1400,1169,4.0
234,4,3,-1,892334543,892334577,34,1169,173,4.1441441441441444
234,3,3,0,892334577,892334610,33,173,942,3.4545454545454546
234,3,3,0,892334610,892334680,70,942,133,3.7777777777777777
234,3,2,-1,892334680,892334713,33,133,445,3.727272727272727
234,2,3,1,892334713,892334765,52,445,436,3.5
234,3,1,-2,892334765,892334766,1,436,951,2.6666666666666665
234,1,4,3,892334766,892334803,37,951,31,3.642857142857143
234,4,4,0,892334803,892334852,49,31,964,3.0
234,4,3,-1,892334852,892334883,31,964,319,3.0408163265306123
234,3,2,-1,892334883,892334976,93,319,117,3.689189189189189
234,2,2,0,892334976,892335042,66,117,241,3.5625
234,2,5,3,892335042,892335074,32,241,200,3.8157894736842106
234,5,3,-2,892335074,892335142,68,200,1035,3.03125
234,3,3,0,892335142,892335186,44,1035,609,3.7058823529411766
234,3,3,0,892335186,892335187,1,609,1448,3.0
234,3,3,0,892335187,892335213,26,1448,1450,4.0
234,3,2,-1,892335213,892335309,96,1450,385,3.6129032258064515
234,2,3,1,892335309,892335342,33,385,13,3.5454545454545454
234,3,3,0,892335342,892335372,30,13,782,2.8
234,3,2,-1,892335372,892335415,43,782,1010,3.611111111111111
234,2,3,1,892335415,892335460,45,1010,1460,3.0
234,3,2,-1,892335460,892335500,40,1460,1100,3.0
234,2,3,1,892335500,892335541,41,1100,588,3.8358208955223883
234,3,2,-1,892335541,892335564,23,588,76,3.1875
234,2,2,0,892335564,892335616,52,76,102,3.3684210526315788
234,2,3,1,892335616,892335674,58,102,72,3.175438596491228
234,3,2,-1,892335674,892335707,33,72,702,2.764705882352941
234,2,3,1,892335707,892335739,32,702,125,3.5555555555555554
234,3,3,0,892335739,892335764,25,125,1285,3.1
234,3,3,0,892335764,892335797,33,1285,1075,2.5
234,3,3,0,892335797,892335825,28,1075,845,3.661290322580645
234,3,3,0,892335825,892335850,25,845,549,3.4871794871794872
234,3,3,0,892335850,892335870,20,549,649,3.625
234,3,2,-1,892335870,892335894,24,649,40,2.7037037037037037
234,2,5,3,892335894,892335920,26,40,91,3.6
234,5,4,-1,892335920,892335989,69,91,638,3.923076923076923
234,4,3,-1,892335989,892335990,1,638,692,3.56
234,3,3,0,892335990,892336021,31,692,237,3.7315436241610738
234,3,3,0,892336021,892336047,26,237,447,3.46875
234,3,4,1,892336047,892336077,30,447,502,3.272727272727273
234,4,3,-1,892336077,892336119,42,502,1447,3.0
234,3,4,1,892336119,892336165,46,1447,792,3.793103448275862
234,4,1,-3,892336165,892336194,29,792,130,1.8461538461538463
234,1,3,2,892336194,892336257,63,130,671,3.4285714285714284
234,3,4,1,892336257,892336286,29,671,1445,3.5
234,4,2,-2,892336286,892336287,1,1445,219,2.735294117647059
234,2,2,0,892336287,892336322,35,219,401,2.6774193548387095
234,2,3,1,892336322,892336358,36,401,636,3.4146341463414633
234,3,3,0,892336358,892826643,490285,636,956,3.5714285714285716
234,3,4,1,892826643,892826701,58,956,152,3.6785714285714284
234,4,3,-1,892826701,892826760,59,152,648,3.9545454545454546
119,4,5,1,874774449,874774575,126,323,275,4.087912087912088
119,5,5,0,874774575,874774718,143,275,50,4.306532663316583
119,5,4,-1,874774718,874774815,97,50,741,3.3043478260869565
119,4,4,0,874774815,874774993,178,741,277,3.6
119,4,4,0,874774993,874775038,45,277,298,3.779220779220779
119,4,4,0,874775038,874775185,147,298,628,3.573529411764706
119,4,2,-2,874775185,874775262,77,628,276,3.6036036036036037
119,2,5,3,874775262,874775311,49,276,222,3.578125
119,5,4,-1,874775311,874775406,95,222,181,3.98974358974359
119,4,4,0,874775406,874775465,59,181,597,3.2771084337349397
119,4,4,0,874775465,874775535,70,597,924,3.3703703703703702
119,4,4,0,874775535,874775580,45,924,475,3.956043956043956
119,4,4,0,874775580,874775614,34,475,257,3.7154471544715446
119,4,4,0,874775614,874775680,66,257,1202,3.6666666666666665
119,4,2,-2,874775680,874775731,51,1202,250,3.4698795180722892
119,2,2,0,874775731,874775849,118,250,105,2.6176470588235294
119,2,3,1,874775849,874775914,65,105,255,3.2027027027027026
119,3,3,0,874775914,874775945,31,255,930,2.793103448275862
119,3,2,-1,874775945,874775980,35,930,831,2.6097560975609757
119,2,3,1,874775980,874780860,4880,831,825,2.914285714285714
119,3,3,0,874780860,874780969,109,825,977,2.473684210526316
119,3,3,0,874780969,874780996,27,977,1259,3.0
119,3,3,0,874780996,874781037,41,1259,1244,2.7777777777777777
119,3,3,0,874781037,874781067,30,1244,595,2.9166666666666665
119,3,3,0,874781067,874781068,1,595,986,2.5555555555555554
119,3,5,2,874781068,874781198,130,986,1153,4.666666666666667
119,5,5,0,874781198,874781257,59,1153,213,3.943396226415094
119,5,4,-1,874781257,874781303,46,213,174,4.253521126760563
119,4,5,1,874781303,874781351,48,174,168,4.0476190476190474
119,5,4,-1,874781351,874781352,1,168,89,3.9615384615384617
119,4,5,1,874781352,874781407,55,89,511,4.096153846153846
119,5,4,-1,874781407,874781460,53,511,64,4.373737373737374
119,4,5,1,874781460,874781547,87,64,1260,5.0
119,5,4,-1,874781547,874781698,151,1260,22,4.215909090909091
119,4,5,1,874781698,874781742,44,22,382,3.764705882352941
119,5,4,-1,874781742,874781872,130,382,193,3.883720930232558
119,4,5,1,874781872,874781994,122,193,385,3.6129032258064515
119,5,5,0,874781994,874782022,28,385,154,3.6031746031746033
119,5,4,-1,874782022,874782068,46,154,86,3.869565217391304
119,4,3,-1,874782068,874782100,32,86,23,3.9047619047619047
119,3,5,2,874782100,874782127,27,23,658,3.393939393939394
119,5,5,0,874782127,874782190,63,658,716,3.1904761904761907
119,5,4,-1,874782190,874782191,1,716,172,4.225225225225225
119,4,5,1,874782191,874782228,37,172,132,3.929411764705882
119,5,4,-1,874782228,886175150,11392922,132,271,3.3134328358208953
119,4,3,-1,886175150,886175361,211,271,751,3.3896103896103895
119,3,4,1,886175361,886175431,70,751,689,3.1538461538461537
119,4,5,1,886175431,886175571,140,689,315,4.15
119,5,5,0,886175571,886176486,915,315,137,3.9545454545454546
119,5,1,-4,886176486,886176678,192,137,755,3.085714285714286
119,1,4,3,886176678,886176814,136,755,392,3.5555555555555554
119,4,5,1,886176814,886176922,108,392,1137,4.25
119,5,3,-2,886176922,886176993,71,1137,1264,3.5
119,3,4,1,886176993,886177048,55,1264,685,3.2666666666666666
119,4,4,0,886177048,886177076,28,685,24,3.3728813559322033
119,4,4,0,886177076,886177162,86,24,710,3.41025641025641
119,4,4,0,886177162,886177206,44,710,562,3.2941176470588234
119,4,4,0,886177206,886177235,29,562,591,3.7169811320754715
119,4,3,-1,886177235,886177338,103,591,1263,3.1666666666666665
119,3,4,1,886177338,886177659,321,1263,204,3.6744186046511627
119,4,2,-2,886177659,886177762,103,204,526,3.909090909090909
119,2,3,1,886177762,891287060,5109298,526,1265,2.75
119,3,1,-2,891287060,892564313,1277253,1265,294,3.1052631578947367
119,1,4,3,892564313,892564349,36,294,917,4.0
119,4,1,-3,892564349,892564442,93,917,916,3.3333333333333335
167,3,5,2,892737972,892738081,109,235,137,3.9545454545454546
167,5,3,-2,892738081,892738141,60,137,831,2.6097560975609757
167,3,4,1,892738141,892738212,71,831,603,4.315789473684211
167,4,4,0,892738212,892738237,25,603,655,3.7857142857142856
167,4,5,1,892738237,892738307,70,655,521,3.787878787878788
167,5,1,-4,892738307,892738341,34,521,949,3.392857142857143
167,1,5,4,892738341,892738384,43,949,83,4.204081632653061
167,5,4,-1,892738384,892738385,1,83,513,4.526315789473684
167,4,1,-3,892738385,892738418,33,513,1305,2.3333333333333335
167,1,5,4,892738418,892738453,35,1305,435,3.8933333333333335
299,3,4,1,877618584,877618619,35,288,300,3.6861313868613137
299,4,1,-3,877618619,877618647,28,300,749,3.2777777777777777
299,1,5,4,877618647,877877434,258787,749,127,4.162790697674419
299,5,3,-2,877877434,877877479,45,127,181,3.98974358974359
299,3,4,1,877877479,877877535,56,181,275,4.087912087912088
299,4,4,0,877877535,877877600,65,275,475,3.956043956043956
299,4,3,-1,877877600,877877691,91,475,297,4.142857142857143
299,3,2,-1,877877691,877877732,41,297,257,3.7154471544715446
299,2,4,2,877877732,877877733,1,257,129,3.744186046511628
299,4,2,-2,877877733,877877775,42,129,93,3.5641025641025643
299,2,4,2,877877775,877877847,72,93,408,4.4772727272727275
299,4,5,1,877877847,877877933,86,408,248,3.746268656716418
299,5,4,-1,877877933,877877965,32,248,13,3.5454545454545454
299,4,3,-1,877877965,877878001,36,13,1322,2.5
299,3,2,-1,877878001,877878036,35,1322,255,3.2027027027027026
299,2,3,1,877878036,877878080,44,255,1379,3.0
299,3,3,0,877878080,877878184,104,1379,111,3.5106382978723403
299,3,4,1,877878184,877878227,43,111,151,3.6544117647058822
299,4,3,-1,877878227,877878339,112,151,274,3.5609756097560976
299,3,2,-1,877878339,877878382,43,274,1300,2.5
299,2,4,2,877878382,877878451,69,1300,508,3.6923076923076925
299,4,3,-1,877878451,877878561,110,508,473,2.9166666666666665
299,3,5,2,877878561,877878601,40,473,10,3.85
299,5,2,-3,877878601,877878602,1,10,1226,3.5454545454545454
299,2,3,1,877878602,877880111,1509,1226,20,3.375
299,3,1,-2,877880111,877880196,85,20,1132,2.588235294117647
299,1,3,2,877880196,877880350,154,1132,531,3.7435897435897436
299,3,4,1,877880350,877880474,124,531,28,3.923076923076923
299,4,3,-1,877880474,877880522,48,28,652,3.9642857142857144
299,3,4,1,877880522,877880566,44,652,509,3.7058823529411766
299,4,4,0,877880566,877880612,46,509,48,4.055555555555555
299,4,4,0,877880612,877880648,36,48,61,4.190476190476191
299,4,4,0,877880648,877880649,1,61,318,4.5046728971962615
299,4,4,0,877880649,877880852,203,318,529,4.142857142857143
299,4,4,0,877880852,877880915,63,529,692,3.56
299,4,4,0,877880915,877880961,46,692,174,4.253521126760563
299,4,3,-1,877880961,877881169,208,174,32,3.7222222222222223
299,3,3,0,877881169,877881170,1,32,1507,3.0
299,3,4,1,877881170,877881228,58,1507,513,4.526315789473684
299,4,4,0,877881228,877881276,48,513,645,3.5714285714285716
299,4,4,0,877881276,877881320,44,645,144,3.9545454545454546
299,4,5,1,877881320,877881356,36,144,190,4.233333333333333
299,5,4,-1,877881356,878191889,310533,190,135,3.7974683544303796
299,4,4,0,878191889,878191943,54,135,114,4.3478260869565215
299,4,3,-1,878191943,878192039,96,114,197,4.112676056338028
299,3,4,1,878192039,878192078,39,197,136,3.764705882352941
299,4,3,-1,878192078,878192154,76,136,496,4.094594594594595
299,3,4,1,878192154,878192192,38,496,813,4.055555555555555
299,4,4,0,878192192,878192237,45,813,1020,3.727272727272727
299,4,3,-1,878192237,878192238,1,1020,423,3.7016129032258065
299,3,4,1,878192238,878192311,73,423,511,4.096153846153846
299,4,4,0,878192311,878192379,68,511,727,3.5517241379310347
299,4,3,-1,878192379,878192429,50,727,229,3.185185185185185
299,3,4,1,878192429,878192497,68,229,367,3.4242424242424243
299,4,5,1,878192497,878192555,58,367,213,3.943396226415094
299,5,4,-1,878192555,878192556,1,213,479,4.25
299,4,3,-1,878192556,878192601,45,479,239,3.423076923076923
299,3,4,1,878192601,878192680,79,239,97,3.7282608695652173
299,4,3,-1,878192680,878192721,41,97,1021,3.8666666666666667
299,3,4,1,878192721,878192756,35,1021,502,3.272727272727273
299,4,4,0,878192756,878192804,48,502,647,4.142857142857143
299,4,5,1,878192804,878192833,29,647,1005,4.166666666666667
299,5,5,0,878192833,879123190,930357,1005,175,3.8354430379746836
299,5,4,-1,879123190,884023998,4900808,175,345,3.4782608695652173
299,4,4,0,884023998,887135610,3111612,345,347,3.59375
299,4,4,0,887135610,889417423,2281813,347,936,3.727272727272727
299,4,5,1,889417423,889501163,83740,936,173,4.1441441441441444
299,5,5,0,889501163,889501190,27,173,170,4.242424242424242
299,5,5,0,889501190,889501230,40,170,487,4.043478260869565
299,5,4,-1,889501230,889501260,30,487,965,3.7142857142857144
299,4,4,0,889501260,889501288,28,965,198,4.04
299,4,4,0,889501288,889501325,37,198,202,3.730337078651685
299,4,5,1,889501325,889501365,40,202,433,3.8035714285714284
299,5,4,-1,889501365,889501393,28,433,606,4.294117647058823
299,4,4,0,889501393,889501514,121,606,641,4.5
299,4,3,-1,889501514,889501551,37,641,919,4.0
299,3,4,1,889501551,889501593,42,919,962,3.142857142857143
299,4,3,-1,889501593,889501620,27,962,820,3.0444444444444443
299,3,3,0,889501620,889501654,34,820,95,3.8194444444444446
299,3,3,0,889501654,889501790,136,95,501,3.289473684210526
299,3,5,2,889501790,889501890,100,501,543,4.166666666666667
299,5,4,-1,889501890,889501926,36,543,166,4.0
299,4,4,0,889501926,889501995,69,166,512,3.888888888888889
299,4,4,0,889501995,889502050,55,512,86,3.869565217391304
299,4,4,0,889502050,889502087,37,86,855,3.590909090909091
299,4,3,-1,889502087,889502198,111,855,381,3.2758620689655173
299,3,2,-1,889502198,889502528,330,381,1214,1.8
299,2,3,1,889502528,889502640,112,1214,241,3.5625
299,3,3,0,889502640,889502687,47,241,724,3.64
299,3,4,1,889502687,889502688,1,724,517,3.625
299,4,4,0,889502688,889502727,39,517,1119,3.5185185185185186
299,4,2,-2,889502727,889502756,29,1119,387,3.5357142857142856
299,2,3,1,889502756,889502786,30,387,1074,2.857142857142857
299,3,4,1,889502786,889502823,37,1074,49,3.3
299,4,3,-1,889502823,889502865,42,49,553,3.5
299,3,4,1,889502865,889502979,114,553,746,3.7560975609756095
299,4,4,0,889502979,889502980,1,746,210,3.921259842519685
299,4,4,0,889502980,889503013,33,210,1103,3.5555555555555554
299,4,4,0,889503013,889503112,99,1103,792,3.793103448275862
299,4,3,-1,889503112,889503305,193,792,72,3.175438596491228
299,3,3,0,889503305,889503334,29,72,856,4.142857142857143
299,3,2,-1,889503334,889503373,39,856,399,3.317073170731707
299,2,1,-1,889503373,889503374,1,399,17,3.032258064516129
299,1,4,3,889503374,889503441,67,17,715,3.257142857142857
299,4,3,-1,889503441,889503503,62,715,954,3.5
299,3,1,-2,889503503,889503564,61,954,94,2.8823529411764706
299,1,2,1,889503564,889503740,176,94,67,3.106382978723404
299,2,3,1,889503740,889503774,34,67,384,2.7941176470588234
299,3,2,-1,889503774,889503856,82,384,1036,3.0
308,4,3,-1,887736459,887736532,73,641,659,4.027777777777778
308,3,5,2,887736532,887736584,52,659,498,4.290909090909091
308,5,4,-1,887736584,887736695,111,498,183,3.951219512195122
308,4,3,-1,887736695,887736696,1,183,165,3.9130434782608696
308,3,5,2,887736696,887736797,101,165,853,2.75
308,5,5,0,887736797,887736843,46,853,238,3.888888888888889
308,5,4,-1,887736843,887736880,37,238,48,4.055555555555555
308,4,5,1,887736880,887736881,1,48,654,4.119047619047619
308,5,5,0,887736881,887736924,43,654,56,4.051724137931035
308,5,4,-1,887736924,887736925,1,56,185,3.9726027397260273
308,4,3,-1,887736925,887736998,73,185,404,3.6578947368421053
308,3,5,2,887736998,887736999,1,404,175,3.8354430379746836
308,5,3,-2,887736999,887737036,37,175,528,4.241379310344827
308,3,4,1,887737036,887737084,48,528,163,3.53125
308,4,5,1,887737084,887737130,46,163,511,4.096153846153846
308,5,4,-1,887737130,887737243,113,511,127,4.162790697674419
308,4,4,0,887737243,887737244,1,127,70,3.5833333333333335
308,4,4,0,887737244,887737293,49,70,92,3.7142857142857144
308,4,5,1,887737293,887737334,41,92,201,3.75
308,5,3,-2,887737334,887737383,49,201,237,3.7315436241610738
308,3,5,2,887737383,887737431,48,237,50,4.306532663316583
308,5,4,-1,887737431,887737432,1,50,486,3.9565217391304346
308,4,3,-1,887737432,887737484,52,486,522,3.8461538461538463
308,3,4,1,887737484,887737535,51,522,461,3.3333333333333335
308,4,3,-1,887737535,887737536,1,461,515,4.202898550724638
308,3,4,1,887737536,887737594,58,515,806,3.6666666666666665
308,4,4,0,887737594,887737647,53,806,59,4.0
308,4,4,0,887737647,887737686,39,59,209,3.8275862068965516
308,4,3,-1,887737686,887737760,74,209,60,4.105263157894737
308,3,4,1,887737760,887737890,130,60,429,3.742857142857143
308,4,3,-1,887737890,887737891,1,429,132,3.929411764705882
308,3,4,1,887737891,887737955,64,132,618,3.5
308,4,3,-1,887737955,887737956,1,618,144,3.9545454545454546
308,3,4,1,887737956,887738057,101,144,99,3.8392857142857144
308,4,4,0,887738057,887738152,95,99,154,3.6031746031746033
308,4,4,0,887738152,887738191,39,154,506,3.566666666666667
308,4,3,-1,887738191,887738225,34,506,133,3.7777777777777777
308,3,5,2,887738225,887738268,43,133,408,4.4772727272727275
308,5,5,0,887738268,887738301,33,408,433,3.8035714285714284
308,5,4,-1,887738301,887738346,45,433,1515,4.0
308,4,4,0,887738346,887738470,124,1515,82,3.6741573033707864
308,4,4,0,887738470,887738508,38,82,520,4.136363636363637
308,4,4,0,887738508,887738509,1,520,241,3.5625
308,4,5,1,887738509,887738570,61,241,494,3.8333333333333335
308,5,4,-1,887738570,887738571,1,494,367,3.4242424242424243
308,4,4,0,887738571,887738619,48,367,514,4.033333333333333
308,4,3,-1,887738619,887738620,1,514,117,3.689189189189189
308,3,4,1,887738620,887738664,44,117,655,3.7857142857142856
308,4,4,0,887738664,887738847,183,655,184,3.393939393939394
308,4,5,1,887738847,887738893,46,184,588,3.8358208955223883
308,5,3,-2,887738893,887738894,1,588,109,3.282608695652174
308,3,3,0,887738894,887738972,78,109,73,3.588235294117647
308,3,4,1,887738972,887739014,42,73,671,3.4285714285714284
308,4,4,0,887739014,887739056,42,671,447,3.46875
308,4,4,0,887739056,887739095,39,447,181,3.98974358974359
308,4,4,0,887739095,887739212,117,181,1421,3.2
308,4,3,-1,887739212,887739213,1,1421,615,3.8333333333333335
308,3,4,1,887739213,887739257,44,615,1404,3.875
308,4,3,-1,887739257,887739335,78,1404,959,3.4583333333333335
308,3,4,1,887739335,887739383,48,959,131,3.731707317073171
308,4,3,-1,887739383,887739426,43,131,15,3.725663716814159
308,3,3,0,887739426,887739427,1,15,826,2.5555555555555554
308,3,3,0,887739427,887739472,45,826,291,3.2
308,3,5,2,887739472,887739521,49,291,502,3.272727272727273
308,5,4,-1,887739521,887739639,118,502,739,3.391304347826087
308,4,3,-1,887739639,887739669,30,739,1211,3.5714285714285716
308,3,3,0,887739669,887739670,1,1211,118,3.2764227642276422
308,3,3,0,887739670,887739757,87,118,614,3.727272727272727
308,3,2,-1,887739757,887739800,43,614,616,3.1052631578947367
308,2,3,1,887739800,887739831,31,616,147,3.3142857142857145
308,3,4,1,887739831,887739863,32,147,741,3.3043478260869565
308,4,3,-1,887739863,887739891,28,741,141,3.4827586206896552
308,3,3,0,887739891,887739915,24,141,365,2.95
308,3,3,0,887739915,887739951,36,365,473,2.9166666666666665
308,3,4,1,887739951,887739987,36,473,411,2.911764705882353
308,4,4,0,887739987,887740033,46,411,1045,3.2
308,4,4,0,887740033,887740099,66,1045,501,3.289473684210526
308,4,4,0,887740099,887740216,117,501,420,3.5652173913043477
308,4,3,-1,887740216,887740254,38,420,729,3.3793103448275863
308,3,3,0,887740254,887740410,156,729,660,3.71875
308,3,4,1,887740410,887740451,41,660,72,3.175438596491228
308,4,3,-1,887740451,887740500,49,72,966,4.7
308,3,4,1,887740500,887740568,68,966,88,3.433734939759036
308,4,4,0,887740568,887740603,35,88,605,3.3333333333333335
308,4,4,0,887740603,887740649,46,605,1046,3.3529411764705883
308,4,4,0,887740649,887740700,51,1046,402,3.3076923076923075
308,4,3,-1,887740700,887740729,29,402,21,2.9210526315789473
308,3,4,1,887740729,887740833,104,21,712,3.0434782608695654
308,4,3,-1,887740833,887740866,33,712,448,3.466666666666667
308,3,3,0,887740866,887741003,137,448,449,2.9069767441860463
308,3,3,0,887741003,887741108,105,449,637,2.888888888888889
308,3,4,1,887741108,887741150,42,637,107,3.45
308,4,3,-1,887741150,887741179,29,107,139,2.7222222222222223
308,3,3,0,887741179,887741271,92,139,1074,2.857142857142857
308,3,4,1,887741271,887741329,58,1074,567,3.272727272727273
308,4,5,1,887741329,887741383,54,567,298,3.779220779220779
308,5,4,-1,887741383,887741415,32,298,293,3.630434782608696
308,4,4,0,887741415,887741437,22,293,248,3.746268656716418
308,4,3,-1,887741437,887741461,24,248,295,3.769230769230769
308,3,4,1,887741461,887741526,65,295,257,3.7154471544715446
308,4,4,0,887741526,887741554,28,257,284,3.1547619047619047
308,4,3,-1,887741554,887741604,50,284,1252,3.0
308,3,4,1,887741604,887741693,89,1252,255,3.2027027027027026
308,4,4,0,887741693,887741795,102,255,151,3.6544117647058822
308,4,4,0,887741795,887742103,308,151,928,3.142857142857143
308,4,4,0,887742103,887742165,62,928,122,2.282608695652174
95,3,2,-1,879192597,879192708,111,25,237,3.7315436241610738
95,2,3,1,879192708,879192819,111,237,275,4.087912087912088
95,3,4,1,879192819,879193512,693,275,742,3.5555555555555554
95,4,4,0,879193512,879193619,107,742,117,3.689189189189189
95,4,2,-2,879193619,879193651,32,117,596,3.180327868852459
95,2,3,1,879193651,879193708,57,596,815,3.135135135135135
95,3,3,0,879193708,879193881,173,815,1047,2.6923076923076925
95,3,4,1,879193881,879194012,131,1047,111,3.5106382978723403
95,4,4,0,879194012,879194114,102,111,121,3.521212121212121
95,4,3,-1,879194114,879196298,2184,121,161,3.5844155844155843
95,3,3,0,879196298,879196353,55,161,89,3.9615384615384617
95,3,3,0,879196353,879196408,55,89,241,3.5625
95,3,3,0,879196408,879196513,105,241,265,3.710144927536232
95,3,5,2,879196513,879196566,53,265,210,3.921259842519685
95,5,4,-1,879196566,879196594,28,210,568,3.5853658536585367
95,4,3,-1,879196594,879196629,35,568,431,3.422222222222222
95,3,3,0,879196629,879196665,36,431,449,2.9069767441860463
95,3,2,-1,879196665,879196666,1,449,665,2.72972972972973
95,2,3,1,879196666,879196748,82,665,554,2.9555555555555557
95,3,4,1,879196748,879197021,273,554,209,3.8275862068965516
95,4,4,0,879197021,879197022,1,209,462,3.7954545454545454
95,4,4,0,879197022,879197385,363,462,98,4.240875912408759
95,4,3,-1,879197385,879197445,60,98,498,4.290909090909091
95,3,4,1,879197445,879197500,55,498,48,4.055555555555555
95,4,4,0,879197500,879197562,62,48,523,4.159090909090909
95,4,4,0,879197562,879197603,41,523,28,3.923076923076923
95,4,5,1,879197603,879197652,49,28,178,4.378378378378378
95,5,5,0,879197652,879197685,33,178,64,4.373737373737374
95,5,4,-1,879197685,879197728,43,64,509,3.7058823529411766
95,4,4,0,879197728,879197783,55,509,491,3.55
95,4,3,-1,879197783,879197834,51,491,58,3.543859649122807
95,3,3,0,879197834,879197886,52,58,185,3.9726027397260273
95,3,2,-1,879197886,879197970,84,185,1101,3.793103448275862
95,2,3,1,879197970,879198109,139,1101,95,3.8194444444444446
95,3,4,1,879198109,879198209,100,95,202,3.730337078651685
95,4,4,0,879198209,879198353,144,202,51,3.5277777777777777
95,4,4,0,879198353,879198354,1,51,196,3.9404761904761907
95,4,3,-1,879198354,879198604,250,196,49,3.3
95,3,4,1,879198604,879198652,48,49,97,3.7282608695652173
95,4,3,-1,879198652,879198697,45,97,483,4.475609756097561
95,3,3,0,879198697,879198747,50,483,443,3.8421052631578947
95,3,4,1,879198747,879198800,53,443,52,3.727272727272727
95,4,3,-1,879198800,879198888,88,52,203,3.826923076923077
95,3,3,0,879198888,879198946,58,203,1018,3.0714285714285716
95,3,3,0,879198946,880570852,1371906,1018,180,3.9473684210526314
95,3,4,1,880570852,880570909,57,180,474,4.172413793103448
95,4,5,1,880570909,880570964,55,474,199,4.191489361702128
95,5,3,-2,880570964,880570993,29,199,132,3.929411764705882
95,3,4,1,880570993,880571016,23,132,88,3.433734939759036
95,4,3,-1,880571016,880571045,29,88,671,3.4285714285714284
95,3,5,2,880571045,880571164,119,671,207,3.4761904761904763
95,5,4,-1,880571164,880571226,62,207,507,3.6285714285714286
95,4,3,-1,880571226,880571428,202,507,392,3.5555555555555554
95,3,5,2,880571428,880571456,28,392,660,3.71875
95,5,5,0,880571456,880571479,23,660,423,3.7016129032258065
95,5,3,-2,880571479,880571746,267,423,640,2.75
95,3,3,0,880571746,880571951,205,640,26,3.36
95,3,2,-1,880571951,880572104,153,26,674,2.6875
95,2,4,2,880572104,880572132,28,674,650,3.1363636363636362
95,4,2,-2,880572132,880572166,34,650,447,3.46875
95,2,3,1,880572166,880572218,52,447,63,3.125
95,3,4,1,880572218,880572249,31,63,142,3.1481481481481484
95,4,4,0,880572249,880572250,1,142,139,2.7222222222222223
95,4,4,0,880572250,880572288,38,139,627,3.3823529411764706
95,4,2,-2,880572288,880572323,35,627,110,2.25
95,2,2,0,880572323,880572356,33,110,43,3.1
95,2,3,1,880572356,880572416,60,43,1133,3.076923076923077
95,3,4,1,880572416,880572448,32,1133,843,2.933333333333333
95,4,3,-1,880572448,880572449,1,843,791,3.0
95,3,4,1,880572449,880572474,25,791,102,3.3684210526315788
95,4,2,-2,880572474,880572495,21,102,781,3.4166666666666665
95,2,2,0,880572495,880572581,86,781,1227,2.6
95,2,2,0,880572581,880572602,21,1227,1222,2.6363636363636362
95,2,4,2,880572602,880572628,26,1222,366,3.4285714285714284
95,4,3,-1,880572628,880572658,30,366,1091,2.5384615384615383
95,3,3,0,880572658,880572689,31,1091,1228,2.5
95,3,2,-1,880572689,880572787,98,1228,1188,2.45
95,2,5,3,880572787,880573288,501,1188,91,3.6
95,5,4,-1,880573288,880573627,339,91,631,3.581818181818182
95,4,4,0,880573627,882803989,2230362,631,250,3.4698795180722892
95,4,5,1,882803989,884266051,1462062,250,471,3.5714285714285716
95,5,2,-3,884266051,884266083,32,471,294,3.1052631578947367
95,2,1,-1,884266083,884266100,17,294,862,1.6666666666666667
95,1,2,1,884266100,888954039,4687939,862,542,2.888888888888889
95,2,2,0,888954039,888954076,37,542,514,4.033333333333333
95,2,3,1,888954076,888954170,94,514,648,3.9545454545454546
95,3,4,1,888954170,888954243,73,648,197,4.112676056338028
95,4,2,-2,888954243,888954310,67,197,675,3.625
95,2,3,1,888954310,888954341,31,675,133,3.7777777777777777
95,3,4,1,888954341,888954412,71,133,625,3.25
95,4,4,0,888954412,888954440,28,625,527,3.823529411764706
95,4,5,1,888954440,888954513,73,527,404,3.6578947368421053
95,5,3,-2,888954513,888954552,39,404,506,3.566666666666667
95,3,3,0,888954552,888954609,57,506,855,3.590909090909091
95,3,4,1,888954609,888954631,22,855,141,3.4827586206896552
95,4,4,0,888954631,888954699,68,141,378,3.6904761904761907
95,4,1,-3,888954699,888954726,27,378,32,3.7222222222222223
95,1,4,3,888954726,888954760,34,32,495,3.65
95,4,1,-3,888954760,888954808,48,495,573,2.909090909090909
95,1,2,1,888954808,888954930,122,573,787,2.75
95,2,4,2,888954930,888954961,31,787,416,3.3846153846153846
95,4,4,0,888954961,888956272,1311,416,445,3.727272727272727
95,4,2,-2,888956272,888956400,128,445,712,3.0434782608695654
95,2,1,-1,888956400,888956422,22,712,552,2.8095238095238093
95,1,1,0,888956422,888956489,67,552,1219,3.142857142857143
95,1,3,2,888956489,888956582,93,1219,415,2.6666666666666665
95,3,1,-2,888956582,888956804,222,415,398,2.1
95,1,1,0,888956804,888956869,65,398,1090,2.3529411764705883
95,1,1,0,888956869,888956901,32,1090,1230,1.8888888888888888
95,1,3,2,888956901,888956928,27,1230,395,2.5714285714285716
38,5,5,0,892428216,892428658,442,313,678,2.8181818181818183
38,5,4,-1,892428658,892428688,30,678,328,3.4895833333333335
38,4,5,1,892428688,892429225,537,328,588,3.8358208955223883
38,5,4,-1,892429225,892429399,174,588,28,3.923076923076923
38,4,5,1,892429399,892429460,61,28,247,3.0
38,5,1,-4,892429460,892429512,52,247,257,3.7154471544715446
38,1,5,4,892429512,892429567,55,257,252,2.911392405063291
38,5,2,-3,892429567,892429873,306,252,133,3.7777777777777777
38,2,5,3,892429873,892429903,30,133,82,3.6741573033707864
38,5,1,-4,892429903,892429952,49,82,195,3.9072164948453607
38,1,5,4,892429952,892430001,49,195,742,3.5555555555555554
38,5,5,0,892430001,892430120,119,742,392,3.5555555555555554
38,5,2,-3,892430120,892430309,189,392,356,3.2
38,2,5,3,892430309,892430369,60,356,153,3.7865168539325844
38,5,5,0,892430369,892430516,147,153,71,3.6575342465753424
38,5,5,0,892430516,892430539,23,71,402,3.3076923076923075
38,5,5,0,892430539,892430636,97,402,1,3.902439024390244
38,5,5,0,892430636,892430829,193,1,99,3.8392857142857144
38,5,5,0,892430829,892430937,108,99,84,3.0
38,5,5,0,892430937,892431026,89,84,418,3.825
38,5,5,0,892431026,892431151,125,418,118,3.2764227642276422
38,5,5,0,892431151,892431586,435,118,404,3.6578947368421053
38,5,5,0,892431586,892431607,21,404,234,3.7674418604651163
38,5,2,-3,892431607,892431665,58,234,202,3.730337078651685
38,2,5,3,892431665,892431727,62,202,451,3.207792207792208
38,5,3,-2,892431727,892431871,144,451,218,3.5555555555555554
38,3,1,-2,892431871,892431907,36,218,211,3.958904109589041
38,1,5,4,892431907,892432030,123,211,94,2.8823529411764706
38,5,5,0,892432030,892432062,32,94,161,3.5844155844155843
38,5,5,0,892432062,892432090,28,161,155,3.0588235294117645
38,5,1,-4,892432090,892432205,115,155,403,3.298507462686567
38,1,5,4,892432205,892432476,271,403,465,3.75
38,5,5,0,892432476,892432531,55,465,1033,3.0
38,5,2,-3,892432531,892432573,42,1033,185,3.9726027397260273
38,2,3,1,892432573,892432624,51,185,424,1.4
38,3,3,0,892432624,892432750,126,424,410,3.0434782608695654
38,3,5,2,892432750,892432751,1,410,112,2.7
38,5,2,-3,892432751,892432786,35,112,139,2.7222222222222223
38,2,3,1,892432786,892433290,504,139,411,2.911764705882353
38,3,3,0,892433290,892433375,85,411,616,3.1052631578947367
38,3,2,-1,892433375,892433680,305,616,838,2.0
38,2,4,2,892433680,892433704,24,838,1036,3.0
38,4,5,1,892433704,892433801,97,1036,1031,2.6
38,5,1,-4,892433801,892433912,111,1031,444,2.6842105263157894
38,1,1,0,892433912,892433945,33,444,717,2.9696969696969697
38,1,1,0,892433945,892434036,91,717,400,2.375
38,1,3,2,892434036,892434164,128,400,395,2.5714285714285716
38,3,3,0,892434164,892434217,53,395,105,2.6176470588235294
38,3,2,-1,892434217,892434251,34,105,406,2.5294117647058822
38,2,4,2,892434251,892434283,32,406,1037,2.0
38,4,4,0,892434283,892434312,29,1037,67,3.106382978723404
38,4,1,-3,892434312,892434373,61,67,590,1.8888888888888888
38,1,5,4,892434373,892434430,57,590,447,3.46875
38,5,2,-3,892434430,892434452,22,447,637,2.888888888888889
38,2,5,3,892434452,892434475,23,637,1030,2.3636363636363638
38,5,5,0,892434475,892434523,48,1030,452,2.6129032258064515
38,5,1,-4,892434523,892434626,103,452,413,2.5652173913043477
38,1,1,0,892434626,892434742,116,413,940,2.4
38,1,3,2,892434742,892434800,58,940,672,2.7222222222222223
38,3,1,-2,892434800,892434801,1,672,122,2.282608695652174
102,4,4,0,875886434,879082395,3195961,319,612,4.0
102,4,3,-1,879082395,883277645,4195250,612,322,3.0476190476190474
102,3,2,-1,883277645,883278200,555,322,1025,2.95
102,2,2,0,883278200,883748352,470152,1025,993,3.4838709677419355
102,2,2,0,883748352,883748418,66,993,501,3.289473684210526
102,2,3,1,883748418,883748450,32,501,418,3.825
102,3,4,1,883748450,883748488,38,418,95,3.8194444444444446
102,4,2,-2,883748488,887051723,3303235,95,338,2.75
102,2,3,1,887051723,888801063,1749340,338,650,3.1363636363636362
102,3,2,-1,888801063,888801316,253,650,127,4.162790697674419
102,2,3,1,888801316,888801360,44,127,56,4.051724137931035
102,3,2,-1,888801360,888801406,46,56,181,3.98974358974359
102,2,3,1,888801406,888801407,1,181,511,4.096153846153846
102,3,3,0,888801407,888801465,58,511,823,2.75
102,3,3,0,888801465,888801522,57,823,210,3.921259842519685
102,3,2,-1,888801522,888801622,100,210,38,2.784313725490196
102,2,3,1,888801622,888801623,1,38,229,3.185185185185185
102,3,2,-1,888801623,888801812,189,229,405,3.25
102,2,3,1,888801812,888801876,64,405,546,2.9789473684210526
102,3,3,0,888801876,888802038,162,546,241,3.5625
102,3,1,-2,888802038,888802319,281,241,986,2.5555555555555554
102,1,2,1,888802319,888802722,403,986,827,2.4375
102,2,2,0,888802722,888802767,45,827,391,2.4285714285714284
102,2,1,-1,888802767,888802768,1,391,450,2.2758620689655173
102,1,4,3,888802768,888802939,171,450,98,4.240875912408759
102,4,3,-1,888802939,888802940,1,98,185,3.9726027397260273
102,3,3,0,888802940,888803052,112,185,559,3.477272727272727
102,3,2,-1,888803052,888803149,97,559,219,2.735294117647059
102,2,1,-1,888803149,888803245,96,219,760,2.35
102,1,2,1,888803245,888803395,150,760,565,2.4285714285714284
102,2,4,2,888803395,888803487,92,565,204,3.6744186046511627
102,4,3,-1,888803487,888803488,1,204,629,3.3333333333333335
102,3,3,0,888803488,888803537,49,629,524,4.166666666666667
102,3,3,0,888803537,888803602,65,524,72,3.175438596491228
102,3,3,0,888803602,888803708,106,72,154,3.6031746031746033
102,3,3,0,888803708,888803738,30,154,502,3.272727272727273
102,3,3,0,888803738,888803802,64,502,655,3.7857142857142856
102,3,3,0,888803802,892991118,4187316,655,13,3.5454545454545454
102,3,3,0,892991118,892991311,193,13,88,3.433734939759036
102,3,2,-1,892991311,892991376,65,88,153,3.7865168539325844
102,2,3,1,892991376,892991448,72,153,778,3.5925925925925926
102,3,3,0,892991448,892993302,1854,778,393,3.5125
102,3,3,0,892993302,892993605,303,393,235,3.106382978723404
102,3,2,-1,892993605,892993735,130,235,396,2.84
102,2,2,0,892993735,892993786,51,396,411,2.911764705882353
102,2,2,0,892993786,892993827,41,411,384,2.7941176470588234
102,2,2,0,892993827,892993927,100,384,167,2.8181818181818183
102,2,2,0,892993927,892993983,56,167,1052,2.4545454545454546
102,2,1,-1,892993983,892994075,92,1052,1030,2.3636363636363638
63,4,3,-1,875746917,875746948,31,333,288,3.5214285714285714
63,3,2,-1,875746948,875746986,38,288,322,3.0476190476190474
63,2,4,2,875746986,875747010,24,322,748,3.1043478260869564
63,4,2,-2,875747010,875747047,37,748,294,3.1052631578947367
63,2,3,1,875747047,875747190,143,294,242,3.5217391304347827
63,3,4,1,875747190,875747242,52,242,408,4.4772727272727275
63,4,5,1,875747242,875747265,23,408,813,4.055555555555555
63,5,4,-1,875747265,875747292,27,813,25,3.3185840707964602
63,4,4,0,875747292,875747319,27,25,475,3.956043956043956
63,4,3,-1,875747319,875747342,23,475,257,3.7154471544715446
63,3,5,2,875747342,875747368,26,257,1007,4.117647058823529
63,5,4,-1,875747368,875747401,33,1007,277,3.6
63,4,4,0,875747401,875747439,38,277,13,3.5454545454545454
63,4,2,-2,875747439,875747470,31,13,596,3.180327868852459
63,2,3,1,875747470,875747514,44,596,246,4.0
63,3,3,0,875747514,875747556,42,246,181,3.98974358974359
63,3,3,0,875747556,875747581,25,181,284,3.1547619047619047
63,3,4,1,875747581,875747635,54,284,224,3.4545454545454546
63,4,1,-3,875747635,875747657,22,224,282,3.610526315789474
63,1,4,3,875747657,875747731,74,282,109,3.282608695652174
63,4,4,0,875747731,875747752,21,109,508,3.6923076923076925
63,4,2,-2,875747752,875747789,37,508,1138,3.0
63,2,3,1,875747789,875747829,40,1138,287,3.4516129032258065
63,3,3,0,875747829,875747854,25,287,1012,3.2916666666666665
63,3,3,0,875747854,875747896,42,1012,111,3.5106382978723403
63,3,1,-2,875747896,875747917,21,111,841,2.772727272727273
63,1,1,0,875747917,875747936,19,841,828,3.0
63,1,3,2,875747936,875747955,19,828,929,2.8421052631578947
63,3,4,1,875747955,875748004,49,929,10,3.85
63,4,2,-2,875748004,875748068,64,10,3,3.0625
63,2,3,1,875748068,875748109,41,3,412,2.272727272727273
63,3,2,-1,875748109,875748139,30,412,106,2.8125
63,2,3,1,875748139,875748164,25,106,924,3.3703703703703702
63,3,3,0,875748164,875748198,34,924,1028,2.857142857142857
63,3,4,1,875748198,875748326,128,1028,300,3.6861313868613137
160,4,4,0,876767440,876767572,132,150,50,4.306532663316583
160,4,3,-1,876767572,876767621,49,50,933,2.5
160,3,5,2,876767621,876767660,39,933,273,3.5238095238095237
160,5,4,-1,876767660,876767822,162,273,117,3.689189189189189
160,4,5,1,876767822,876768106,284,117,276,3.6036036036036037
160,5,4,-1,876768106,876768949,843,276,123,3.297872340425532
160,4,4,0,876768949,876768990,41,123,13,3.5454545454545454
160,4,3,-1,876768990,876769148,158,13,762,3.3962264150943398
160,3,5,2,876769148,876770168,1020,762,187,4.215189873417722
160,5,5,0,876770168,876770311,143,187,182,3.842857142857143
160,5,4,-1,876770311,876858091,87780,182,11,3.8904109589041096
160,4,4,0,876858091,876860808,2717,11,175,3.8354430379746836
160,4,4,0,876860808,876861799,991,175,61,4.190476190476191
160,4,4,0,876861799,876861878,79,61,218,3.5555555555555554
160,4,5,1,876861878,876862243,365,218,484,4.116279069767442
160,5,3,-2,876862243,878078096,1215853,484,328,3.4895833333333335
160,3,3,0,878078096,878078115,19,328,325,2.625
50,3,5,2,877052093,877052167,74,327,475,3.956043956043956
50,5,4,-1,877052167,877052297,130,475,9,3.8878504672897196
50,4,3,-1,877052297,877052329,32,9,246,4.0
50,3,1,-2,877052329,877052400,71,246,325,2.625
50,1,2,1,877052400,877052438,38,325,15,3.725663716814159
50,2,5,3,877052438,877052501,63,15,1084,4.0
50,5,5,0,877052501,877052550,49,1084,253,3.5
50,5,5,0,877052550,877052805,255,253,1008,3.5
50,5,4,-1,877052805,877052958,153,1008,123,3.297872340425532
301,4,4,0,882074262,882074291,29,127,288,3.5214285714285714
301,4,4,0,882074291,882074312,21,288,24,3.3728813559322033
301,4,4,0,882074312,882074345,33,24,1,3.902439024390244
301,4,1,-3,882074345,882074384,39,1,276,3.6036036036036037
301,1,2,1,882074384,882074408,24,276,235,3.106382978723404
301,2,4,2,882074408,882074437,29,235,742,3.5555555555555554
301,4,4,0,882074437,882074460,23,742,15,3.725663716814159
301,4,4,0,882074460,882074561,101,15,282,3.610526315789474
301,4,5,1,882074561,882074584,23,282,117,3.689189189189189
301,5,4,-1,882074584,882074613,29,117,1012,3.2916666666666665
301,4,4,0,882074613,882074665,52,1012,763,3.347826086956522
301,4,4,0,882074665,882074684,19,763,1016,3.559322033898305
301,4,1,-3,882074684,882074708,24,1016,111,3.5106382978723403
301,1,4,3,882074708,882074726,18,111,123,3.297872340425532
301,4,4,0,882074726,882074727,1,123,405,3.25
301,4,2,-2,882074727,882074776,49,405,151,3.6544117647058822
301,2,1,-1,882074776,882074800,24,151,273,3.5238095238095237
301,1,3,2,882074800,882074801,1,273,249,3.3275862068965516
301,3,2,-1,882074801,882074818,17,249,122,2.282608695652174
301,2,1,-1,882074818,882074867,49,122,411,2.911764705882353
301,1,4,3,882074867,882074932,65,411,756,2.6885245901639343
301,4,3,-1,882074932,882075055,123,756,824,2.590909090909091
301,3,2,-1,882075055,882075082,27,824,3,3.0625
301,2,4,2,882075082,882075110,28,3,323,3.0
301,4,4,0,882075110,882075148,38,323,871,2.3823529411764706
301,4,4,0,882075148,882075171,23,871,866,3.3962264150943398
301,4,2,-2,882075171,882075202,31,866,407,2.611111111111111
301,2,4,2,882075202,882075242,40,407,409,2.9615384615384617
301,4,4,0,882075242,882075338,96,409,831,2.6097560975609757
301,4,2,-2,882075338,882075356,18,831,743,1.9545454545454546
301,2,2,0,882075356,882075386,30,743,678,2.8181818181818183
301,2,5,3,882075386,882075432,46,678,269,4.085106382978723
301,5,4,-1,882075432,882075454,22,269,333,3.546666666666667
301,4,4,0,882075454,882075473,19,333,271,3.3134328358208953
301,4,3,-1,882075473,882075520,47,271,299,3.0
301,3,4,1,882075520,882075672,152,299,265,3.710144927536232
301,4,3,-1,882075672,882075743,71,265,153,3.7865168539325844
301,3,3,0,882075743,882075774,31,153,746,3.7560975609756095
301,3,4,1,882075774,882075775,1,746,427,4.2025316455696204
301,4,4,0,882075775,882075803,28,427,474,4.172413793103448
301,4,4,0,882075803,882075827,24,474,481,3.8421052631578947
301,4,4,0,882075827,882075859,32,481,22,4.215909090909091
301,4,4,0,882075859,882075962,103,22,73,3.588235294117647
301,4,5,1,882075962,882075994,32,73,651,3.8627450980392157
301,5,2,-3,882075994,882076021,27,651,157,3.5714285714285716
301,2,2,0,882076021,882076046,25,157,89,3.9615384615384617
301,2,3,1,882076046,882076072,26,89,419,3.8208955223880596
301,3,4,1,882076072,882076098,26,419,156,4.017857142857143
301,4,4,0,882076098,882076121,23,156,97,3.7282608695652173
301,4,4,0,882076121,882076146,25,97,523,4.159090909090909
301,4,1,-3,882076146,882076187,41,523,655,3.7857142857142856
301,1,4,3,882076187,882076211,24,655,210,3.921259842519685
301,4,4,0,882076211,882076238,27,210,527,3.823529411764706
301,4,4,0,882076238,882076239,1,527,199,4.191489361702128
301,4,5,1,882076239,882076264,25,199,204,3.6744186046511627
301,5,3,-2,882076264,882076291,27,204,183,3.951219512195122
301,3,5,2,882076291,882076334,43,183,95,3.8194444444444446
301,5,4,-1,882076334,882076403,69,95,483,4.475609756097561
301,4,3,-1,882076403,882076463,60,483,31,3.642857142857143
301,3,3,0,882076463,882076494,31,31,179,3.8823529411764706
301,3,4,1,882076494,882076538,44,179,568,3.5853658536585367
301,4,4,0,882076538,882076558,20,568,502,3.272727272727273
301,4,3,-1,882076558,882076587,29,502,54,3.3714285714285714
301,3,4,1,882076587,882076619,32,54,367,3.4242424242424243
301,4,4,0,882076619,882076643,24,367,218,3.5555555555555554
301,4,5,1,882076643,882076682,39,218,69,3.8015873015873014
301,5,3,-2,882076682,882076751,69,69,77,3.3857142857142857
301,3,4,1,882076751,882076782,31,77,216,3.8454545454545452
301,4,5,1,882076782,882076806,24,216,693,3.6285714285714286
301,5,3,-2,882076806,882076890,84,693,606,4.294117647058823
301,3,2,-1,882076890,882076915,25,606,402,3.3076923076923075
301,2,4,2,882076915,882076936,21,402,47,3.5869565217391304
301,4,4,0,882076936,882076967,31,47,426,3.1
301,4,3,-1,882076967,882076987,20,426,521,3.787878787878788
301,3,4,1,882076987,882077033,46,521,425,3.7027027027027026
301,4,3,-1,882077033,882077055,22,425,385,3.6129032258064515
301,3,5,2,882077055,882077078,23,385,82,3.6741573033707864
301,5,4,-1,882077078,882077142,64,82,88,3.433734939759036
301,4,5,1,882077142,882077222,80,88,226,3.378787878787879
301,5,3,-2,882077222,882077256,34,226,562,3.2941176470588234
301,3,2,-1,882077256,882077284,28,562,160,3.4
301,2,4,2,882077284,882077285,1,160,58,3.543859649122807
301,4,3,-1,882077285,882077330,45,58,684,3.847826086956522
301,3,4,1,882077330,882077351,21,684,732,3.6266666666666665
301,4,4,0,882077351,882077811,460,732,465,3.75
301,4,4,0,882077811,882077836,25,465,196,3.9404761904761907
301,4,2,-2,882077836,882077871,35,196,735,3.58
301,2,4,2,882077871,882077872,1,735,233,3.323529411764706
301,4,4,0,882077872,882078008,136,233,443,3.8421052631578947
301,4,3,-1,882078008,882078084,76,443,387,3.5357142857142856
301,3,4,1,882078084,882078199,115,387,470,3.72
301,4,3,-1,882078199,882078267,68,470,552,2.8095238095238093
301,3,3,0,882078267,882078287,20,552,162,3.4651162790697674
301,3,4,1,882078287,882078308,21,162,755,3.085714285714286
301,4,4,0,882078308,882078326,18,755,363,3.0
301,4,3,-1,882078326,882078360,34,363,90,3.0
301,3,4,1,882078360,882078419,59,90,99,3.8392857142857144
301,4,3,-1,882078419,882078420,1,99,142,3.1481481481481484
301,3,4,1,882078420,882078459,39,142,380,3.4878048780487805
301,4,4,0,882078459,882078492,33,380,29,2.5714285714285716
301,4,4,0,882078492,882078558,66,29,797,3.1538461538461537
301,4,2,-2,882078558,882078580,22,797,231,2.938775510204082
301,2,2,0,882078580,882078621,41,231,67,3.106382978723404
301,2,3,1,882078621,882078735,114,67,393,3.5125
301,3,4,1,882078735,882078778,43,393,959,3.4583333333333335
301,4,4,0,882078778,882078809,31,959,1035,3.03125
301,4,3,-1,882078809,882078830,21,1035,554,2.9555555555555557
301,3,1,-2,882078830,882078882,52,554,631,3.581818181818182
301,1,3,2,882078882,882078883,1,631,80,2.967741935483871
301,3,2,-1,882078883,882078906,23,80,737,3.12
301,2,4,2,882078906,882078928,22,737,51,3.5277777777777777
301,4,4,0,882078928,882078955,27,51,559,3.477272727272727
301,4,5,1,882078955,882078994,39,559,43,3.1
301,5,4,-1,882078994,882079199,205,43,576,3.125
301,4,1,-3,882079199,882079221,22,576,1230,1.8888888888888888
301,1,2,1,882079221,882079256,35,1230,771,2.5714285714285716
301,2,4,2,882079256,882079294,38,771,1112,2.9
301,4,5,1,882079294,882079315,21,1112,384,2.7941176470588234
301,5,2,-3,882079315,882079334,19,384,665,2.72972972972973
301,2,3,1,882079334,882079353,19,665,1091,2.5384615384615383
301,3,2,-1,882079353,882079423,70,1091,120,2.3421052631578947
301,2,3,1,882079423,882079446,23,120,41,3.0625
301,3,3,0,882079446,882079503,57,41,217,3.1538461538461537
301,3,4,1,882079503,882079542,39,217,719,2.6666666666666665
225,5,5,0,879539615,879539643,28,427,237,3.7315436241610738
225,5,5,0,879539643,879539672,29,237,510,3.823529411764706
225,5,4,-1,879539672,879539727,55,510,64,4.373737373737374
225,4,5,1,879539727,879539767,40,64,478,4.161290322580645
225,5,5,0,879539767,879540678,911,478,22,4.215909090909091
225,5,5,0,879540678,879540707,29,22,136,3.764705882352941
225,5,2,-3,879540707,879540748,41,136,143,3.56
225,2,5,3,879540748,879540778,30,143,1203,4.0
290,2,3,1,880473415,880473474,59,683,243,2.357142857142857
290,3,4,1,880473474,880473556,82,243,228,3.7246376811594204
290,4,1,-3,880473556,880473557,1,228,449,2.9069767441860463
290,1,5,4,880473557,880473582,25,449,50,4.306532663316583
290,5,2,-3,880473582,880473583,1,50,62,3.048780487804878
290,2,5,3,880473583,880473667,84,62,71,3.6575342465753424
290,5,5,0,880473667,880473696,29,71,181,3.98974358974359
290,5,3,-2,880473696,880473734,38,181,520,4.136363636363637
290,3,3,0,880473734,880473735,1,520,699,3.736842105263158
290,3,4,1,880473735,880473776,41,699,318,4.5046728971962615
290,4,4,0,880473776,880473777,1,318,498,4.290909090909091
290,4,3,-1,880473777,880473802,25,498,144,3.9545454545454546
290,3,5,2,880473802,880473891,89,144,174,4.253521126760563
290,5,3,-2,880473891,880473918,27,174,515,4.202898550724638
290,3,5,2,880473918,880473942,24,515,22,4.215909090909091
290,5,3,-2,880473942,880473971,29,22,89,3.9615384615384617
290,3,3,0,880473971,880473993,22,89,132,3.929411764705882
290,3,3,0,880473993,880474034,41,132,651,3.8627450980392157
290,3,4,1,880474034,880474054,20,651,183,3.951219512195122
290,4,3,-1,880474054,880474107,53,183,162,3.4651162790697674
290,3,4,1,880474107,880474141,34,162,596,3.180327868852459
290,4,4,0,880474141,880474156,15,596,496,4.094594594594595
290,4,3,-1,880474156,880474174,18,496,484,4.116279069767442
290,3,3,0,880474174,880474204,30,484,622,3.3333333333333335
290,3,5,2,880474204,880474235,31,622,28,3.923076923076923
290,5,4,-1,880474235,880474293,58,28,196,3.9404761904761907
290,4,5,1,880474293,880474327,34,196,1,3.902439024390244
290,5,4,-1,880474327,880474367,40,1,136,3.764705882352941
290,4,4,0,880474367,880474422,55,136,402,3.3076923076923075
290,4,2,-2,880474422,880474451,29,402,239,3.423076923076923
290,2,4,2,880474451,880474494,43,239,15,3.725663716814159
290,4,4,0,880474494,880474510,16,15,135,3.7974683544303796
290,4,4,0,880474510,880474590,80,135,527,3.823529411764706
290,4,4,0,880474590,880474606,16,527,429,3.742857142857143
290,4,4,0,880474606,880474652,46,429,588,3.8358208955223883
290,4,3,-1,880474652,880474716,64,588,568,3.5853658536585367
290,3,4,1,880474716,880474740,24,568,141,3.4827586206896552
290,4,3,-1,880474740,880474799,59,141,199,4.191489361702128
290,3,2,-1,880474799,880474835,36,199,151,3.6544117647058822
290,2,5,3,880474835,880474977,142,151,158,2.7027027027027026
290,5,3,-2,880474977,880475016,39,158,97,3.7282608695652173
290,3,4,1,880475016,880475032,16,97,31,3.642857142857143
290,4,3,-1,880475032,880475169,137,31,393,3.5125
290,3,4,1,880475169,880475218,49,393,216,3.8454545454545452
290,4,3,-1,880475218,880475245,27,216,208,3.8125
290,3,4,1,880475245,880475266,21,208,121,3.521212121212121
290,4,2,-2,880475266,880475310,44,121,742,3.5555555555555554
290,2,3,1,880475310,880475341,31,742,404,3.6578947368421053
290,3,2,-1,880475341,880475469,128,404,436,3.5
290,2,4,2,880475469,880475495,26,436,472,2.984375
290,4,2,-2,880475495,880475542,47,472,403,3.298507462686567
290,2,2,0,880475542,880475564,22,403,546,2.9789473684210526
290,2,3,1,880475564,880475565,1,546,1285,3.1
290,3,3,0,880475565,880475585,20,1285,102,3.3684210526315788
290,3,2,-1,880475585,880475625,40,102,650,3.1363636363636362
290,2,4,2,880475625,880475664,39,650,809,2.7058823529411766
290,4,3,-1,880475664,880475695,31,809,720,3.2
290,3,2,-1,880475695,880475735,40,720,1091,2.5384615384615383
290,2,4,2,880475735,880475757,22,1091,1047,2.6923076923076925
290,4,4,0,880475757,880475782,25,1047,1035,3.03125
290,4,3,-1,880475782,880475783,1,1035,43,3.1
290,3,3,0,880475783,880475807,24,43,550,3.272727272727273
290,3,4,1,880475807,880731778,255971,550,222,3.578125
290,4,4,0,880731778,880731874,96,222,274,3.5609756097560976
290,4,4,0,880731874,880731896,22,274,118,3.2764227642276422
290,4,4,0,880731896,880731963,67,118,66,3.4705882352941178
290,4,2,-2,880731963,880732131,168,66,1013,2.388888888888889
290,2,3,1,880732131,880732271,140,1013,1060,3.235294117647059
290,3,2,-1,880732271,880732365,94,1060,405,3.25
290,2,3,1,880732365,880732491,126,405,832,2.7142857142857144
290,3,3,0,880732491,880732538,47,832,926,2.7857142857142856
290,3,3,0,880732538,880732575,37,926,252,2.911392405063291
290,3,3,0,880732575,880732656,81,252,818,2.769230769230769
290,3,4,1,880732656,880732712,56,818,120,2.3421052631578947
290,4,2,-2,880732712,880732753,41,120,105,2.6176470588235294
290,2,2,0,880732753,880732771,18,105,1079,2.1923076923076925
97,5,4,-1,884238693,884238728,35,482,98,4.240875912408759
97,4,4,0,884238728,884238752,24,98,435,3.8933333333333335
97,4,2,-2,884238752,884238817,65,435,205,3.717391304347826
97,2,3,1,884238817,884238860,43,205,194,4.029411764705882
97,3,4,1,884238860,884238887,27,194,189,3.88
97,4,4,0,884238887,884238911,24,189,1,3.902439024390244
97,4,3,-1,884238911,884238966,55,1,484,4.116279069767442
97,3,5,2,884238966,884239471,505,484,50,4.306532663316583
97,5,5,0,884239471,884239472,1,50,191,4.168674698795181
97,5,5,0,884239472,884239525,53,191,115,3.6666666666666665
97,5,5,0,884239525,884239616,91,115,69,3.8015873015873014
97,5,1,-4,884239616,884239655,39,69,133,3.7777777777777777
97,1,5,4,884239655,884239686,31,133,153,3.7865168539325844
97,5,3,-2,884239686,884239687,1,153,1126,3.625
97,3,5,2,884239687,884239712,25,1126,96,3.9130434782608696
97,5,5,0,884239712,884239744,32,96,208,3.8125
97,5,5,0,884239744,884239791,47,208,32,3.7222222222222223
157,5,5,0,886889729,886889876,147,268,273,3.5238095238095237
157,5,2,-3,886889876,886890015,139,273,748,3.1043478260869564
157,2,5,3,886890015,886890341,326,748,1016,3.559322033898305
157,5,5,0,886890341,886890342,1,1016,147,3.3142857142857145
157,5,3,-2,886890342,886890372,30,147,685,3.2666666666666666
157,3,3,0,886890372,886890406,34,685,597,3.2771084337349397
157,3,4,1,886890406,886890541,135,597,50,4.306532663316583
157,4,4,0,886890541,886890692,151,50,283,3.901639344262295
157,4,5,1,886890692,886890712,20,283,508,3.6923076923076925
157,5,3,-2,886890712,886890734,22,508,3,3.0625
157,3,4,1,886890734,886890855,121,3,410,3.0434782608695654
157,4,2,-2,886890855,886890878,23,410,934,3.0294117647058822
157,2,2,0,886890878,886891173,295,934,1283,2.9
157,2,3,1,886891173,886891194,21,1283,1244,2.7777777777777777
157,3,4,1,886891194,886891218,24,1244,407,2.611111111111111
157,4,1,-3,886891218,886891243,25,407,120,2.3421052631578947
181,3,4,1,878961227,878961270,43,328,270,3.7804878048780486
181,4,2,-2,878961270,878961303,33,270,301,3.2465753424657535
181,2,2,0,878961303,878961304,1,301,323,3.0
181,2,4,2,878961304,878961332,28,323,289,2.988888888888889
181,4,2,-2,878961332,878961369,37,289,678,2.8181818181818183
181,2,1,-1,878961369,878961474,105,678,681,2.25
181,1,3,2,878961474,878961511,37,681,690,3.260869565217391
181,3,2,-1,878961511,878961542,31,690,879,3.2291666666666665
181,2,1,-1,878961542,878961585,43,879,995,3.0
181,1,1,0,878961585,878961586,1,995,938,2.5555555555555554
181,1,2,1,878961586,878961623,37,938,321,3.0172413793103448
181,2,1,-1,878961623,878961668,45,321,330,2.625
181,1,2,1,878961668,878961709,41,330,336,2.4
181,2,1,-1,878961709,878961748,39,336,335,2.5
181,1,1,0,878961748,878961749,1,335,299,3.0
181,1,3,2,878961749,878961780,31,299,327,3.5076923076923077
181,3,3,0,878961780,878961781,1,327,937,3.5
181,3,1,-2,878961781,878961814,33,937,243,2.357142857142857
181,1,1,0,878961814,878962006,192,243,1296,3.2222222222222223
181,1,1,0,878962006,878962051,45,1296,1385,1.0
181,1,1,0,878962051,878962052,1,1385,1330,2.0
181,1,1,0,878962052,878962086,34,1330,1383,1.0
181,1,1,0,878962086,878962119,33,1383,1360,1.0
181,1,1,0,878962119,878962120,1,1360,1358,1.0
181,1,1,0,878962120,878962168,48,1358,1388,2.0
181,1,1,0,878962168,878962169,1,1388,1341,1.0
181,1,1,0,878962169,878962199,30,1341,1369,2.0
181,1,1,0,878962199,878962200,1,1369,1174,2.0
181,1,1,0,878962200,878962240,40,1174,1352,1.0
181,1,1,0,878962240,878962278,38,1352,1349,1.0
181,1,1,0,878962278,878962279,1,1349,1320,1.0
181,1,1,0,878962279,878962349,70,1320,1312,2.8333333333333335
181,1,3,2,878962349,878962350,1,1312,458,3.0588235294117645
181,3,1,-2,878962350,878962464,114,458,1364,1.0
181,1,1,0,878962464,878962465,1,1364,985,2.9
181,1,1,0,878962465,878962496,31,985,1165,1.8
181,1,2,1,878962496,878962585,89,1165,126,3.8620689655172415
181,2,1,-1,878962585,878962586,1,126,456,2.2
181,1,1,0,878962586,878962623,37,456,1081,2.6666666666666665
181,1,1,0,878962623,878962719,96,1081,149,2.4
181,1,2,1,878962719,878962720,1,149,475,3.956043956043956
181,2,1,-1,878962720,878962773,53,475,1284,2.5454545454545454
181,1,2,1,878962773,878962774,1,1284,864,3.2142857142857144
181,2,2,0,878962774,878962816,42,864,285,4.181818181818182
181,2,1,-1,878962816,878962866,50,285,104,1.0
181,1,1,0,878962866,878962918,52,104,741,3.3043478260869565
181,1,2,1,878962918,878962919,1,741,546,2.9789473684210526
181,2,2,0,878962919,878962955,36,546,10,3.85
181,2,2,0,878962955,878962996,41,10,284,3.1547619047619047
181,2,1,-1,878962996,878962997,1,284,1040,2.2666666666666666
181,1,4,3,878962997,878963037,40,1040,7,3.76056338028169
181,4,2,-2,878963037,878963038,1,7,281,3.2
181,2,2,0,878963038,878963085,47,281,740,3.423076923076923
181,2,1,-1,878963085,878963121,36,740,932,2.5
181,1,1,0,878963121,878963122,1,932,1049,2.5714285714285716
181,1,2,1,878963122,878963167,45,1049,106,2.8125
181,2,2,0,878963167,878963168,1,106,871,2.3823529411764706
181,2,1,-1,878963168,878963204,36,871,1011,3.1
181,1,1,0,878963204,878963205,1,1011,931,2.2758620689655173
181,1,3,2,878963205,878963241,36,931,928,3.142857142857143
181,3,2,-1,878963241,878963275,34,928,1048,2.857142857142857
181,2,1,-1,878963275,878963304,29,1048,1215,2.0714285714285716
181,1,1,0,878963304,878963305,1,1215,978,2.357142857142857
181,1,1,0,878963305,878963343,38,978,107,3.45
181,1,1,0,878963343,878963380,37,107,472,2.984375
181,1,1,0,878963380,878963381,1,472,1102,2.6
181,1,4,3,878963381,878963417,36,1102,974,3.125
181,4,2,-2,878963417,878963440,23,974,278,3.0357142857142856
181,2,2,0,878963440,878963441,1,278,1052,2.4545454545454546
278,3,2,-1,891294959,891294980,21,302,301,3.2465753424657535
278,2,3,1,891294980,891295007,27,301,882,3.6666666666666665
278,3,5,2,891295007,891295043,36,882,306,4.033333333333333
278,5,5,0,891295043,891295044,1,306,286,3.442857142857143
278,5,3,-2,891295044,891295099,55,286,258,3.7547169811320753
278,3,4,1,891295099,891295130,31,258,311,3.761904761904762
278,4,5,1,891295130,891295164,34,311,752,3.6666666666666665
278,5,3,-2,891295164,891295230,66,752,245,3.056179775280899
278,3,5,2,891295230,891295330,100,245,923,4.142857142857143
276,4,3,-1,874786366,874786392,26,294,322,3.0476190476190474
276,3,3,0,874786392,874786419,27,322,678,2.8181818181818183
276,3,3,0,874786419,874786439,20,678,260,2.4716981132075473
276,3,5,2,874786439,874786488,49,260,181,3.98974358974359
276,5,5,0,874786488,874786517,29,181,7,3.76056338028169
276,5,4,-1,874786517,874786538,21,7,628,3.573529411764706
276,4,4,0,874786538,874786568,30,628,117,3.689189189189189
276,4,5,1,874786568,874786605,37,117,100,4.0162162162162165
276,5,2,-3,874786605,874786632,27,100,696,3.138888888888889
276,2,4,2,874786632,874786657,25,696,123,3.297872340425532
276,4,4,0,874786657,874786686,29,123,147,3.3142857142857145
276,4,4,0,874786686,874786756,70,147,742,3.5555555555555554
276,4,3,-1,874786756,874786784,28,742,1010,3.611111111111111
276,3,4,1,874786784,874786807,23,1010,411,2.911764705882353
276,4,4,0,874786807,874786876,69,411,1129,3.4444444444444446
276,4,4,0,874786876,874786897,21,1129,121,3.521212121212121
276,4,4,0,874786897,874786924,27,121,150,3.803921568627451
276,4,2,-2,874786924,874786945,21,150,974,3.125
276,2,3,1,874786945,874786964,19,974,118,3.2764227642276422
276,3,3,0,874786964,874787006,42,118,252,2.911392405063291
276,3,3,0,874787006,874787044,38,252,1028,2.857142857142857
276,3,2,-1,874787044,874787090,46,1028,977,2.473684210526316
276,2,3,1,874787090,874787091,1,977,1245,2.3333333333333335
276,3,3,0,874787091,874787109,18,1245,472,2.984375
276,3,3,0,874787109,874787150,41,472,597,3.2771084337349397
276,3,2,-1,874787150,874787172,22,597,930,2.793103448275862
276,2,3,1,874787172,874787195,23,930,21,2.9210526315789473
276,3,2,-1,874787195,874787237,42,21,456,2.2
276,2,2,0,874787237,874787300,63,456,1079,2.1923076923076925
276,2,5,3,874787300,874787353,53,1079,214,3.272727272727273
276,5,5,0,874787353,874787376,23,214,175,3.8354430379746836
276,5,4,-1,874787376,874787467,91,175,806,3.6666666666666665
276,4,5,1,874787467,874787496,29,806,22,4.215909090909091
276,5,5,0,874787496,874787497,1,22,11,3.8904109589041096
276,5,4,-1,874787497,874787526,29,11,558,3.75
276,4,3,-1,874787526,874787549,23,558,97,3.7282608695652173
276,3,4,1,874787549,874790801,3252,97,531,3.7435897435897436
276,4,4,0,874790801,874790826,25,531,772,3.3333333333333335
276,4,3,-1,874790826,874790855,29,772,939,3.6333333333333333
276,3,3,0,874790855,874790875,20,939,1194,4.181818181818182
276,3,4,1,874790875,874790903,28,1194,647,4.142857142857143
276,4,5,1,874790903,874790926,23,647,423,3.7016129032258065
276,5,4,-1,874790926,874790952,26,423,193,3.883720930232558
276,4,5,1,874790952,874790972,20,193,429,3.742857142857143
276,5,3,-2,874790972,874790995,23,429,39,3.107142857142857
276,3,4,1,874790995,874790996,1,39,69,3.8015873015873014
276,4,4,0,874790996,874791048,52,69,1220,2.9166666666666665
276,4,4,0,874791048,874791101,53,1220,425,3.7027027027027026
276,4,5,1,874791101,874791102,1,425,179,3.8823529411764706
276,5,4,-1,874791102,874791123,21,179,526,3.909090909090909
276,4,4,0,874791123,874791194,71,526,658,3.393939393939394
276,4,4,0,874791194,874791214,20,658,735,3.58
276,4,4,0,874791214,874791236,22,735,382,3.764705882352941
276,4,4,0,874791236,874791257,21,382,317,3.774193548387097
276,4,4,0,874791257,874791297,40,317,655,3.7857142857142856
276,4,2,-2,874791297,874791316,19,655,697,2.7777777777777777
276,2,3,1,874791316,874791339,23,697,365,2.95
276,3,4,1,874791339,874791383,44,365,1482,4.0
276,4,1,-3,874791383,874791407,24,1482,1213,2.0
276,1,3,2,874791407,874791444,37,1213,583,3.4285714285714284
276,3,2,-1,874791444,874791464,20,583,720,3.2
276,2,2,0,874791464,874791487,23,720,803,2.75
276,2,3,1,874791487,874791488,1,803,1232,2.6666666666666665
276,3,3,0,874791488,874791623,135,1232,789,3.7777777777777777
276,3,3,0,874791623,874791694,71,789,786,3.0
276,3,4,1,874791694,874791695,1,786,959,3.4583333333333335
276,4,4,0,874791695,874791747,52,959,154,3.6031746031746033
276,4,3,-1,874791747,874791805,58,154,564,2.0
276,3,4,1,874791805,874791806,1,564,746,3.7560975609756095
276,4,4,0,874791806,874791870,64,746,428,3.744186046511628
276,4,3,-1,874791870,874791871,1,428,85,3.3157894736842106
276,3,2,-1,874791871,874791894,23,85,1140,2.1666666666666665
276,2,3,1,874791894,874791932,38,1140,158,2.7027027027027026
276,3,4,1,874791932,874791960,28,158,72,3.175438596491228
276,4,3,-1,874791960,874791993,33,72,66,3.4705882352941178
276,3,4,1,874791993,874792018,25,66,709,4.171428571428572
276,4,2,-2,874792018,874792118,100,709,571,2.5
276,2,1,-1,874792118,874792143,25,571,783,2.388888888888889
276,1,3,2,874792143,874792168,25,783,63,3.125
276,3,3,0,874792168,874792189,21,63,384,2.7941176470588234
276,3,3,0,874792189,874792216,27,384,451,3.207792207792208
276,3,3,0,874792216,874792237,21,451,80,2.967741935483871
276,3,3,0,874792237,874792277,40,80,41,3.0625
276,3,2,-1,874792277,874792310,33,41,575,2.619047619047619
276,2,4,2,874792310,874792366,56,575,55,4.051282051282051
276,4,4,0,874792366,874792402,36,55,241,3.5625
276,4,5,1,874792402,874792435,33,241,96,3.9130434782608696
276,5,4,-1,874792435,874792436,1,96,684,3.847826086956522
276,4,1,-3,874792436,874792519,83,684,540,2.4615384615384617
276,1,3,2,874792519,874792520,1,540,541,2.9473684210526314
276,3,3,0,874792520,874792547,27,541,686,3.9
276,3,4,1,874792547,874792574,27,686,550,3.272727272727273
276,4,1,-3,874792574,874792601,27,550,397,1.5
276,1,3,2,874792601,874792634,33,397,802,3.076923076923077
276,3,4,1,874792634,874792663,29,802,164,3.6140350877192984
276,4,2,-2,874792663,874792745,82,164,561,3.1515151515151514
276,2,3,1,874792745,874792767,22,561,551,1.6666666666666667
276,3,2,-1,874792767,874792793,26,551,816,2.0
276,2,3,1,874792793,874792794,1,816,567,3.272727272727273
276,3,4,1,874792794,874792839,45,567,969,3.8947368421052633
276,4,3,-1,874792839,874792870,31,969,755,3.085714285714286
276,3,4,1,874792870,874792907,37,755,417,3.0588235294117645
276,4,2,-2,874792907,874792969,62,417,624,3.0
276,2,3,1,874792969,874793035,66,624,1035,3.03125
276,3,3,0,874793035,874793062,27,1035,415,2.6666666666666665
276,3,3,0,874793062,874793092,30,415,426,3.1
276,3,3,0,874793092,874793118,26,426,768,3.238095238095238
276,3,4,1,874793118,874795500,2382,768,421,3.462962962962963
276,4,2,-2,874795500,874795538,38,421,739,3.391304347826087
276,2,5,3,874795538,874795613,75,739,603,4.315789473684211
276,5,3,-2,874795613,874795637,24,603,44,3.1333333333333333
276,3,5,2,874795637,874795704,67,44,156,4.017857142857143
276,5,1,-4,874795704,874795729,25,156,1253,1.3333333333333333
276,1,2,1,874795729,874795795,66,1253,771,2.5714285714285716
276,2,3,1,874795795,874795823,28,771,572,2.857142857142857
276,3,4,1,874795823,874795868,45,572,462,3.7954545454545454
276,4,4,0,874795868,874795888,20,462,634,3.6
276,4,4,0,874795888,874795928,40,634,171,4.090909090909091
276,4,5,1,874795928,874795949,21,171,198,4.04
276,5,3,-2,874795949,874796116,167,198,1131,3.6666666666666665
276,3,3,0,874796116,874796412,296,1131,631,3.581818181818182
276,3,3,0,874796412,874836629,40217,631,975,3.411764705882353
276,3,5,2,874836629,874836703,74,975,479,4.25
276,5,3,-2,874836703,874836725,22,479,949,3.392857142857143
276,3,2,-1,874836725,874977245,140520,949,809,2.7058823529411766
276,2,1,-1,874977245,874977422,177,809,1228,2.5
276,1,2,1,874977422,874977442,20,1228,391,2.4285714285714284
276,2,3,1,874977442,874977474,32,391,431,3.422222222222222
276,3,2,-1,874977474,874977513,39,431,373,3.142857142857143
276,2,4,2,874977513,874977579,66,373,1240,3.5454545454545454
276,4,3,-1,874977579,877584219,2606640,1240,879,3.2291666666666665
276,3,4,1,877584219,877584220,1,879,333,3.546666666666667
276,4,2,-2,877584220,877934232,350012,333,84,3.0
276,2,2,0,877934232,877934264,32,84,34,3.2
276,2,3,1,877934264,877934374,110,34,1044,3.2777777777777777
276,3,4,1,877934374,877934392,18,1044,1170,3.1666666666666665
276,4,3,-1,877934392,877934446,54,1170,1074,2.857142857142857
276,3,3,0,877934446,877934643,197,1074,797,3.1538461538461537
276,3,4,1,877934643,877934677,34,797,844,3.8333333333333335
276,4,3,-1,877934677,877934705,28,844,413,2.5652173913043477
276,3,2,-1,877934705,877934828,123,413,383,2.5
276,2,3,1,877934828,877934891,63,383,1083,2.3333333333333335
276,3,2,-1,877934891,877934947,56,1083,1471,2.75
276,2,3,1,877934947,877935306,359,1471,790,2.8518518518518516
276,3,3,0,877935306,877935335,29,790,765,3.0
276,3,2,-1,877935335,877935336,1,765,577,1.7058823529411764
276,2,3,1,877935336,877935377,41,577,364,2.8095238095238093
276,3,2,-1,877935377,877935392,15,364,725,3.0
276,2,4,2,877935392,877935446,54,725,770,3.25
276,4,4,0,877935446,877935456,10,770,334,3.4210526315789473
276,4,3,-1,877935456,880913705,2978249,334,1081,2.6666666666666665
276,3,3,0,880913705,880913767,62,1081,452,2.6129032258064515
276,3,5,2,880913767,880913800,33,452,50,4.306532663316583
276,5,2,-3,880913800,882659211,1745411,50,1089,2.1363636363636362
276,2,5,3,882659211,882659577,366,1089,91,3.6
276,5,2,-3,882659577,882659602,25,91,94,2.8823529411764706
276,2,3,1,882659602,882659656,54,94,1109,3.4545454545454546
276,3,3,0,882659656,883822507,1162851,1109,748,3.1043478260869564
276,3,3,0,883822507,884286759,464252,748,74,2.4
276,3,5,2,884286759,885159577,872818,74,313,4.323076923076923
276,5,4,-1,885159577,885159630,53,313,347,3.59375
276,4,5,1,885159630,885871447,711817,347,272,4.2
276,5,4,-1,885871447,885871474,27,272,1301,3.6666666666666665
276,4,4,0,885871474,886483710,612236,1301,581,3.130434782608696
276,4,4,0,886483710,888873407,2389697,581,518,3.5833333333333335
276,4,4,0,888873407,888873488,81,518,691,4.0
276,4,4,0,888873488,888873674,186,691,1199,2.6666666666666665
276,4,4,0,888873674,888873675,1,1199,92,3.7142857142857144
276,4,3,-1,888873675,889174764,301089,92,366,3.4285714285714284
276,3,4,1,889174764,889174849,85,366,652,3.9642857142857144
276,4,3,-1,889174849,889174870,21,652,544,3.185185185185185
276,3,5,2,889174870,889174904,34,544,474,4.172413793103448
276,5,4,-1,889174904,890979199,1804295,474,902,3.9444444444444446
276,4,2,-2,890979199,890979634,435,902,289,2.988888888888889
276,2,4,2,890979634,890979964,330,289,737,3.12
276,4,4,0,890979964,892436298,1456334,737,262,3.5217391304347827
276,4,4,0,892436298,892436314,16,262,316,4.285714285714286
276,4,3,-1,892436314,892436354,40,316,1483,3.25
276,3,4,1,892436354,892436368,14,1483,915,4.0
276,4,3,-1,892436368,892436418,50,915,264,2.65
7,2,3,1,891350383,891350464,81,682,259,2.492063492063492
7,3,1,-2,891350464,891350594,130,259,681,2.25
7,1,3,2,891350594,891350703,109,681,268,3.9838709677419355
7,3,3,0,891350703,891350704,1,268,309,2.3333333333333335
7,3,5,2,891350704,891350756,52,309,64,4.373737373737374
7,5,4,-1,891350756,891350757,1,64,187,4.215189873417722
7,4,3,-1,891350757,891350782,25,187,176,3.967032967032967
7,3,4,1,891350782,891350810,28,176,86,3.869565217391304
7,4,4,0,891350810,891350900,90,86,618,3.5
7,4,3,-1,891350900,891350965,65,618,650,3.1363636363636362
7,3,4,1,891350965,891351002,37,650,98,4.240875912408759
7,4,5,1,891351002,891351041,39,98,234,3.7674418604651163
7,5,5,0,891351041,891351042,1,234,93,3.5641025641025643
7,5,5,0,891351042,891351082,40,93,100,4.0162162162162165
7,5,5,0,891351082,891351121,39,100,612,4.0
7,5,4,-1,891351121,891351234,113,612,657,4.341463414634147
7,4,5,1,891351234,891351287,53,657,132,3.929411764705882
7,5,4,-1,891351287,891351384,97,132,636,3.4146341463414633
7,4,5,1,891351384,891351432,48,636,56,4.051724137931035
7,5,4,-1,891351432,891351472,40,56,499,4.0
7,4,3,-1,891351472,891351509,37,499,656,3.75
7,3,4,1,891351509,891351547,38,656,68,3.5714285714285716
7,4,5,1,891351547,891351585,38,68,385,3.6129032258064515
7,5,5,0,891351585,891351624,39,385,661,4.133333333333334
7,5,5,0,891351624,891351653,29,661,648,3.9545454545454546
7,5,3,-2,891351653,891351685,32,648,198,4.04
7,3,3,0,891351685,891351686,1,198,213,3.943396226415094
7,3,5,2,891351686,891351728,42,213,671,3.4285714285714284
7,5,5,0,891351728,891351772,44,671,527,3.823529411764706
7,5,5,0,891351772,891351814,42,527,498,4.290909090909091
7,5,5,0,891351814,891352010,196,498,492,4.117647058823529
7,5,4,-1,891352010,891352058,48,492,393,3.5125
7,4,5,1,891352058,891352059,1,393,157,3.5714285714285716
7,5,4,-1,891352059,891352093,34,157,480,4.283018867924528
7,4,3,-1,891352093,891352134,41,480,421,3.462962962962963
7,3,5,2,891352134,891352220,86,421,7,3.76056338028169
7,5,5,0,891352220,891352261,41,7,568,3.5853658536585367
7,5,3,-2,891352261,891352341,80,568,505,4.0625
7,3,5,2,891352341,891352384,43,505,504,4.085714285714285
7,5,5,0,891352384,891352451,67,504,589,4.384615384615385
7,5,3,-2,891352451,891352489,38,589,161,3.5844155844155843
7,3,5,2,891352489,891352557,68,161,211,3.958904109589041
7,5,3,-2,891352557,891352594,37,211,627,3.3823529411764706
7,3,5,2,891352594,891352626,32,627,81,3.2857142857142856
7,5,2,-3,891352626,891352659,33,81,674,2.6875
7,2,4,2,891352659,891352692,33,674,27,3.235294117647059
7,4,3,-1,891352692,891352749,57,27,537,3.5
7,3,4,1,891352749,891352778,29,537,217,3.1538461538461537
7,4,4,0,891352778,891352831,53,217,432,3.719298245614035
7,4,4,0,891352831,891352864,33,432,471,3.5714285714285716
7,4,5,1,891352864,891352904,40,471,402,3.3076923076923075
7,5,5,0,891352904,891352947,43,402,675,3.625
7,5,1,-4,891352947,891353051,104,675,212,3.230769230769231
7,1,4,3,891353051,891353086,35,212,549,3.4871794871794872
7,4,5,1,891353086,891353124,38,549,679,3.2432432432432434
7,5,4,-1,891353124,891353154,30,679,465,3.75
7,4,5,1,891353154,891353192,38,465,133,3.7777777777777777
7,5,5,0,891353192,891353254,62,133,649,3.625
7,5,3,-2,891353254,891353290,36,649,405,3.25
7,3,5,2,891353290,891353325,35,405,77,3.3857142857142857
7,5,3,-2,891353325,891353326,1,77,230,3.3518518518518516
7,3,2,-1,891353326,891353357,31,230,472,2.984375
7,2,5,3,891353357,891353411,54,472,501,3.289473684210526
7,5,5,0,891353411,891353444,33,501,162,3.4651162790697674
7,5,5,0,891353444,891353477,33,162,581,3.130434782608696
7,5,5,0,891353477,891353543,66,581,200,3.8157894736842106
7,5,4,-1,891353543,891353570,27,200,637,2.888888888888889
7,4,3,-1,891353570,891353614,44,637,640,2.75
7,3,5,2,891353614,891353652,38,640,592,4.333333333333333
7,5,5,0,891353652,891353676,24,592,639,4.083333333333333
7,5,3,-2,891353676,891353710,34,639,384,2.7941176470588234
7,3,3,0,891353710,891353744,34,384,597,3.2771084337349397
7,3,3,0,891353744,891353766,22,597,232,3.0789473684210527
7,3,2,-1,891353766,891353801,35,232,595,2.9166666666666665
7,2,3,1,891353801,891353828,27,595,29,2.5714285714285716
7,3,5,2,891353828,891353860,32,29,452,2.6129032258064515
7,5,4,-1,891353860,891353892,32,452,620,3.0
7,4,3,-1,891353892,891353950,58,620,571,2.5
7,3,5,2,891353950,891353977,27,571,72,3.175438596491228
7,5,4,-1,891353977,891354053,76,72,241,3.5625
7,4,4,0,891354053,891354090,37,241,389,3.272727272727273
7,4,3,-1,891354090,891354114,24,389,594,2.3333333333333335
7,3,3,0,891354114,891354165,51,594,78,2.3636363636363638
7,3,3,0,891354165,891354217,52,78,623,3.0454545454545454
7,3,4,1,891354217,891354257,40,623,401,2.6774193548387095
7,4,4,0,891354257,891354288,31,401,396,2.84
7,4,3,-1,891354288,891354331,43,396,572,2.857142857142857
7,3,4,1,891354331,891354357,26,572,399,3.317073170731707
7,4,4,0,891354357,891354381,24,399,80,2.967741935483871
7,4,2,-2,891354381,891354438,57,80,415,2.6666666666666665
7,2,4,2,891354438,891354471,33,415,665,2.72972972972973
7,4,3,-1,891354471,891354499,28,665,62,3.048780487804878
7,3,4,1,891354499,891354531,32,62,552,2.8095238095238093
7,4,5,1,891354531,891354588,57,552,617,3.8
7,5,4,-1,891354588,891354611,23,617,561,3.1515151515151514
7,4,3,-1,891354611,891354639,28,561,554,2.9555555555555557
7,3,2,-1,891354639,891354662,23,554,541,2.9473684210526314
7,2,5,3,891354662,891354689,27,541,53,2.9523809523809526
7,5,3,-2,891354689,891354729,40,53,139,2.7222222222222223
7,3,2,-1,891354729,891354730,1,139,590,1.8888888888888888
7,2,3,1,891354730,891354785,55,590,449,2.9069767441860463
7,3,2,-1,891354785,891354882,97,449,545,1.7142857142857142
7,2,1,-1,891354882,892130809,775927,545,294,3.1052631578947367
7,1,1,0,892130809,892130982,173,294,260,2.4716981132075473
7,1,4,3,892130982,892131849,867,260,542,2.888888888888889
7,4,4,0,892131849,892131924,75,542,558,3.75
7,4,1,-3,892131924,892131925,1,558,672,2.7222222222222223
7,1,1,0,892131925,892131978,53,672,440,1.5
7,1,4,3,892131978,892132019,41,440,565,2.4285714285714284
7,4,2,-2,892132019,892132020,1,565,446,2.0
7,2,4,2,892132020,892132145,125,446,557,3.090909090909091
7,4,3,-1,892132145,892132171,26,557,580,3.625
7,3,3,0,892132171,892132277,106,580,642,3.4285714285714284
7,3,3,0,892132277,892132317,40,642,227,3.169811320754717
7,3,2,-1,892132317,892132380,63,227,583,3.4285714285714284
7,2,4,2,892132380,892132425,45,583,450,2.2758620689655173
7,4,3,-1,892132425,892132652,227,450,417,3.0588235294117645
7,3,5,2,892132652,892132773,121,417,626,5.0
7,5,3,-2,892132773,892132798,25,626,560,3.111111111111111
7,3,3,0,892132798,892132885,87,560,231,2.938775510204082
7,3,5,2,892132885,892132943,58,231,576,3.125
7,5,5,0,892132943,892133036,93,576,428,3.744186046511628
7,5,3,-2,892133036,892133154,118,428,73,3.588235294117647
7,3,4,1,892133154,892133180,26,73,585,2.5384615384615383
7,4,3,-1,892133180,892133271,91,585,575,2.619047619047619
7,3,4,1,892133271,892133310,39,575,386,2.769230769230769
7,4,4,0,892133310,892133361,51,386,579,2.727272727272727
7,4,5,1,892133361,892133466,105,579,520,4.136363636363637
7,5,4,-1,892133466,892134959,1493,520,31,3.642857142857143
7,4,4,0,892134959,892135277,318,31,258,3.7547169811320753
7,4,5,1,892135277,892135346,69,258,185,3.9726027397260273
7,5,5,0,892135346,892135347,1,185,667,2.4285714285714284
10,4,4,0,877886281,877886359,78,334,333,3.546666666666667
10,4,3,-1,877886359,877886598,239,333,663,3.948717948717949
10,3,4,1,877886598,877886722,124,663,518,3.5833333333333335
10,4,4,0,877886722,877886846,124,518,486,3.9565217391304346
10,4,4,0,877886846,877886911,65,486,686,3.9
10,4,4,0,877886911,877886912,1,686,371,3.0
10,4,3,-1,877886912,877888677,1765,371,175,3.8354430379746836
10,3,4,1,877888677,877888812,135,175,168,4.0476190476190474
10,4,5,1,877888812,877888876,64,168,606,4.294117647058823
10,5,4,-1,877888876,877888877,1,606,16,3.411764705882353
10,4,5,1,877888877,877888943,66,16,480,4.283018867924528
10,5,5,0,877888943,877888944,1,480,197,4.112676056338028
10,5,5,0,877888944,877889130,186,197,211,3.958904109589041
10,5,5,0,877889130,877889186,56,211,285,4.181818181818182
10,5,5,0,877889186,877889261,75,285,435,3.8933333333333335
10,5,4,-1,877889261,877889262,1,435,482,3.9444444444444446
10,4,5,1,877889262,877889333,71,482,180,3.9473684210526314
10,5,5,0,877889333,877891904,2571,180,484,4.116279069767442
10,5,5,0,877891904,877891905,1,484,589,4.384615384615385
10,5,4,-1,877891905,877891966,61,589,414,3.3076923076923075
10,4,4,0,877891966,877891967,1,414,203,3.826923076923077
10,4,3,-1,877891967,877892050,83,203,704,3.125
10,3,4,1,877892050,877892160,110,704,495,3.65
10,4,5,1,877892160,877892209,49,495,510,3.823529411764706
10,5,4,-1,877892209,877892210,1,510,7,3.76056338028169
10,4,4,0,877892210,877892277,67,7,700,2.7142857142857144
10,4,5,1,877892277,877892437,160,700,694,4.277777777777778
10,5,4,-1,877892437,877892438,1,694,40,2.7037037037037037
10,4,3,-1,877892438,879163524,1271086,40,294,3.1052631578947367
284,4,4,0,885328728,885328991,263,345,340,3.7419354838709675
284,4,5,1,885328991,885329065,74,340,268,3.9838709677419355
284,5,4,-1,885329065,885329146,81,268,306,4.033333333333333
284,4,3,-1,885329146,885329238,92,306,319,3.0408163265306123
284,3,3,0,885329238,885329322,84,319,682,3.0476190476190474
284,3,3,0,885329322,885329395,73,682,300,3.6861313868613137
284,3,3,0,885329395,885329468,73,300,690,3.260869565217391
284,3,3,0,885329468,885329671,203,690,289,2.988888888888889
284,3,2,-1,885329671,885329821,150,289,539,2.6666666666666665
201,4,3,-1,884110637,884110702,65,268,895,3.142857142857143
201,3,4,1,884110702,884110735,33,895,991,2.4545454545454546
201,4,3,-1,884110735,884110766,31,991,751,3.3896103896103895
201,3,5,2,884110766,884110811,45,751,324,3.2291666666666665
201,5,2,-3,884110811,884110887,76,324,332,3.6511627906976742
201,2,4,2,884110887,884110927,40,332,334,3.4210526315789473
201,4,2,-2,884110927,884111064,137,334,289,2.988888888888889
201,2,2,0,884111064,884111270,206,289,210,3.921259842519685
201,2,4,2,884111270,884111312,42,210,98,4.240875912408759
201,4,5,1,884111312,884111359,47,98,1131,3.6666666666666665
201,5,4,-1,884111359,884111360,1,1131,216,3.8454545454545452
201,4,4,0,884111360,884111397,37,216,556,2.7142857142857144
201,4,4,0,884111397,884111436,39,556,408,4.4772727272727275
201,4,4,0,884111436,884111485,49,408,642,3.4285714285714284
201,4,4,0,884111485,884111546,61,642,59,4.0
201,4,4,0,884111546,884111598,52,59,480,4.283018867924528
201,4,3,-1,884111598,884111599,1,480,1039,3.9583333333333335
201,3,3,0,884111599,884111637,38,1039,1425,2.6
201,3,3,0,884111637,884111678,41,1425,171,4.090909090909091
201,3,5,2,884111678,884111708,30,171,127,4.162790697674419
201,5,4,-1,884111708,884111775,67,127,656,3.75
201,4,4,0,884111775,884111830,55,656,1137,4.25
201,4,4,0,884111830,884111873,43,1137,198,4.04
201,4,4,0,884111873,884111899,26,198,1194,4.181818181818182
201,4,4,0,884111899,884111927,28,1194,26,3.36
201,4,2,-2,884111927,884111958,31,26,45,4.130434782608695
201,2,3,1,884111958,884112029,71,45,70,3.5833333333333335
201,3,2,-1,884112029,884112077,48,70,960,3.0
201,2,2,0,884112077,884112136,59,960,1006,2.7777777777777777
201,2,4,2,884112136,884112245,109,1006,183,3.951219512195122
201,4,4,0,884112245,884112281,36,183,176,3.967032967032967
201,4,2,-2,884112281,884112282,1,176,232,3.0789473684210527
201,2,1,-1,884112282,884112352,70,232,431,3.422222222222222
201,1,3,2,884112352,884112426,74,431,770,3.25
201,3,1,-2,884112426,884112427,1,770,39,3.107142857142857
201,1,1,0,884112427,884112537,110,39,441,2.4
201,1,3,2,884112537,884112580,43,441,443,3.8421052631578947
201,3,5,2,884112580,884112581,1,443,447,3.46875
201,5,4,-1,884112581,884112627,46,447,773,3.1666666666666665
201,4,3,-1,884112627,884112673,46,773,567,3.272727272727273
201,3,1,-2,884112673,884112800,127,567,116,3.6666666666666665
201,1,3,2,884112800,884112801,1,116,209,3.8275862068965516
201,3,3,0,884112801,884112840,39,209,211,3.958904109589041
201,3,4,1,884112840,884112901,61,211,423,3.7016129032258065
201,4,3,-1,884112901,884112991,90,423,124,4.052631578947368
201,3,4,1,884112991,884113082,91,124,204,3.6744186046511627
201,4,3,-1,884113082,884113302,220,204,705,3.7857142857142856
201,3,4,1,884113302,884113343,41,705,223,4.108695652173913
201,4,5,1,884113343,884113368,25,223,160,3.4
201,5,3,-2,884113368,884113422,54,160,654,4.119047619047619
201,3,4,1,884113422,884113453,31,654,466,3.5
201,4,3,-1,884113453,884113490,37,466,1065,3.1578947368421053
201,3,2,-1,884113490,884113592,102,1065,1056,3.3333333333333335
201,2,3,1,884113592,884113634,42,1056,317,3.774193548387097
201,3,2,-1,884113634,884113635,1,317,747,3.5526315789473686
201,2,5,3,884113635,884113662,27,747,93,3.5641025641025643
201,5,4,-1,884113662,884113713,51,93,42,3.893617021276596
201,4,3,-1,884113713,884113806,93,42,1166,3.8
201,3,4,1,884113806,884113924,118,1166,461,3.3333333333333335
201,4,2,-2,884113924,884113975,51,461,1427,2.3333333333333335
201,2,3,1,884113975,884114015,40,1427,25,3.3185840707964602
201,3,3,0,884114015,884114069,54,25,240,3.0350877192982457
201,3,4,1,884114069,884114099,30,240,1428,3.2857142857142856
201,4,3,-1,884114099,884114169,70,1428,10,3.85
201,3,2,-1,884114169,884114194,25,10,1422,2.5
201,2,1,-1,884114194,884114232,38,1422,31,3.642857142857143
201,1,2,1,884114232,884114233,1,31,979,3.1
201,2,2,0,884114233,884114275,42,979,121,3.521212121212121
201,2,4,2,884114275,884114471,196,121,285,4.181818181818182
201,4,1,-3,884114471,884114505,34,285,406,2.5294117647058822
201,1,1,0,884114505,884114506,1,406,370,2.8125
201,1,4,3,884114506,884114635,129,370,853,2.75
201,4,2,-2,884114635,884114682,47,853,667,2.4285714285714284
201,2,1,-1,884114682,884114713,31,667,774,3.0
201,1,2,1,884114713,884114770,57,774,665,2.72972972972973
201,2,3,1,884114770,884114895,125,665,955,3.2666666666666666
201,3,2,-1,884114895,884140022,25127,955,175,3.8354430379746836
201,2,3,1,884140022,884140049,27,175,32,3.7222222222222223
201,3,3,0,884140049,884140078,29,32,180,3.9473684210526314
201,3,4,1,884140078,884140079,1,180,1398,4.5
201,4,3,-1,884140079,884140246,167,1398,425,3.7027027027027026
201,3,4,1,884140246,884140247,1,425,708,3.3157894736842106
201,4,2,-2,884140247,884140275,28,708,20,3.375
201,2,3,1,884140275,884140307,32,20,591,3.7169811320754715
201,3,2,-1,884140307,884140382,75,591,215,3.662921348314607
201,2,4,2,884140382,884140428,46,215,458,3.0588235294117645
201,4,4,0,884140428,884140458,30,458,508,3.6923076923076925
201,4,3,-1,884140458,884140487,29,508,1103,3.5555555555555554
201,3,1,-2,884140487,884140488,1,1103,81,3.2857142857142856
201,1,4,3,884140488,884140522,34,81,956,3.5714285714285716
201,4,3,-1,884140522,884140579,57,956,1010,3.611111111111111
201,3,4,1,884140579,884140610,31,1010,47,3.5869565217391304
201,4,1,-3,884140610,884140637,27,47,1136,3.3076923076923075
201,1,2,1,884140637,884140709,72,1136,125,3.5555555555555554
201,2,5,3,884140709,884140750,41,125,1135,3.0526315789473686
201,5,2,-3,884140750,884140751,1,1135,51,3.5277777777777777
201,2,1,-1,884140751,884140787,36,51,1227,2.6
201,1,2,1,884140787,884140825,38,1227,387,3.5357142857142856
201,2,3,1,884140825,884140853,28,387,1423,2.25
201,3,2,-1,884140853,884140891,38,1423,1224,2.6666666666666665
201,2,3,1,884140891,884140927,36,1224,980,3.142857142857143
201,3,3,0,884140927,884140975,48,980,823,2.75
201,3,3,0,884140975,884141015,40,823,1421,3.2
201,3,3,0,884141015,884141053,38,1421,1267,2.909090909090909
201,3,1,-2,884141053,884310148,169095,1267,118,3.2764227642276422
201,1,1,0,884310148,884310149,1,118,62,3.048780487804878
287,5,4,-1,875333916,875333964,48,327,246,4.0
287,4,4,0,875333964,875333965,1,246,298,3.779220779220779
287,4,2,-2,875333965,875334036,71,298,1067,3.533333333333333
287,2,3,1,875334036,875334060,24,1067,250,3.4698795180722892
287,3,5,2,875334060,875334088,28,250,1,3.902439024390244
287,5,5,0,875334088,875334089,1,1,9,3.8878504672897196
287,5,3,-2,875334089,875334126,37,9,111,3.5106382978723403
287,3,5,2,875334126,875334151,25,111,237,3.7315436241610738
287,5,3,-2,875334151,875334196,45,237,742,3.5555555555555554
287,3,4,1,875334196,875334224,28,742,257,3.7154471544715446
287,4,4,0,875334224,875334248,24,257,235,3.106382978723404
287,4,5,1,875334248,875334271,23,235,50,4.306532663316583
287,5,5,0,875334271,875334293,22,50,591,3.7169811320754715
287,5,1,-4,875334293,875334340,47,591,476,3.1216216216216215
287,1,5,4,875334340,875334405,65,476,117,3.689189189189189
287,5,5,0,875334405,875334430,25,117,1016,3.559322033898305
287,5,2,-3,875334430,875334454,24,1016,240,3.0350877192982457
287,2,4,2,875334454,875334519,65,240,108,3.107142857142857
287,4,5,1,875334519,875334587,68,108,845,3.661290322580645
287,5,5,0,875334587,875334759,172,845,56,4.051724137931035
287,5,4,-1,875334759,875334807,48,56,710,3.41025641025641
287,4,5,1,875334807,875334962,155,710,201,3.75
287,5,4,-1,875334962,875335018,56,201,652,3.9642857142857144
287,4,5,1,875335018,875335124,106,652,11,3.8904109589041096
287,5,5,0,875335124,875335190,66,11,168,4.0476190476190474
287,5,3,-2,875335190,875335424,234,168,941,3.5
287,3,3,0,875335424,875336743,1319,941,426,3.1
287,3,5,2,875336743,875336804,61,426,156,4.017857142857143
287,5,5,0,875336804,888177097,12840293,156,340,3.7419354838709675
287,5,4,-1,888177097,888177170,73,340,268,3.9838709677419355
287,4,2,-2,888177170,888177213,43,268,895,3.142857142857143
287,2,5,3,888177213,888177364,151,895,100,4.0162162162162165
287,5,5,0,888177364,888177402,38,100,291,3.2
246,5,4,-1,884920788,884920918,130,50,1,3.902439024390244
246,4,1,-3,884920918,884920948,30,1,56,4.051724137931035
246,1,3,2,884920948,884920949,1,56,216,3.8454545454545452
246,3,4,1,884920949,884920978,29,216,675,3.625
246,4,3,-1,884920978,884920997,19,675,633,3.9
246,3,5,2,884920997,884921033,36,633,652,3.9642857142857144
246,5,2,-3,884921033,884921058,25,652,215,3.662921348314607
246,2,3,1,884921058,884921202,144,215,69,3.8015873015873014
246,3,3,0,884921202,884921245,43,69,8,3.903225806451613
246,3,4,1,884921245,884921319,74,8,132,3.929411764705882
246,4,4,0,884921319,884921362,43,132,175,3.8354430379746836
246,4,5,1,884921362,884921380,18,175,1101,3.793103448275862
246,5,4,-1,884921380,884921394,14,1101,208,3.8125
246,4,3,-1,884921394,884921453,59,208,418,3.825
246,3,3,0,884921453,884921511,58,418,596,3.180327868852459
246,3,5,2,884921511,884921533,22,596,741,3.3043478260869565
246,5,3,-2,884921533,884921558,25,741,228,3.7246376811594204
246,3,3,0,884921558,884921613,55,228,164,3.6140350877192984
246,3,4,1,884921613,884921637,24,164,475,3.956043956043956
246,4,4,0,884921637,884921638,1,475,651,3.8627450980392157
246,4,3,-1,884921638,884921661,23,651,431,3.422222222222222
246,3,4,1,884921661,884921679,18,431,735,3.58
246,4,3,-1,884921679,884921705,26,735,133,3.7777777777777777
246,3,5,2,884921705,884921727,22,133,151,3.6544117647058822
246,5,5,0,884921727,884921794,67,151,109,3.282608695652174
246,5,2,-3,884921794,884921839,45,109,77,3.3857142857142857
246,2,3,1,884921839,884921861,22,77,111,3.5106382978723403
246,3,5,2,884921861,884921918,57,111,425,3.7027027027027026
246,5,4,-1,884921918,884921948,30,425,184,3.393939393939394
246,4,2,-2,884921948,884921965,17,184,597,3.2771084337349397
246,2,2,0,884921965,884921986,21,597,82,3.6741573033707864
246,2,5,3,884921986,884922042,56,82,172,4.225225225225225
246,5,4,-1,884922042,884922070,28,172,746,3.7560975609756095
246,4,5,1,884922070,884922235,165,746,288,3.5214285714285714
246,5,3,-2,884922235,884922252,17,288,66,3.4705882352941178
246,3,3,0,884922252,884922272,20,66,97,3.7282608695652173
246,3,5,2,884922272,884922341,69,97,68,3.5714285714285716
246,5,3,-2,884922341,884922383,42,68,25,3.3185840707964602
246,3,3,0,884922383,884922434,51,25,404,3.6578947368421053
246,3,1,-2,884922434,884922554,120,404,628,3.573529411764706
246,1,4,3,884922554,884922605,51,628,211,3.958904109589041
246,4,3,-1,884922605,884922627,22,211,393,3.5125
246,3,3,0,884922627,884922657,30,393,99,3.8392857142857144
246,3,2,-1,884922657,884922658,1,99,17,3.032258064516129
246,2,4,2,884922658,884922697,39,17,403,3.298507462686567
246,4,3,-1,884922697,884922714,17,403,447,3.46875
246,3,3,0,884922714,884922740,26,447,550,3.272727272727273
246,3,3,0,884922740,884922801,61,550,1218,3.2
246,3,4,1,884922801,884922831,30,1218,665,2.72972972972973
246,4,1,-3,884922831,884922869,38,665,1044,3.2777777777777777
246,1,4,3,884922869,884922964,95,1044,470,3.72
246,4,2,-2,884922964,884923003,39,470,451,3.207792207792208
246,2,3,1,884923003,884923047,44,451,416,3.3846153846153846
246,3,3,0,884923047,884923073,26,416,232,3.0789473684210527
246,3,3,0,884923073,884923127,54,232,572,2.857142857142857
246,3,2,-1,884923127,884923175,48,572,38,2.784313725490196
246,2,1,-1,884923175,884923305,130,38,412,2.272727272727273
246,1,2,1,884923305,884923306,1,412,578,3.066666666666667
246,2,2,0,884923306,884923329,23,578,226,3.378787878787879
246,2,5,3,884923329,884923348,19,226,567,3.272727272727273
246,5,3,-2,884923348,884923372,24,567,1222,2.6363636363636362
246,3,2,-1,884923372,884923390,18,1222,3,3.0625
246,2,3,1,884923390,884923405,15,3,790,2.8518518518518516
246,3,1,-2,884923405,884923425,20,790,1232,2.6666666666666665
246,1,1,0,884923425,884923445,20,1232,561,3.1515151515151514
246,1,3,2,884923445,884923471,26,561,426,3.1
246,3,3,0,884923471,884923487,16,426,541,2.9473684210526314
246,3,3,0,884923487,884923547,60,541,240,3.0350877192982457
246,3,1,-2,884923547,884923592,45,240,720,3.2
246,1,2,1,884923592,884923632,40,720,384,2.7941176470588234
246,2,3,1,884923632,884923653,21,384,1028,2.857142857142857
246,3,1,-2,884923653,884923687,34,1028,155,3.0588235294117645
246,1,1,0,884923687,884923715,28,155,138,2.6
246,1,1,0,884923715,884923750,35,138,401,2.6774193548387095
246,1,2,1,884923750,884923767,17,401,809,2.7058823529411766
246,2,1,-1,884923767,884923811,44,809,585,2.5384615384615383
246,1,1,0,884923811,884923829,18,585,827,2.4375
246,1,2,1,884923829,884923893,64,827,67,3.106382978723404
246,2,1,-1,884923893,884923922,29,67,145,2.3636363636363638
246,1,1,0,884923922,884923955,33,145,158,2.7027027027027026
246,1,1,0,884923955,884923971,16,158,1228,2.5
246,1,2,1,884923971,884924001,30,1228,798,3.3333333333333335
246,2,1,-1,884924001,884924025,24,798,831,2.6097560975609757
246,1,2,1,884924025,884924026,1,831,765,3.0
246,2,4,2,884924026,884924045,19,765,840,3.090909090909091
246,4,2,-2,884924045,884924460,415,840,294,3.1052631578947367
246,2,1,-1,884924460,884924473,13,294,252,2.911392405063291
246,1,2,1,884924473,884924764,291,252,930,2.793103448275862
246,2,1,-1,884924764,884924765,1,930,981,2.0
246,1,1,0,884924765,884924780,15,981,743,1.9545454545454546
246,1,1,0,884924780,884924813,33,743,368,1.8823529411764706
242,3,4,1,879740223,879740362,139,475,283,3.901639344262295
242,4,4,0,879740362,879740594,232,283,237,3.7315436241610738
242,4,5,1,879740594,879741340,746,237,268,3.9838709677419355
249,3,4,1,879571456,879571521,65,309,333,3.546666666666667
249,4,3,-1,879571521,879571586,65,333,748,3.1043478260869564
249,3,4,1,879571586,879571678,92,748,250,3.4698795180722892
249,4,4,0,879571678,879571695,17,250,50,4.306532663316583
249,4,3,-1,879571695,879571752,57,50,255,3.2027027027027026
249,3,3,0,879571752,879571779,27,255,993,3.4838709677419355
249,3,5,2,879571779,879571883,104,993,129,3.744186046511628
249,5,2,-3,879571883,879571998,115,129,252,2.911392405063291
249,2,2,0,879571998,879571999,1,252,245,3.056179775280899
249,2,4,2,879571999,879572124,125,245,86,3.869565217391304
249,4,4,0,879572124,879572142,18,86,357,4.063291139240507
249,4,5,1,879572142,879572167,25,357,806,3.6666666666666665
249,5,5,0,879572167,879572189,22,806,56,4.051724137931035
249,5,4,-1,879572189,879572210,21,56,1,3.902439024390244
249,4,5,1,879572210,879572229,19,1,89,3.9615384615384617
249,5,5,0,879572229,879572256,27,89,1103,3.5555555555555554
249,5,3,-2,879572256,879572284,28,1103,239,3.423076923076923
249,3,4,1,879572284,879572314,30,239,174,4.253521126760563
249,4,5,1,879572314,879572349,35,174,198,4.04
249,5,4,-1,879572349,879572370,21,198,223,4.108695652173913
249,4,5,1,879572370,879572402,32,223,156,4.017857142857143
249,5,4,-1,879572402,879572403,1,156,708,3.3157894736842106
249,4,4,0,879572403,879572432,29,708,23,3.9047619047619047
249,4,5,1,879572432,879572451,19,23,238,3.888888888888889
249,5,5,0,879572451,879572472,21,238,427,4.2025316455696204
249,5,4,-1,879572472,879572496,24,427,228,3.7246376811594204
249,4,5,1,879572496,879572516,20,228,58,3.543859649122807
249,5,4,-1,879572516,879572540,24,58,183,3.951219512195122
249,4,4,0,879572540,879572567,27,183,144,3.9545454545454546
249,4,5,1,879572567,879572582,15,144,209,3.8275862068965516
249,5,4,-1,879572582,879572600,18,209,96,3.9130434782608696
249,4,5,1,879572600,879572630,30,96,42,3.893617021276596
249,5,5,0,879572630,879572646,16,42,124,4.052631578947368
249,5,5,0,879572646,879572668,22,124,135,3.7974683544303796
249,5,4,-1,879572668,879572688,20,135,31,3.642857142857143
249,4,3,-1,879572688,879572705,17,31,121,3.521212121212121
249,3,4,1,879572705,879572760,55,121,53,2.9523809523809526
249,4,5,1,879572760,879572777,17,53,79,3.956989247311828
249,5,4,-1,879572777,879572795,18,79,467,4.071428571428571
249,4,4,0,879572795,879572911,116,467,195,3.9072164948453607
249,4,5,1,879572911,879572926,15,195,22,4.215909090909091
249,5,4,-1,879572926,879572944,18,22,658,3.393939393939394
249,4,3,-1,879572944,879640210,67266,658,125,3.5555555555555554
249,3,4,1,879640210,879640241,31,125,471,3.5714285714285716
249,4,4,0,879640241,879640306,65,471,24,3.3728813559322033
249,4,4,0,879640306,879640326,20,24,455,3.1702127659574466
249,4,4,0,879640326,879640343,17,455,240,3.0350877192982457
249,4,3,-1,879640343,879640361,18,240,148,3.2131147540983607
249,3,4,1,879640361,879640396,35,148,13,3.5454545454545454
249,4,3,-1,879640396,879640436,40,13,546,2.9789473684210526
249,3,3,0,879640436,879640452,16,546,108,3.107142857142857
249,3,3,0,879640452,879640481,29,108,476,3.1216216216216215
249,3,2,-1,879640481,879640521,40,476,290,3.108108108108108
249,2,3,1,879640521,879640549,28,290,456,2.2
249,3,2,-1,879640549,879640585,36,456,930,2.793103448275862
249,2,3,1,879640585,879640618,33,930,407,2.611111111111111
249,3,4,1,879640618,879640918,300,407,583,3.4285714285714284
249,4,5,1,879640918,879640935,17,583,603,4.315789473684211
249,5,5,0,879640935,879640949,14,603,182,3.842857142857143
249,5,5,0,879640949,879640977,28,182,83,4.204081632653061
249,5,4,-1,879640977,879640998,21,83,403,3.298507462686567
249,4,5,1,879640998,879641035,37,403,479,4.25
249,5,4,-1,879641035,879641067,32,479,188,3.625
249,4,4,0,879641067,879641093,26,188,723,3.5384615384615383
249,4,4,0,879641093,879641109,16,723,176,3.967032967032967
249,4,5,1,879641109,879641140,31,176,179,3.8823529411764706
249,5,5,0,879641140,879641194,54,179,241,3.5625
249,5,5,0,879641194,879641251,57,241,686,3.9
249,5,3,-2,879641251,879641284,33,686,2,3.0851063829787235
249,3,4,1,879641284,879641305,21,2,216,3.8454545454545452
249,4,3,-1,879641305,879641322,17,216,218,3.5555555555555554
99,3,5,2,885678304,885678348,44,895,313,4.323076923076923
99,5,4,-1,885678348,885678397,49,313,300,3.6861313868613137
99,4,4,0,885678397,885678453,56,300,294,3.1052631578947367
99,4,2,-2,885678453,885678479,26,294,678,2.8181818181818183
99,2,3,1,885678479,885678499,20,678,322,3.0476190476190474
99,3,2,-1,885678499,885678520,21,322,358,2.6551724137931036
99,2,4,2,885678520,885678539,19,358,338,2.75
99,4,2,-2,885678539,885678576,37,338,312,3.0
99,2,3,1,885678576,885678696,120,312,345,3.4782608695652173
99,3,5,2,885678696,885678724,28,345,1016,3.559322033898305
99,5,3,-2,885678724,885678753,29,1016,282,3.610526315789474
99,3,5,2,885678753,885678785,32,282,475,3.956043956043956
99,5,4,-1,885678785,885678813,28,475,405,3.25
99,4,4,0,885678813,885678840,27,405,591,3.7169811320754715
99,4,4,0,885678840,885678886,46,591,676,3.3142857142857145
99,4,2,-2,885678886,885678973,87,676,276,3.6036036036036037
99,2,3,1,885678973,885679025,52,276,25,3.3185840707964602
99,3,5,2,885679025,885679114,89,25,742,3.5555555555555554
99,5,1,-4,885679114,885679157,43,742,274,3.5609756097560976
99,1,4,3,885679157,885679183,26,274,544,3.185185185185185
99,4,3,-1,885679183,885679210,27,544,472,2.984375
99,3,2,-1,885679210,885679237,27,472,815,3.135135135135135
99,2,3,1,885679237,885679261,24,815,121,3.521212121212121
99,3,4,1,885679261,885679262,1,121,363,3.0
99,4,4,0,885679262,885679279,17,363,240,3.0350877192982457
99,4,3,-1,885679279,885679299,20,240,413,2.5652173913043477
99,3,4,1,885679299,885679319,20,413,1132,2.588235294117647
99,4,4,0,885679319,885679382,63,1132,369,2.5714285714285716
99,4,2,-2,885679382,885679411,29,369,409,2.9615384615384617
99,2,4,2,885679411,885679437,26,409,1067,3.533333333333333
99,4,2,-2,885679437,885679472,35,1067,120,2.3421052631578947
99,2,3,1,885679472,885679504,32,120,1079,2.1923076923076925
99,3,1,-2,885679504,885679533,29,1079,1052,2.4545454545454546
99,1,5,4,885679533,885679596,63,1052,22,4.215909090909091
99,5,5,0,885679596,885679705,109,22,210,3.921259842519685
99,5,4,-1,885679705,885679952,247,210,204,3.6744186046511627
99,4,3,-1,885679952,885679998,46,204,963,3.9285714285714284
99,3,4,1,885679998,885680176,178,963,789,3.7777777777777777
99,4,4,0,885680176,885680374,198,789,403,3.298507462686567
99,4,5,1,885680374,885680458,84,403,12,4.358974358974359
99,5,3,-2,885680458,885680578,120,12,28,3.923076923076923
99,3,1,-2,885680578,885680616,38,28,694,4.277777777777778
99,1,4,3,885680616,885680617,1,694,402,3.3076923076923075
99,4,4,0,885680617,885680723,106,402,203,3.826923076923077
99,4,3,-1,885680723,885680772,49,203,421,3.462962962962963
99,3,4,1,885680772,885680837,65,421,92,3.7142857142857144
99,4,4,0,885680837,886518562,837725,92,329,3.25
99,4,4,0,886518562,886518628,66,329,290,3.108108108108108
99,4,4,0,886518628,886518810,182,290,182,3.842857142857143
99,4,5,1,886518810,886519097,287,182,4,3.5538461538461537
99,5,2,-3,886519097,886780147,261050,4,931,2.2758620689655173
99,2,3,1,886780147,888469392,1689245,931,246,4.0
99,3,3,0,888469392,888469419,27,246,255,3.2027027027027026
178,4,3,-1,882823395,882823416,21,271,328,3.4895833333333335
178,3,3,0,882823416,882823437,21,328,332,3.6511627906976742
178,3,3,0,882823437,882823530,93,332,678,2.8181818181818183
178,3,2,-1,882823530,882823566,36,678,1038,2.6
178,2,4,2,882823566,882823758,192,1038,100,4.0162162162162165
178,4,5,1,882823758,882823784,26,100,283,3.901639344262295
178,5,4,-1,882823784,882823805,21,283,7,3.76056338028169
178,4,5,1,882823805,882823832,27,7,181,3.98974358974359
178,5,3,-2,882823832,882823833,1,181,742,3.5555555555555554
178,3,4,1,882823833,882823857,24,742,222,3.578125
178,4,4,0,882823857,882823905,48,222,16,3.411764705882353
178,4,4,0,882823905,882823930,25,16,471,3.5714285714285716
178,4,4,0,882823930,882823954,24,471,293,3.630434782608696
178,4,3,-1,882823954,882823978,24,293,282,3.610526315789474
178,3,4,1,882823978,882824027,49,282,628,3.573529411764706
178,4,3,-1,882824027,882824028,1,628,281,3.2
178,3,4,1,882824028,882824055,27,281,1197,3.625
178,4,4,0,882824055,882824194,139,1197,472,2.984375
178,4,4,0,882824194,882824253,59,472,1016,3.559322033898305
178,4,4,0,882824253,882824325,72,1016,148,3.2131147540983607
178,4,2,-2,882824325,882824326,1,148,1047,2.6923076923076925
178,2,3,1,882824326,882824592,266,1047,762,3.3962264150943398
178,3,3,0,882824592,882824671,79,762,535,3.380952380952381
178,3,3,0,882824671,882824713,42,535,476,3.1216216216216215
178,3,2,-1,882824713,882824983,270,476,978,2.357142857142857
178,2,4,2,882824983,882825768,785,978,144,3.9545454545454546
178,4,5,1,882825768,882826162,394,144,427,4.2025316455696204
178,5,4,-1,882826162,882826187,25,427,226,3.378787878787879
178,4,5,1,882826187,882826210,23,226,520,4.136363636363637
178,5,4,-1,882826210,882826306,96,520,194,4.029411764705882
178,4,4,0,882826306,882826347,41,194,153,3.7865168539325844
178,4,2,-2,882826347,882826395,48,153,156,4.017857142857143
178,2,5,3,882826395,882826437,42,156,69,3.8015873015873014
178,5,5,0,882826437,882826514,77,69,478,4.161290322580645
178,5,4,-1,882826514,882826555,41,478,172,4.225225225225225
178,4,5,1,882826555,882826556,1,172,228,3.7246376811594204
178,5,4,-1,882826556,882826577,21,228,71,3.6575342465753424
178,4,5,1,882826577,882826719,142,71,174,4.253521126760563
178,5,2,-3,882826719,882826720,1,174,197,4.112676056338028
178,2,5,3,882826720,882826806,86,197,28,3.923076923076923
178,5,5,0,882826806,882826807,1,28,215,3.662921348314607
178,5,4,-1,882826807,882826868,61,215,193,3.883720930232558
178,4,4,0,882826868,882826889,21,193,230,3.3518518518518516
178,4,5,1,882826889,882826982,93,230,318,4.5046728971962615
178,5,3,-2,882826982,882826983,1,318,134,4.174603174603175
178,3,5,2,882826983,882827019,36,134,684,3.847826086956522
178,5,4,-1,882827019,882827020,1,684,729,3.3793103448275863
178,4,4,0,882827020,882827083,63,729,62,3.048780487804878
178,4,4,0,882827083,882827134,51,62,1169,4.0
178,4,5,1,882827134,882827162,28,1169,658,3.393939393939394
178,5,3,-2,882827162,882827247,85,658,220,3.433333333333333
178,3,5,2,882827247,882827288,41,220,591,3.7169811320754715
178,5,4,-1,882827288,882827375,87,591,233,3.323529411764706
178,4,4,0,882827375,882827400,25,233,1119,3.5185185185185186
178,4,4,0,882827400,882827433,33,1119,724,3.64
178,4,3,-1,882827433,882827506,73,724,465,3.75
178,3,3,0,882827506,882827574,68,465,38,2.784313725490196
178,3,5,2,882827574,882827645,71,38,161,3.5844155844155843
178,5,4,-1,882827645,882827689,44,161,549,3.4871794871794872
178,4,4,0,882827689,882827716,27,549,781,3.4166666666666665
178,4,3,-1,882827716,882827776,60,781,218,3.5555555555555554
178,3,3,0,882827776,882827803,27,218,92,3.7142857142857144
178,3,5,2,882827803,882827834,31,92,792,3.793103448275862
178,5,3,-2,882827834,882827870,36,792,469,3.6842105263157894
178,3,4,1,882827870,882827947,77,469,77,3.3857142857142857
178,4,5,1,882827947,882827985,38,77,73,3.588235294117647
178,5,4,-1,882827985,882828350,365,73,219,2.735294117647059
178,4,3,-1,882828350,884836479,2008129,219,333,3.546666666666667
178,3,3,0,884836479,884836516,37,333,895,3.142857142857143
178,3,1,-2,884836516,884836946,430,895,319,3.0408163265306123
178,1,3,2,884836946,884837073,127,319,625,3.25
178,3,1,-2,884837073,884837126,53,625,244,2.9411764705882355
178,1,4,3,884837126,884837324,198,244,268,3.9838709677419355
178,4,4,0,884837324,884837364,40,268,1012,3.2916666666666665
178,4,3,-1,884837364,884837419,55,1012,508,3.6923076923076925
178,3,3,0,884837419,885784558,947139,508,1283,2.9
178,3,3,0,885784558,885784583,25,1283,1051,3.625
178,3,3,0,885784583,886678518,893935,1051,1300,2.5
178,3,3,0,886678518,886678647,129,1300,873,2.7586206896551726
178,3,1,-2,886678647,886678700,53,873,260,2.4716981132075473
178,1,2,1,886678700,888513069,1834369,260,877,2.619047619047619
178,2,4,2,888513069,888513290,221,877,316,4.285714285714286
178,4,4,0,888513290,888514680,1390,316,284,3.1547619047619047
178,4,3,-1,888514680,888514710,30,284,619,3.4782608695652173
178,3,4,1,888514710,888514821,111,619,250,3.4698795180722892
178,4,4,0,888514821,892239796,3724975,250,302,4.133333333333334
178,4,3,-1,892239796,892239928,132,302,682,3.0476190476190474
251,3,4,1,886271496,886271541,45,258,288,3.5214285714285714
251,4,5,1,886271541,886271640,99,288,64,4.373737373737374
251,5,4,-1,886271640,886271675,35,64,275,4.087912087912088
251,4,4,0,886271675,886271700,25,275,12,4.358974358974359
251,4,5,1,886271700,886271733,33,12,79,3.956989247311828
251,5,5,0,886271733,886271855,122,79,612,4.0
251,5,3,-2,886271855,886271856,1,612,55,4.051282051282051
251,3,4,1,886271856,886271884,28,55,100,4.0162162162162165
251,4,5,1,886271884,886271920,36,100,144,3.9545454545454546
251,5,4,-1,886271920,886271955,35,144,429,3.742857142857143
251,4,4,0,886271955,886272009,54,429,117,3.689189189189189
251,4,3,-1,886272009,886272086,77,117,813,4.055555555555555
251,3,5,2,886272086,886272146,60,813,298,3.779220779220779
251,5,4,-1,886272146,886272175,29,298,1012,3.2916666666666665
251,4,3,-1,886272175,886272197,22,1012,1016,3.559322033898305
251,3,4,1,886272197,886272223,26,1016,282,3.610526315789474
251,4,4,0,886272223,886272249,26,282,295,3.769230769230769
251,4,3,-1,886272249,886272283,34,295,24,3.3728813559322033
251,3,3,0,886272283,886272319,36,24,147,3.3142857142857145
251,3,5,2,886272319,886272346,27,147,237,3.7315436241610738
251,5,3,-2,886272346,886272378,32,237,250,3.4698795180722892
251,3,2,-1,886272378,886272407,29,250,476,3.1216216216216215
251,2,4,2,886272407,886272456,49,476,281,3.2
251,4,2,-2,886272456,886272547,91,281,148,3.2131147540983607
251,2,2,0,886272547,886272585,38,148,978,2.357142857142857
251,2,4,2,886272585,886272615,30,978,25,3.3185840707964602
81,4,3,-1,876533389,876533504,115,147,116,3.6666666666666665
81,3,3,0,876533504,876533545,41,116,100,4.0162162162162165
81,3,3,0,876533545,876533586,41,100,471,3.5714285714285716
81,3,2,-1,876533586,876533619,33,471,222,3.578125
81,2,3,1,876533619,876533657,38,222,93,3.5641025641025643
81,3,4,1,876533657,876533710,53,93,273,3.5238095238095237
81,4,3,-1,876533710,876533764,54,273,405,3.25
81,3,3,0,876533764,876533824,60,405,926,2.7857142857142856
81,3,3,0,876533824,876533894,70,926,284,3.1547619047619047
81,3,2,-1,876533894,876533946,52,284,151,3.6544117647058822
81,2,3,1,876533946,876533988,42,151,1047,2.6923076923076925
81,3,3,0,876533988,876534009,21,1047,619,3.4782608695652173
81,3,1,-2,876534009,876534097,88,619,756,2.6885245901639343
81,1,2,1,876534097,876534124,27,756,476,3.1216216216216215
81,2,3,1,876534124,876534174,50,476,111,3.5106382978723403
81,3,2,-1,876534174,876534244,70,111,411,2.911764705882353
81,2,1,-1,876534244,876534277,33,411,1028,2.857142857142857
81,1,3,2,876534277,876534313,36,1028,274,3.5609756097560976
81,3,3,0,876534313,876534366,53,274,1059,2.764705882352941
81,3,3,0,876534366,876534437,71,1059,824,2.590909090909091
81,3,4,1,876534437,876534505,68,824,726,2.8
81,4,3,-1,876534505,876534594,89,726,124,4.052631578947368
81,3,4,1,876534594,876534751,157,124,169,4.548387096774194
81,4,5,1,876534751,876534783,32,169,186,3.905263157894737
81,5,2,-3,876534783,876535131,348,186,432,3.719298245614035
260,5,1,-4,890618349,890618403,54,326,538,3.25
260,1,4,3,890618403,890618476,73,538,350,3.2
260,4,4,0,890618476,890618537,61,350,881,2.769230769230769
260,4,5,1,890618537,890618728,191,881,270,3.7804878048780486
260,5,5,0,890618728,890618729,1,270,1025,2.95
260,5,4,-1,890618729,890618898,169,1025,322,3.0476190476190474
25,4,3,-1,885852008,885852059,51,195,197,4.112676056338028
25,3,4,1,885852059,885852086,27,197,498,4.290909090909091
25,4,4,0,885852086,885852120,34,498,612,4.0
25,4,5,1,885852120,885852150,30,612,50,4.306532663316583
25,5,4,-1,885852150,885852218,68,50,968,3.75
25,4,4,0,885852218,885852248,30,968,527,3.823529411764706
25,4,5,1,885852248,885852271,23,527,478,4.161290322580645
25,5,5,0,885852271,885852301,30,478,169,4.548387096774194
25,5,4,-1,885852301,885852337,36,169,208,3.8125
25,4,3,-1,885852337,885852381,44,208,133,3.7777777777777777
25,3,2,-1,885852381,885852443,62,133,432,3.719298245614035
25,2,3,1,885852443,885852529,86,432,143,3.56
25,3,5,2,885852529,885852569,40,143,479,4.25
25,5,4,-1,885852569,885852611,42,479,837,4.0
25,4,4,0,885852611,885852656,45,837,692,3.56
25,4,4,0,885852656,885852697,41,692,729,3.3793103448275863
25,4,4,0,885852697,885852720,23,729,141,3.4827586206896552
25,4,4,0,885852720,885852757,37,141,238,3.888888888888889
25,4,5,1,885852757,885852817,60,238,125,3.5555555555555554
25,5,4,-1,885852817,885852862,45,125,495,3.65
25,4,5,1,885852862,885852920,58,495,408,4.4772727272727275
25,5,4,-1,885852920,885852969,49,408,173,4.1441441441441444
25,4,4,0,885852969,885853030,61,173,121,3.521212121212121
25,4,5,1,885853030,885853415,385,121,98,4.240875912408759
59,5,4,-1,888202787,888202814,27,288,900,4.2
59,4,4,0,888202814,888202941,127,900,7,3.76056338028169
59,4,2,-2,888202941,888203018,77,7,929,2.8421052631578947
59,2,4,2,888203018,888203053,35,929,9,3.8878504672897196
59,4,5,1,888203053,888203095,42,9,508,3.6923076923076925
59,5,3,-2,888203095,888203128,33,508,1115,3.3846153846153846
59,3,2,-1,888203128,888203129,1,1115,273,3.5238095238095237
59,2,5,3,888203129,888203234,105,273,14,4.101694915254237
59,5,4,-1,888203234,888203270,36,14,25,3.3185840707964602
59,4,3,-1,888203270,888203343,73,25,123,3.297872340425532
59,3,3,0,888203343,888203371,28,123,237,3.7315436241610738
59,3,4,1,888203371,888203415,44,237,846,3.1052631578947367
59,4,2,-2,888203415,888203449,34,846,284,3.1547619047619047
59,2,3,1,888203449,888203482,33,284,472,2.984375
59,3,3,0,888203482,888203578,96,472,405,3.25
59,3,4,1,888203578,888203610,32,405,975,3.411764705882353
59,4,2,-2,888203610,888203658,48,975,756,2.6885245901639343
59,2,2,0,888203658,888203659,1,756,760,2.35
59,2,1,-1,888203659,888203708,49,760,926,2.7857142857142856
59,1,4,3,888203708,888203709,1,926,764,3.1176470588235294
59,4,5,1,888203709,888203749,40,764,823,2.75
59,5,3,-2,888203749,888203750,1,823,290,3.108108108108108
59,3,2,-1,888203750,888203865,115,290,871,2.3823529411764706
59,2,1,-1,888203865,888203900,35,871,1120,3.1
59,1,4,3,888203900,888203959,59,1120,106,2.8125
59,4,5,1,888203959,888204309,350,106,483,4.475609756097561
59,5,4,-1,888204309,888204389,80,483,466,3.5
59,4,4,0,888204389,888204430,41,466,515,4.202898550724638
59,4,5,1,888204430,888204553,123,515,55,4.051282051282051
59,5,4,-1,888204553,888204597,44,55,429,3.742857142857143
59,4,5,1,888204597,888204641,44,429,514,4.033333333333333
59,5,5,0,888204641,888204642,1,514,655,3.7857142857142856
59,5,4,-1,888204642,888204757,115,655,169,4.548387096774194
59,4,5,1,888204757,888204758,1,169,1111,4.0
59,5,3,-2,888204758,888204841,83,1111,194,4.029411764705882
59,3,5,2,888204841,888204877,36,194,181,3.98974358974359
59,5,3,-2,888204877,888204927,50,181,604,3.8181818181818183
59,3,5,2,888204927,888204965,38,604,511,4.096153846153846
59,5,5,0,888204965,888204996,31,511,179,3.8823529411764706
59,5,4,-1,888204996,888205033,37,179,644,3.7
59,4,3,-1,888205033,888205088,55,644,1109,3.4545454545454546
59,3,4,1,888205088,888205188,100,1109,4,3.5538461538461537
59,4,2,-2,888205188,888205228,40,4,68,3.5714285714285716
59,2,4,2,888205228,888205265,37,68,65,3.511111111111111
59,4,4,0,888205265,888205300,35,65,582,3.7457627118644066
59,4,5,1,888205300,888205336,36,582,647,4.142857142857143
59,5,5,0,888205336,888205370,34,647,443,3.8421052631578947
59,5,3,-2,888205370,888205463,93,443,710,3.41025641025641
59,3,5,2,888205463,888205534,71,710,675,3.625
59,5,5,0,888205534,888205659,125,675,96,3.9130434782608696
59,5,5,0,888205659,888205660,1,96,82,3.6741573033707864
59,5,5,0,888205660,888205744,84,82,11,3.8904109589041096
59,5,4,-1,888205744,888205745,1,11,570,3.526315789473684
59,4,4,0,888205745,888205787,42,570,448,3.466666666666667
59,4,1,-3,888205787,888205855,68,448,501,3.289473684210526
59,1,3,2,888205855,888205921,66,501,229,3.185185185185185
59,3,3,0,888205921,888205956,35,229,488,4.277777777777778
59,3,5,2,888205956,888205982,26,488,433,3.8035714285714284
59,5,2,-3,888205982,888206048,66,433,1118,3.533333333333333
59,2,3,1,888206048,888206125,77,1118,662,3.4583333333333335
59,3,3,0,888206125,888206161,36,662,1112,2.9
59,3,4,1,888206161,888206254,93,1112,1107,2.9
59,4,4,0,888206254,888206296,42,1107,402,3.3076923076923075
59,4,4,0,888206296,888206362,66,402,226,3.378787878787879
59,4,2,-2,888206362,888206363,1,226,90,3.0
59,2,3,1,888206363,888206409,46,90,951,2.6666666666666665
59,3,4,1,888206409,888206410,1,951,708,3.3157894736842106
59,4,1,-3,888206410,888206445,35,708,946,3.1153846153846154
59,1,1,0,888206445,888206561,116,946,142,3.1481481481481484
59,1,3,2,888206561,888206562,1,142,1116,3.5714285714285716
59,3,5,2,888206562,888206605,43,1116,101,3.4827586206896552
59,5,4,-1,888206605,888206809,204,101,323,3.0
72,4,5,1,880035614,880035636,22,1,9,3.8878504672897196
72,5,5,0,880035636,880035680,44,9,100,4.0162162162162165
72,5,5,0,880035680,880035708,28,100,591,3.7169811320754715
72,5,3,-2,880035708,880035786,78,591,220,3.433333333333333
72,3,4,1,880035786,880035887,101,220,866,3.3962264150943398
72,4,4,0,880035887,880035958,71,866,1051,3.625
72,4,3,-1,880035958,880036048,90,1051,121,3.521212121212121
72,3,4,1,880036048,880036185,137,121,106,2.8125
72,4,3,-1,880036185,880036346,161,106,237,3.7315436241610738
72,3,1,-2,880036346,880036347,1,237,7,3.76056338028169
72,1,5,4,880036347,880036515,168,7,520,4.136363636363637
72,5,4,-1,880036515,880036550,35,520,23,3.9047619047619047
72,4,4,0,880036550,880036638,88,23,58,3.543859649122807
72,4,4,0,880036638,880036664,26,58,528,4.241379310344827
72,4,4,0,880036664,880036718,54,528,521,3.787878787878788
72,4,4,0,880036718,880036746,28,521,527,3.823529411764706
72,4,3,-1,880036746,880036783,37,527,699,3.736842105263158
72,3,4,1,880036783,880036824,41,699,518,3.5833333333333335
72,4,3,-1,880036824,880036854,30,518,54,3.3714285714285714
72,3,4,1,880036854,880036911,57,54,356,3.2
72,4,4,0,880036911,880036945,34,356,77,3.3857142857142857
72,4,4,0,880036945,880036946,1,77,51,3.5277777777777777
72,4,4,0,880036946,880036996,50,51,581,3.130434782608696
72,4,3,-1,880036996,880037020,24,581,664,3.15
72,3,4,1,880037020,880037119,99,664,79,3.956989247311828
72,4,1,-3,880037119,880037203,84,79,181,3.98974358974359
72,1,4,3,880037203,880037204,1,181,177,3.875
72,4,5,1,880037204,880037242,38,177,435,3.8933333333333335
72,5,4,-1,880037242,880037277,35,435,566,3.543859649122807
72,4,3,-1,880037277,880037307,30,566,38,2.784313725490196
72,3,3,0,880037307,880037334,27,38,1110,2.85
72,3,3,0,880037334,880037376,42,1110,2,3.0851063829787235
72,3,5,2,880037376,880037417,41,2,98,4.240875912408759
72,5,3,-2,880037417,880037418,1,98,443,3.8421052631578947
72,3,4,1,880037418,880037436,18,443,525,4.0
72,4,3,-1,880037436,880037462,26,525,203,3.826923076923077
72,3,4,1,880037462,880037479,17,203,642,3.4285714285714284
72,4,5,1,880037479,880037768,289,642,480,4.283018867924528
72,5,4,-1,880037768,880037793,25,480,194,4.029411764705882
72,4,5,1,880037793,880037853,60,194,45,4.130434782608695
72,5,4,-1,880037853,880037881,28,45,479,4.25
87,3,4,1,879875471,879875649,178,303,48,4.055555555555555
87,4,5,1,879875649,879875734,85,48,210,3.921259842519685
87,5,5,0,879875734,879875736,2,210,174,4.253521126760563
87,5,4,-1,879875736,879875737,1,174,182,3.842857142857143
87,4,5,1,879875737,879875775,38,182,566,3.543859649122807
87,5,4,-1,879875775,879875817,42,566,22,4.215909090909091
87,4,5,1,879875817,879875818,1,22,385,3.6129032258064515
87,5,5,0,879875818,879875856,38,385,79,3.956989247311828
87,5,3,-2,879875856,879875857,1,79,273,3.5238095238095237
87,3,4,1,879875857,879875893,36,273,651,3.8627450980392157
87,4,3,-1,879875893,879875940,47,651,578,3.066666666666667
87,3,4,1,879875940,879875996,56,578,472,2.984375
87,4,3,-1,879875996,879876036,40,472,679,3.2432432432432434
87,3,4,1,879876036,879876074,38,679,2,3.0851063829787235
87,4,2,-2,879876074,879876110,36,2,1188,2.45
87,2,4,2,879876110,879876162,52,1188,118,3.2764227642276422
87,4,3,-1,879876162,879876163,1,118,570,3.526315789473684
87,3,4,1,879876163,879876194,31,570,1016,3.559322033898305
87,4,3,-1,879876194,879876224,30,1016,252,2.911392405063291
87,3,3,0,879876224,879876225,1,252,1089,2.1363636363636362
87,3,4,1,879876225,879876256,31,1089,254,2.7419354838709675
87,4,4,0,879876256,879876315,59,254,535,3.380952380952381
87,4,4,0,879876315,879876336,21,535,1190,3.4285714285714284
87,4,5,1,879876336,879876403,67,1190,194,4.029411764705882
87,5,5,0,879876403,879876447,44,194,8,3.903225806451613
87,5,5,0,879876447,879876448,1,8,70,3.5833333333333335
87,5,5,0,879876448,879876488,40,70,100,4.0162162162162165
87,5,5,0,879876488,879876524,36,100,4,3.5538461538461537
87,5,3,-2,879876524,879876610,86,4,789,3.7777777777777777
87,3,3,0,879876610,879876637,27,789,47,3.5869565217391304
87,3,2,-1,879876637,879876673,36,47,201,3.75
87,2,4,2,879876673,879876703,30,201,393,3.5125
87,4,4,0,879876703,879876734,31,393,871,2.3823529411764706
87,4,3,-1,879876734,879876768,34,871,801,2.2
87,3,3,0,879876768,879876812,44,801,1049,2.5714285714285716
87,3,2,-1,879876812,879876813,1,1049,321,3.0172413793103448
87,2,2,0,879876813,879876848,35,321,775,2.4285714285714284
87,2,3,1,879876848,879876885,37,775,715,3.257142857142857
87,3,3,0,879876885,879876886,1,715,1186,3.0
87,3,3,0,879876886,879876917,31,1186,702,2.764705882352941
87,3,4,1,879876917,879876946,29,702,411,2.911764705882353
87,4,4,0,879876946,879877006,60,411,629,3.3333333333333335
87,4,4,0,879877006,879877008,2,629,585,2.5384615384615383
87,4,3,-1,879877008,879877043,35,585,1182,2.4285714285714284
87,3,3,0,879877043,879877083,40,1182,73,3.588235294117647
87,3,2,-1,879877083,879877127,44,73,90,3.0
87,2,3,1,879877127,879877173,46,90,158,2.7027027027027026
87,3,4,1,879877173,879877208,35,158,866,3.3962264150943398
87,4,2,-2,879877208,879877240,32,866,1079,2.1923076923076925
87,2,2,0,879877240,879877241,1,1079,476,3.1216216216216215
87,2,2,0,879877241,879877279,38,476,598,2.5
87,2,1,-1,879877279,879877280,1,598,1177,3.0
87,1,3,2,879877280,879877404,124,1177,297,4.142857142857143
87,3,4,1,879877404,879877652,248,297,519,4.291666666666667
87,4,5,1,879877652,879877681,29,519,196,3.9404761904761907
87,5,3,-2,879877681,879877710,29,196,423,3.7016129032258065
87,3,3,0,879877710,879877741,31,423,192,4.090909090909091
87,3,3,0,879877741,879877772,31,192,521,3.787878787878788
87,3,3,0,879877772,879877799,27,521,157,3.5714285714285716
87,3,4,1,879877799,879877824,25,157,427,4.2025316455696204
87,4,5,1,879877824,879877825,1,427,97,3.7282608695652173
87,5,5,0,879877825,879877930,105,97,491,3.55
87,5,5,0,879877930,879877951,21,491,1189,5.0
42,4,4,0,881105462,881105505,43,125,118,3.2764227642276422
42,4,4,0,881105505,881105541,36,118,405,3.25
42,4,3,-1,881105541,881105581,40,405,284,3.1547619047619047
42,3,5,2,881105581,881105633,52,284,1,3.902439024390244
42,5,3,-2,881105633,881105766,133,1,926,2.7857142857142856
42,3,3,0,881105766,881105817,51,926,546,2.9789473684210526
42,3,4,1,881105817,881105882,65,546,222,3.578125
42,4,4,0,881105882,881105972,90,222,866,3.3962264150943398
42,4,1,-3,881105972,881106072,100,866,413,2.5652173913043477
42,1,4,3,881106072,881106113,41,413,925,3.0
42,4,3,-1,881106113,881106162,49,925,103,2.2
42,3,1,-2,881106162,881106220,58,103,1048,2.857142857142857
42,1,4,3,881106220,881106270,50,1048,280,3.103448275862069
42,4,4,0,881106270,881106317,47,280,411,2.911764705882353
42,4,1,-3,881106317,881106582,265,411,595,2.9166666666666665
42,1,5,4,881106582,881106711,129,595,174,4.253521126760563
42,5,5,0,881106711,881107220,509,174,173,4.1441441441441444
42,5,4,-1,881107220,881107256,36,173,568,3.5853658536585367
42,4,5,1,881107256,881107291,35,568,181,3.98974358974359
42,5,5,0,881107291,881107329,38,181,194,4.029411764705882
42,5,5,0,881107329,881107375,46,194,523,4.159090909090909
42,5,5,0,881107375,881107413,38,523,215,3.662921348314607
42,5,2,-3,881107413,881107502,89,215,658,3.393939393939394
42,2,4,2,881107502,881107576,74,658,87,3.9
42,4,3,-1,881107576,881107642,66,87,655,3.7857142857142856
42,3,5,2,881107642,881107687,45,655,202,3.730337078651685
42,5,5,0,881107687,881107718,31,202,496,4.094594594594595
42,5,4,-1,881107718,881107773,55,496,427,4.2025316455696204
42,4,5,1,881107773,881107821,48,427,48,4.055555555555555
42,5,3,-2,881107821,881107880,59,48,86,3.869565217391304
42,3,5,2,881107880,881107949,69,86,195,3.9072164948453607
42,5,5,0,881107949,881108040,91,195,79,3.956989247311828
42,5,4,-1,881108040,881108093,53,79,684,3.847826086956522
42,4,5,1,881108093,881108147,54,684,216,3.8454545454545452
42,5,3,-2,881108147,881108279,132,216,746,3.7560975609756095
42,3,4,1,881108279,881108280,1,746,66,3.4705882352941178
42,4,5,1,881108280,881108345,65,66,501,3.289473684210526
42,5,5,0,881108345,881108346,1,501,99,3.8392857142857144
42,5,3,-2,881108346,881108425,79,99,794,3.6
42,3,4,1,881108425,881108484,59,794,939,3.6333333333333333
42,4,2,-2,881108484,881108548,64,939,131,3.731707317073171
42,2,2,0,881108548,881108633,85,131,1043,3.2
42,2,3,1,881108633,881108684,51,1043,403,3.298507462686567
42,3,3,0,881108684,881108760,76,403,1046,3.3529411764705883
42,3,2,-1,881108760,881108815,55,1046,953,3.076923076923077
42,2,5,3,881108815,881108873,58,953,102,3.3684210526315788
42,5,3,-2,881108873,881109059,186,102,141,3.4827586206896552
42,3,4,1,881109059,881109060,1,141,785,3.4375
42,4,4,0,881109060,881109148,88,785,135,3.7974683544303796
42,4,4,0,881109148,881109149,1,135,720,3.2
42,4,4,0,881109149,881109271,122,720,1044,3.2777777777777777
42,4,1,-3,881109271,881109324,53,1044,219,2.735294117647059
42,1,2,1,881109324,881109325,1,219,43,3.1
42,2,4,2,881109325,881110578,1253,43,121,3.521212121212121
42,4,3,-1,881110578,881110670,92,121,25,3.3185840707964602
42,3,5,2,881110670,881110719,49,25,845,3.661290322580645
42,5,1,-4,881110719,881110763,44,845,834,2.0
292,4,5,1,877628139,881103478,3475339,300,176,3.967032967032967
292,5,5,0,881103478,881103631,153,176,173,4.1441441441441444
292,5,5,0,881103631,881103652,21,173,180,3.9473684210526314
292,5,5,0,881103652,881103711,59,180,657,4.341463414634147
292,5,5,0,881103711,881103758,47,657,98,4.240875912408759
292,5,5,0,881103758,881103874,116,98,209,3.8275862068965516
292,5,4,-1,881103874,881103896,22,209,285,4.181818181818182
292,4,5,1,881103896,881103915,19,285,276,3.6036036036036037
292,5,4,-1,881103915,881103977,62,276,298,3.779220779220779
292,4,5,1,881103977,881103999,22,298,100,4.0162162162162165
292,5,4,-1,881103999,881104068,69,100,181,3.98974358974359
292,4,5,1,881104068,881104093,25,181,11,3.8904109589041096
292,5,4,-1,881104093,881104147,54,11,124,4.052631578947368
292,4,4,0,881104147,881104148,1,124,9,3.8878504672897196
292,4,4,0,881104148,881104194,46,9,115,3.6666666666666665
292,4,5,1,881104194,881104268,74,115,127,4.162790697674419
292,5,5,0,881104268,881104360,92,127,83,4.204081632653061
292,5,2,-3,881104360,881104401,41,83,125,3.5555555555555554
292,2,3,1,881104401,881104424,23,125,1014,3.1
292,3,3,0,881104424,881104533,109,1014,324,3.2291666666666665
292,3,4,1,881104533,881104581,48,324,1010,3.611111111111111
292,4,4,0,881104581,881104606,25,1010,117,3.689189189189189
292,4,4,0,881104606,881104661,55,117,282,3.610526315789474
292,4,3,-1,881104661,881104679,18,282,250,3.4698795180722892
292,3,3,0,881104679,881104701,22,250,118,3.2764227642276422
292,3,2,-1,881104701,881104760,59,118,20,3.375
292,2,3,1,881104760,881104797,37,20,235,3.106382978723404
292,3,3,0,881104797,881104820,23,235,405,3.25
292,3,3,0,881104820,881104881,61,405,252,2.911392405063291
292,3,3,0,881104881,881105031,150,252,535,3.380952380952381
292,3,3,0,881105031,881105123,92,535,628,3.573529411764706
292,3,4,1,881105123,881105135,12,628,150,3.803921568627451
292,4,3,-1,881105135,881105195,60,150,222,3.578125
292,3,5,2,881105195,881105211,16,222,228,3.7246376811594204
292,5,5,0,881105211,881105245,34,228,234,3.7674418604651163
292,5,5,0,881105245,881105246,1,234,197,4.112676056338028
292,5,4,-1,881105246,881105281,35,197,226,3.378787878787879
292,4,5,1,881105281,881105318,37,226,168,4.0476190476190474
292,5,5,0,881105318,881105340,22,168,659,4.027777777777778
292,5,5,0,881105340,881105373,33,659,511,4.096153846153846
292,5,4,-1,881105373,881105374,1,511,705,3.7857142857142856
292,4,4,0,881105374,881105442,68,705,194,4.029411764705882
292,4,5,1,881105442,881105481,39,194,654,4.119047619047619
292,5,4,-1,881105481,881105516,35,654,479,4.25
292,4,5,1,881105516,881105561,45,479,661,4.133333333333334
292,5,4,-1,881105561,881105587,26,661,265,3.710144927536232
292,4,3,-1,881105587,881105701,114,265,214,3.272727272727273
292,3,5,2,881105701,881105778,77,214,631,3.581818181818182
20,4,4,0,879667684,879667904,220,323,181,3.98974358974359
20,4,3,-1,879667904,879667937,33,181,50,4.306532663316583
20,3,3,0,879667937,879667963,26,50,1,3.902439024390244
20,3,3,0,879667963,879668227,264,1,121,3.521212121212121
20,3,4,1,879668227,879668248,21,121,274,3.5609756097560976
20,4,4,0,879668248,879668442,194,274,118,3.2764227642276422
20,4,1,-3,879668442,879668476,34,118,763,3.347826086956522
20,1,3,2,879668476,879668555,79,763,151,3.6544117647058822
20,3,1,-2,879668555,879668583,28,151,866,3.3962264150943398
20,1,2,1,879668583,879668626,43,866,820,3.0444444444444443
20,2,5,3,879668626,879668713,87,820,148,3.2131147540983607
20,5,4,-1,879668713,879668783,70,148,934,3.0294117647058822
20,4,1,-3,879668783,879668829,46,934,931,2.2758620689655173
20,1,1,0,879668829,879668979,150,931,69,3.8015873015873014
20,1,3,2,879668979,879669040,61,69,186,3.905263157894737
20,3,4,1,879669040,879669065,25,186,210,3.921259842519685
20,4,4,0,879669065,879669087,22,210,174,4.253521126760563
20,4,4,0,879669087,879669120,33,174,588,3.8358208955223883
20,4,3,-1,879669120,879669152,32,588,194,4.029411764705882
20,3,3,0,879669152,879669181,29,194,95,3.8194444444444446
20,3,1,-2,879669181,879669244,63,95,357,4.063291139240507
20,1,4,3,879669244,879669291,47,357,568,3.5853658536585367
20,4,2,-2,879669291,879669313,22,568,423,3.7016129032258065
20,2,5,3,879669313,879669339,26,423,22,4.215909090909091
20,5,3,-2,879669339,879669547,208,22,98,4.240875912408759
20,3,3,0,879669547,879669630,83,98,378,3.6904761904761907
20,3,5,2,879669630,879669746,116,378,87,3.9
20,5,3,-2,879669746,879670039,293,87,204,3.6744186046511627
13,3,3,0,881514810,881514811,1,333,328,3.4895833333333335
13,3,1,-2,881514811,881514876,65,328,271,3.3134328358208953
13,1,5,4,881514876,881515011,135,271,12,4.358974358974359
13,5,4,-1,881515011,881515112,101,12,474,4.172413793103448
13,4,3,-1,881515112,881515113,1,474,475,3.956043956043956
13,3,2,-1,881515113,881515193,80,475,242,3.5217391304347827
13,2,4,2,881515193,881515239,46,242,433,3.8035714285714284
13,4,3,-1,881515239,881515295,56,433,165,3.9130434782608696
13,3,3,0,881515295,881515296,1,165,195,3.9072164948453607
13,3,4,1,881515296,881515348,52,195,615,3.8333333333333335
13,4,4,0,881515348,881515411,63,615,613,4.1
13,4,3,-1,881515411,881515457,46,613,331,3.5517241379310347
13,3,1,-2,881515457,881515565,108,331,873,2.7586206896551726
13,1,5,4,881515565,881515613,48,873,886,2.857142857142857
13,5,5,0,881515613,881515647,34,886,263,2.2
13,5,3,-2,881515647,881515698,51,263,299,3.0
13,3,2,-1,881515698,881515735,37,299,689,3.1538461538461537
13,2,1,-1,881515735,881515736,1,689,300,3.6861313868613137
13,1,5,4,881515736,882139347,623611,300,182,3.842857142857143
13,5,5,0,882139347,882139495,148,182,430,4.136363636363637
13,5,5,0,882139495,882139541,46,430,135,3.7974683544303796
13,5,4,-1,882139541,882139686,145,135,766,3.3333333333333335
13,4,5,1,882139686,882139717,31,766,510,3.823529411764706
13,5,3,-2,882139717,882139746,29,510,79,3.956989247311828
13,3,5,2,882139746,882139774,28,79,170,4.242424242424242
13,5,5,0,882139774,882139804,30,170,137,3.9545454545454546
13,5,2,-3,882139804,882139863,59,137,173,4.1441441441441444
13,2,5,3,882139863,882139901,38,173,223,4.108695652173913
13,5,5,0,882139901,882139937,36,223,285,4.181818181818182
13,5,5,0,882139937,882139966,29,285,851,5.0
13,5,5,0,882139966,882140001,35,851,848,4.0
13,5,4,-1,882140001,882140002,1,848,211,3.958904109589041
13,4,4,0,882140002,882140037,35,211,646,3.9285714285714284
13,4,1,-3,882140037,882140070,33,646,507,3.6285714285714286
13,1,5,4,882140070,882140104,34,507,95,3.8194444444444446
13,5,4,-1,882140104,882140130,26,95,188,3.625
13,4,5,1,882140130,882140166,36,188,497,3.35
13,5,5,0,882140166,882140206,40,497,647,4.142857142857143
13,5,5,0,882140206,882140252,46,647,527,3.823529411764706
13,5,5,0,882140252,882140285,33,527,237,3.7315436241610738
13,5,4,-1,882140285,882140286,1,237,32,3.7222222222222223
13,4,5,1,882140286,882140318,32,32,204,3.6744186046511627
13,5,5,0,882140318,882140354,36,204,181,3.98974358974359
13,5,5,0,882140354,882140355,1,181,519,4.291666666666667
13,5,2,-3,882140355,882140389,34,519,421,3.462962962962963
13,2,2,0,882140389,882140425,36,421,650,3.1363636363636362
13,2,5,3,882140425,882140426,1,650,806,3.6666666666666665
13,5,4,-1,882140426,882140487,61,806,22,4.215909090909091
13,4,5,1,882140487,882140588,101,22,215,3.662921348314607
13,5,5,0,882140588,882140624,36,215,525,4.0
13,5,3,-2,882140624,882140691,67,525,70,3.5833333333333335
13,3,1,-2,882140691,882140718,27,70,301,3.2465753424657535
13,1,2,1,882140718,882140740,22,301,321,3.0172413793103448
13,2,3,1,882140740,882140792,52,321,678,2.8181818181818183
13,3,2,-1,882140792,882140814,22,678,884,3.5
13,2,3,1,882140814,882140848,34,884,323,3.0
13,3,5,2,882140848,882140867,19,323,887,3.5789473684210527
13,5,3,-2,882140867,882140966,99,887,880,2.8421052631578947
13,3,3,0,882140966,882141053,87,880,526,3.909090909090909
13,3,5,2,882141053,882141248,195,526,180,3.9473684210526314
13,5,3,-2,882141248,882141306,58,180,209,3.8275862068965516
13,3,5,2,882141306,882141335,29,209,154,3.6031746031746033
13,5,5,0,882141335,882141336,1,154,762,3.3962264150943398
13,5,5,0,882141336,882141392,56,762,435,3.8933333333333335
13,5,3,-2,882141392,882141393,1,435,821,3.076923076923077
13,3,3,0,882141393,882141425,32,821,455,3.1702127659574466
13,3,4,1,882141425,882141458,33,455,805,3.909090909090909
13,4,1,-3,882141458,882141459,1,805,287,3.4516129032258065
13,1,5,4,882141459,882141485,26,287,516,4.055555555555555
13,5,3,-2,882141485,882141503,18,516,845,3.661290322580645
13,3,5,2,882141503,882141617,114,845,732,3.6266666666666665
13,5,4,-1,882141617,882141659,42,732,167,2.8181818181818183
13,4,5,1,882141659,882141686,27,167,791,3.0
13,5,3,-2,882141686,882141727,41,791,869,3.0
13,3,4,1,882141727,882141752,25,869,239,3.423076923076923
13,4,2,-2,882141752,882141841,89,239,235,3.106382978723404
13,2,3,1,882141841,882141872,31,235,90,3.0
13,3,1,-2,882141872,882396869,254997,90,706,2.3333333333333335
13,1,2,1,882396869,882396913,44,706,637,2.888888888888889
13,2,1,-1,882396913,882396914,1,637,760,2.35
13,1,1,0,882396914,882396954,40,760,17,3.032258064516129
13,1,1,0,882396954,882396983,29,17,816,2.0
13,1,1,0,882396983,882396984,1,816,441,2.4
13,1,1,0,882396984,882397010,26,441,853,2.75
13,1,1,0,882397010,882397011,1,853,406,2.5294117647058822
13,1,1,0,882397011,882397039,28,406,446,2.0
13,1,1,0,882397039,882397040,1,446,859,2.75
13,1,1,0,882397040,882397067,27,859,669,2.0
13,1,1,0,882397067,882397068,1,669,424,1.4
13,1,1,0,882397068,882397084,16,424,551,1.6666666666666667
13,1,5,4,882397084,882397146,62,551,686,3.9
13,5,5,0,882397146,882397271,125,686,177,3.875
13,5,5,0,882397271,882397503,232,177,121,3.521212121212121
13,5,3,-2,882397503,882397581,78,121,39,3.107142857142857
13,3,3,0,882397581,882397582,1,39,231,2.938775510204082
13,3,4,1,882397582,882397650,68,231,679,3.2432432432432434
13,4,1,-3,882397650,882397651,1,679,825,2.914285714285714
13,1,4,3,882397651,882397741,90,825,550,3.272727272727273
13,4,2,-2,882397741,882397742,1,550,405,3.25
13,2,2,0,882397742,882397974,232,405,833,2.9444444444444446
13,2,5,3,882397974,882398076,102,833,810,2.9473684210526314
13,5,3,-2,882398076,882398138,62,810,117,3.689189189189189
13,3,2,-1,882398138,882398254,116,117,802,3.076923076923077
13,2,3,1,882398254,882398255,1,802,391,2.4285714285714284
13,3,3,0,882398255,882398326,71,391,586,2.875
13,3,5,2,882398326,882398327,1,586,472,2.984375
13,5,3,-2,882398327,882398385,58,472,829,2.4615384615384617
13,3,3,0,882398385,882398410,25,829,540,2.4615384615384617
13,3,3,0,882398410,882398494,84,540,450,2.2758620689655173
13,3,2,-1,882398494,882398542,48,450,759,2.6
13,2,4,2,882398542,882398654,112,759,99,3.8392857142857144
13,4,3,-1,882398654,882398691,37,99,596,3.180327868852459
13,3,4,1,882398691,882398724,33,596,473,2.9166666666666665
13,4,4,0,882398724,882398743,19,473,820,3.0444444444444443
13,4,4,0,882398743,882398763,20,820,588,3.8358208955223883
13,4,5,1,882398763,882398814,51,588,427,4.2025316455696204
13,5,3,-2,882398814,882398934,120,427,416,3.3846153846153846
13,3,3,0,882398934,882399014,80,416,755,3.085714285714286
13,3,3,0,882399014,882399040,26,755,21,2.9210526315789473
13,3,3,0,882399040,882399074,34,21,862,1.6666666666666667
13,3,4,1,882399074,882399156,82,862,832,2.7142857142857144
13,4,1,-3,882399156,882399218,62,832,138,2.6
13,1,2,1,882399218,882399219,1,138,795,2.4
13,2,4,2,882399219,882399357,138,795,97,3.7282608695652173
13,4,3,-1,882399357,882399419,62,97,51,3.5277777777777777
13,3,5,2,882399419,882399420,1,51,662,3.4583333333333335
13,5,3,-2,882399420,882399528,108,662,722,2.9642857142857144
13,3,2,-1,882399528,882399615,87,722,394,3.5714285714285716
13,2,4,2,882399615,882774047,374432,394,313,4.323076923076923
13,4,5,1,882774047,882774081,34,313,751,3.3896103896103895
13,5,3,-2,882774081,882774224,143,751,892,2.9615384615384617
13,3,4,1,882774224,883670552,896328,892,346,3.5128205128205128
13,4,1,-3,883670552,883670630,78,346,312,3.0
13,1,1,0,883670630,883670705,75,312,687,2.1481481481481484
13,1,1,0,883670705,883670742,37,687,682,3.0476190476190474
13,1,1,0,883670742,883670785,43,682,878,2.0
13,1,1,0,883670785,883670819,34,878,688,2.111111111111111
13,1,1,0,883670819,884538448,867629,688,538,3.25
13,1,5,4,884538448,884538466,18,538,315,4.15
13,5,1,-4,884538466,884538485,19,315,314,1.0
13,1,4,3,884538485,884538634,149,314,614,3.727272727272727
13,4,3,-1,884538634,884538664,30,614,632,3.9523809523809526
13,3,4,1,884538664,884538727,63,632,14,4.101694915254237
13,4,3,-1,884538727,884538766,39,14,746,3.7560975609756095
13,3,4,1,884538766,884538767,1,746,60,4.105263157894737
13,4,2,-2,884538767,886261388,1722621,60,888,3.0
13,2,4,2,886261388,886261450,62,888,353,2.4285714285714284
13,4,2,-2,886261450,886302293,40843,353,350,3.2
13,2,1,-1,886302293,886302385,92,350,908,2.5714285714285716
13,1,2,1,886302385,886302815,430,908,40,2.7037037037037037
13,2,2,0,886302815,886302858,43,40,756,2.6885245901639343
13,2,4,2,886302858,886303745,887,756,739,3.391304347826087
13,4,3,-1,886303745,886304229,484,739,387,3.5357142857142856
13,3,1,-2,886304229,886952422,648193,387,897,1.0
13,1,3,2,886952422,886952438,16,897,882,3.6666666666666665
13,3,1,-2,886952438,886952467,29,882,334,3.4210526315789473
13,1,1,0,886952467,886952521,54,334,683,2.176470588235294
13,1,1,0,886952521,886952569,48,683,752,3.6666666666666665
13,1,5,4,886952569,888073653,1121084,752,316,4.285714285714286
13,5,3,-2,888073653,890704759,2631106,316,903,2.6666666666666665
13,3,2,-1,890704759,890705034,275,903,141,3.4827586206896552
13,2,1,-1,890705034,890705056,22,141,442,1.0
13,1,1,0,890705056,892014908,1309852,442,913,2.5
13,1,5,4,892014908,892015023,115,913,915,4.0
13,5,4,-1,892015023,892015104,81,915,917,4.0
13,4,2,-2,892015104,892015141,37,917,911,2.5
13,2,1,-1,892015141,892015178,37,911,904,4.125
13,1,3,2,892015178,892015236,58,904,889,3.6666666666666665
138,2,4,2,879022956,879023031,75,116,1,3.902439024390244
138,4,5,1,879023031,879023131,100,1,137,3.9545454545454546
138,5,4,-1,879023131,879023245,114,137,285,4.181818181818182
138,4,4,0,879023245,879023389,144,285,151,3.6544117647058822
138,4,5,1,879023389,879023947,558,151,497,3.35
138,5,4,-1,879023947,879023948,1,497,182,3.842857142857143
138,4,5,1,879023948,879024043,95,182,519,4.291666666666667
138,5,4,-1,879024043,879024127,84,519,484,4.116279069767442
138,4,4,0,879024127,879024128,1,484,662,3.4583333333333335
138,4,4,0,879024128,879024184,56,662,614,3.727272727272727
138,4,5,1,879024184,879024232,48,614,435,3.8933333333333335
138,5,4,-1,879024232,879024279,47,435,517,3.625
138,4,5,1,879024279,879024280,1,517,483,4.475609756097561
138,5,4,-1,879024280,879024382,102,483,493,3.909090909090909
60,4,5,1,883325508,883325994,486,327,493,3.909090909090909
60,5,5,0,883325994,883326028,34,493,608,4.285714285714286
60,5,4,-1,883326028,883326057,29,608,136,3.764705882352941
60,4,4,0,883326057,883326086,29,136,204,3.6744186046511627
60,4,5,1,883326086,883326122,36,204,430,4.136363636363637
60,5,5,0,883326122,883326155,33,430,59,4.0
60,5,5,0,883326155,883326185,30,59,593,4.0
60,5,5,0,883326185,883326215,30,593,615,3.8333333333333335
60,5,5,0,883326215,883326273,58,615,445,3.727272727272727
60,5,5,0,883326273,883326339,66,445,199,4.191489361702128
60,5,4,-1,883326339,883326370,31,199,519,4.291666666666667
60,4,4,0,883326370,883326399,29,519,494,3.8333333333333335
60,4,4,0,883326399,883326425,26,494,194,4.029411764705882
60,4,4,0,883326425,883326426,1,194,205,3.717391304347826
60,4,4,0,883326426,883326463,37,205,98,4.240875912408759
60,4,4,0,883326463,883326497,34,98,613,4.1
60,4,4,0,883326497,883326498,1,613,173,4.1441441441441444
60,4,4,0,883326498,883326525,27,173,160,3.4
60,4,5,1,883326525,883326566,41,160,50,4.306532663316583
60,5,4,-1,883326566,883326593,27,50,423,3.7016129032258065
60,4,5,1,883326593,883326620,27,423,427,4.2025316455696204
60,5,4,-1,883326620,883326682,62,427,275,4.087912087912088
60,4,4,0,883326682,883326710,28,275,705,3.7857142857142856
60,4,5,1,883326710,883326733,23,705,429,3.742857142857143
60,5,4,-1,883326733,883326784,51,429,708,3.3157894736842106
60,4,4,0,883326784,883326837,53,708,546,2.9789473684210526
60,4,3,-1,883326837,883326893,56,546,605,3.3333333333333335
60,3,4,1,883326893,883326919,26,605,56,4.051724137931035
60,4,4,0,883326919,883326995,76,56,633,3.9
60,4,4,0,883326995,883327018,23,633,1020,3.727272727272727
60,4,4,0,883327018,883327040,22,1020,77,3.3857142857142857
60,4,3,-1,883327040,883327087,47,77,403,3.298507462686567
60,3,3,0,883327087,883327113,26,403,618,3.5
60,3,4,1,883327113,883327174,61,618,1126,3.625
60,4,4,0,883327174,883327201,27,1126,810,2.9473684210526314
60,4,4,0,883327201,883327265,64,810,161,3.5844155844155843
60,4,3,-1,883327265,883327287,22,161,404,3.6578947368421053
60,3,3,0,883327287,883327342,55,404,207,3.4761904761904763
60,3,4,1,883327342,883327368,26,207,366,3.4285714285714284
60,4,4,0,883327368,883327394,26,366,502,3.272727272727273
60,4,5,1,883327394,883327441,47,502,506,3.566666666666667
60,5,4,-1,883327441,883327442,1,506,237,3.7315436241610738
60,4,4,0,883327442,883327472,30,237,228,3.7246376811594204
60,4,4,0,883327472,883327493,21,228,211,3.958904109589041
60,4,4,0,883327493,883327538,45,211,218,3.5555555555555554
60,4,4,0,883327538,883327539,1,218,699,3.736842105263158
60,4,4,0,883327539,883327566,27,699,163,3.53125
60,4,3,-1,883327566,883327639,73,163,495,3.65
60,3,4,1,883327639,883327664,25,495,582,3.7457627118644066
60,4,4,0,883327664,883327684,20,582,88,3.433734939759036
60,4,5,1,883327684,883327734,50,88,60,4.105263157894737
60,5,4,-1,883327734,883327799,65,60,95,3.8194444444444446
60,4,4,0,883327799,883327827,28,95,216,3.8454545454545452
60,4,4,0,883327827,883327847,20,216,443,3.8421052631578947
60,4,3,-1,883327847,883327923,76,443,1050,3.6153846153846154
60,3,3,0,883327923,883327948,25,1050,71,3.6575342465753424
60,3,3,0,883327948,883327976,28,71,225,3.0714285714285716
60,3,4,1,883327976,883327997,21,225,1123,4.0
57,3,3,0,883696709,883696824,115,323,682,3.0476190476190474
57,3,3,0,883696824,883697158,334,682,284,3.1547619047619047
57,3,4,1,883697158,883697182,24,284,237,3.7315436241610738
57,4,5,1,883697182,883697223,41,237,248,3.746268656716418
57,5,1,-4,883697223,883697253,30,248,472,2.984375
57,1,3,2,883697253,883697352,99,472,1093,3.0
57,3,3,0,883697352,883697378,26,1093,410,3.0434782608695654
57,3,4,1,883697378,883697404,26,410,281,3.2
57,4,3,-1,883697404,883697432,28,281,1028,2.857142857142857
57,3,4,1,883697432,883697482,50,1028,546,2.9789473684210526
57,4,3,-1,883697482,883697536,54,546,871,2.3823529411764706
57,3,3,0,883697536,883697585,49,871,151,3.6544117647058822
57,3,2,-1,883697585,883697617,32,151,760,2.35
57,2,4,2,883697617,883697655,38,760,477,3.1666666666666665
57,4,4,0,883697655,883697679,24,477,411,2.911764705882353
57,4,5,1,883697679,883697704,25,411,249,3.3275862068965516
57,5,4,-1,883697704,883697730,26,249,1016,3.559322033898305
57,4,3,-1,883697730,883697761,31,1016,1011,3.1
57,3,1,-2,883697761,883697785,24,1011,831,2.6097560975609757
57,1,2,1,883697785,883697807,22,831,252,2.911392405063291
57,2,3,1,883697807,883697831,24,252,926,2.7857142857142856
57,3,3,0,883697831,883697915,84,926,866,3.3962264150943398
57,3,3,0,883697915,883697916,1,866,473,2.9166666666666665
57,3,4,1,883697916,883697960,44,473,717,2.9696969696969697
57,4,2,-2,883697960,883697990,30,717,1094,3.2
57,2,3,1,883697990,883698039,49,1094,225,3.0714285714285716
57,3,2,-1,883698039,883698062,23,225,1095,2.8
57,2,3,1,883698062,883698083,21,1095,456,2.2
57,3,4,1,883698083,883698272,189,456,194,4.029411764705882
57,4,4,0,883698272,883698292,20,194,8,3.903225806451613
57,4,5,1,883698292,883698324,32,8,42,3.893617021276596
57,5,4,-1,883698324,883698362,38,42,496,4.094594594594595
57,4,3,-1,883698362,883698408,46,496,144,3.9545454545454546
57,3,4,1,883698408,883698454,46,144,588,3.8358208955223883
57,4,5,1,883698454,883698495,41,588,79,3.956989247311828
57,5,3,-2,883698495,883698525,30,79,1073,3.6315789473684212
57,3,5,2,883698525,883698580,55,1073,318,4.5046728971962615
57,5,3,-2,883698580,883698646,66,318,56,4.051724137931035
223,3,4,1,891548646,891548675,29,1234,333,3.546666666666667
223,4,3,-1,891548675,891548712,37,333,300,3.6861313868613137
223,3,4,1,891548712,891548802,90,300,332,3.6511627906976742
223,4,4,0,891548802,891548828,26,332,682,3.0476190476190474
223,4,4,0,891548828,891548859,31,682,294,3.1052631578947367
223,4,1,-3,891548859,891548920,61,294,321,3.0172413793103448
223,1,3,2,891548920,891548959,39,321,328,3.4895833333333335
223,3,3,0,891548959,891548987,28,328,984,2.6666666666666665
223,3,1,-2,891548987,891549017,30,984,289,2.988888888888889
223,1,4,3,891549017,891549049,32,289,749,3.2777777777777777
223,4,2,-2,891549049,891549079,30,749,329,3.25
223,2,4,2,891549079,891549212,133,329,339,2.7058823529411766
223,4,3,-1,891549212,891549294,82,339,121,3.521212121212121
223,3,4,1,891549294,891549324,30,121,276,3.6036036036036037
223,4,4,0,891549324,891549382,58,276,255,3.2027027027027026
223,4,3,-1,891549382,891549410,28,255,295,3.769230769230769
223,3,1,-2,891549410,891549475,65,295,1009,3.2962962962962963
223,1,5,4,891549475,891549529,54,1009,117,3.689189189189189
223,5,3,-2,891549529,891549570,41,117,742,3.5555555555555554
223,3,4,1,891549570,891549604,34,742,597,3.2771084337349397
223,4,5,1,891549604,891549657,53,597,237,3.7315436241610738
223,5,1,-4,891549657,891549683,26,237,248,3.746268656716418
223,1,4,3,891549683,891549713,30,248,845,3.661290322580645
223,4,4,0,891549713,891549792,79,845,111,3.5106382978723403
223,4,2,-2,891549792,891549841,49,111,1150,3.0
223,2,3,1,891549841,891549876,35,1150,535,3.380952380952381
223,3,4,1,891549876,891549901,25,535,278,3.0357142857142856
223,4,3,-1,891549901,891549945,44,278,1051,3.625
223,3,4,1,891549945,891549975,30,1051,1014,3.1
223,4,3,-1,891549975,891550067,92,1014,763,3.347826086956522
223,3,4,1,891550067,891550094,27,763,274,3.5609756097560976
223,4,3,-1,891550094,891550144,50,274,477,3.1666666666666665
223,3,2,-1,891550144,891550193,49,477,846,3.1052631578947367
223,2,2,0,891550193,891550253,60,846,620,3.0
223,2,1,-1,891550253,891550295,42,620,1284,2.5454545454545454
223,1,3,2,891550295,891550349,54,1284,476,3.1216216216216215
223,3,4,1,891550349,891550371,22,476,820,3.0444444444444443
223,4,1,-3,891550371,891550404,33,820,826,2.5555555555555554
223,1,3,2,891550404,891550431,27,826,1291,2.125
223,3,1,-2,891550431,891550470,39,1291,1300,2.5
223,1,5,4,891550470,891550649,179,1300,22,4.215909090909091
223,5,5,0,891550649,891550711,62,22,173,4.1441441441441444
223,5,4,-1,891550711,891550767,56,173,470,3.72
223,4,4,0,891550767,891550845,78,470,143,3.56
223,4,5,1,891550845,891550889,44,143,69,3.8015873015873014
223,5,5,0,891550889,891550925,36,69,216,3.8454545454545452
223,5,5,0,891550925,891550952,27,216,155,3.0588235294117645
189,3,3,0,893263994,893264023,29,9,297,4.142857142857143
189,3,5,2,893264023,893264048,25,297,124,4.052631578947368
189,5,4,-1,893264048,893264150,102,124,253,3.5
189,4,4,0,893264150,893264174,24,253,248,3.746268656716418
189,4,4,0,893264174,893264248,74,248,24,3.3728813559322033
189,4,4,0,893264248,893264270,22,24,1115,3.3846153846153846
189,4,5,1,893264270,893264301,31,1115,1060,3.235294117647059
189,5,2,-3,893264301,893264335,34,1060,15,3.725663716814159
189,2,3,1,893264335,893264378,43,15,129,3.744186046511628
189,3,5,2,893264378,893264466,88,129,20,3.375
189,5,2,-3,893264466,893264487,21,20,405,3.25
189,2,4,2,893264487,893264595,108,405,459,3.875
189,4,2,-2,893264595,893264619,24,459,21,2.9210526315789473
189,2,4,2,893264619,893264703,84,21,225,3.0714285714285716
189,4,1,-3,893264703,893264735,32,225,118,3.2764227642276422
189,1,2,1,893264735,893264766,31,118,281,3.2
189,2,1,-1,893264766,893264782,16,281,820,3.0444444444444443
189,1,2,1,893264782,893264816,34,820,121,3.521212121212121
189,2,3,1,893264816,893264849,33,121,990,2.769230769230769
189,3,2,-1,893264849,893264865,16,990,105,2.6176470588235294
189,2,1,-1,893264865,893264954,89,105,120,2.3421052631578947
189,1,4,3,893264954,893265046,92,120,751,3.3896103896103895
189,4,4,0,893265046,893265071,25,751,268,3.9838709677419355
189,4,5,1,893265071,893265123,52,268,657,4.341463414634147
189,5,2,-3,893265123,893265160,37,657,618,3.5
189,2,3,1,893265160,893265191,31,618,59,4.0
189,3,4,1,893265191,893265214,23,59,176,3.967032967032967
189,4,5,1,893265214,893265238,24,176,474,4.172413793103448
189,5,5,0,893265238,893265239,1,474,505,4.0625
189,5,5,0,893265239,893265263,24,505,56,4.051724137931035
189,5,5,0,893265263,893265291,28,56,483,4.475609756097561
189,5,3,-2,893265291,893265327,36,483,531,3.7435897435897436
189,3,4,1,893265327,893265349,22,531,511,4.096153846153846
189,4,5,1,893265349,893265401,52,511,234,3.7674418604651163
189,5,5,0,893265401,893265428,27,234,194,4.029411764705882
189,5,5,0,893265428,893265452,24,194,489,4.076923076923077
189,5,5,0,893265452,893265478,26,489,179,3.8823529411764706
189,5,4,-1,893265478,893265535,57,179,135,3.7974683544303796
189,4,4,0,893265535,893265568,33,135,656,3.75
189,4,4,0,893265568,893265569,1,656,661,4.133333333333334
189,4,4,0,893265569,893265624,55,661,83,4.204081632653061
189,4,4,0,893265624,893265657,33,83,198,4.04
189,4,5,1,893265657,893265683,26,198,172,4.225225225225225
189,5,3,-2,893265683,893265684,1,172,91,3.6
189,3,4,1,893265684,893265710,26,91,485,3.717948717948718
189,4,5,1,893265710,893265741,31,485,792,3.793103448275862
189,5,5,0,893265741,893265773,32,792,133,3.7777777777777777
189,5,4,-1,893265773,893265796,23,133,659,4.027777777777778
189,4,3,-1,893265796,893265826,30,659,61,4.190476190476191
189,3,4,1,893265826,893265865,39,61,513,4.526315789473684
189,4,3,-1,893265865,893265947,82,513,241,3.5625
189,3,5,2,893265947,893265971,24,241,96,3.9130434782608696
189,5,5,0,893265971,893265998,27,96,582,3.7457627118644066
189,5,3,-2,893265998,893266027,29,582,31,3.642857142857143
189,3,4,1,893266027,893266051,24,31,1402,4.0
189,4,5,1,893266051,893266074,23,1402,1099,3.7142857142857144
189,5,4,-1,893266074,893266137,63,1099,378,3.6904761904761907
189,4,4,0,893266137,893266161,24,378,863,3.727272727272727
189,4,5,1,893266161,893266204,43,863,196,3.9404761904761907
189,5,4,-1,893266204,893266205,1,196,526,3.909090909090909
189,4,3,-1,893266205,893266230,25,526,162,3.4651162790697674
189,3,5,2,893266230,893266251,21,162,1021,3.8666666666666667
189,5,5,0,893266251,893266325,74,1021,1404,3.875
189,5,5,0,893266325,893266326,1,1404,510,3.823529411764706
189,5,4,-1,893266326,893266376,50,510,44,3.1333333333333333
189,4,4,0,893266376,893277579,11203,44,97,3.7282608695652173
189,4,4,0,893277579,893277702,123,97,150,3.803921568627451
243,4,4,0,879986951,879987045,94,268,127,4.162790697674419
243,4,3,-1,879987045,879987084,39,127,275,4.087912087912088
243,3,4,1,879987084,879987085,1,275,246,4.0
243,4,1,-3,879987085,879987148,63,246,280,3.103448275862069
243,1,2,1,879987148,879987173,25,280,93,3.5641025641025643
243,2,4,2,879987173,879987239,66,93,1,3.902439024390244
243,4,4,0,879987239,879987362,123,1,13,3.5454545454545454
243,4,3,-1,879987362,879987397,35,13,151,3.6544117647058822
243,3,3,0,879987397,879987440,43,151,15,3.725663716814159
243,3,3,0,879987440,879987465,25,15,1115,3.3846153846153846
243,3,4,1,879987465,879987526,61,1115,10,3.85
243,4,3,-1,879987526,879987630,104,10,16,3.411764705882353
243,3,3,0,879987630,879987655,25,16,225,3.0714285714285716
243,3,4,1,879987655,879987736,81,225,477,3.1666666666666665
243,4,4,0,879987736,879987793,57,477,111,3.5106382978723403
243,4,3,-1,879987793,879987875,82,111,25,3.3185840707964602
243,3,2,-1,879987875,879987909,34,25,1368,3.0
243,2,3,1,879987909,879988046,137,1368,215,3.662921348314607
243,3,4,1,879988046,879988071,25,215,318,4.5046728971962615
243,4,3,-1,879988071,879988132,61,318,461,3.3333333333333335
243,3,4,1,879988132,879988157,25,461,531,3.7435897435897436
243,4,4,0,879988157,879988184,27,531,1039,3.9583333333333335
243,4,4,0,879988184,879988215,31,1039,28,3.923076923076923
243,4,4,0,879988215,879988262,47,28,694,4.277777777777778
243,4,4,0,879988262,879988298,36,694,196,3.9404761904761907
243,4,4,0,879988298,879988337,39,196,1197,3.625
243,4,4,0,879988337,879988369,32,1197,509,3.7058823529411766
243,4,4,0,879988369,879988422,53,509,660,3.71875
243,4,4,0,879988422,879988459,37,660,162,3.4651162790697674
243,4,5,1,879988459,879988487,28,162,632,3.9523809523809526
243,5,3,-2,879988487,879988520,33,632,708,3.3157894736842106
243,3,4,1,879988520,879988557,37,708,732,3.6266666666666665
243,4,3,-1,879988557,879988587,30,732,77,3.3857142857142857
243,3,4,1,879988587,879988663,76,77,778,3.5925925925925926
243,4,3,-1,879988663,879988723,60,778,1148,3.0
243,3,4,1,879988723,879988830,107,1148,306,4.033333333333333
243,4,4,0,879988830,879988913,83,306,435,3.8933333333333335
243,4,4,0,879988913,879989006,93,435,514,4.033333333333333
243,4,4,0,879989006,879989134,128,514,208,3.8125
92,4,4,0,875639823,875640189,366,628,411,2.911764705882353
92,4,4,0,875640189,875640214,25,411,273,3.5238095238095237
92,4,2,-2,875640214,875640273,59,273,257,3.7154471544715446
92,2,4,2,875640273,875640318,45,257,237,3.7315436241610738
92,4,4,0,875640318,875640385,67,237,471,3.5714285714285716
92,4,4,0,875640385,875640487,102,471,619,3.4782608695652173
92,4,2,-2,875640487,875640512,25,619,546,2.9789473684210526
92,2,2,0,875640512,875640542,30,546,147,3.3142857142857145
92,2,2,0,875640542,875640582,40,147,1016,3.559322033898305
92,2,3,1,875640582,875640583,1,1016,410,3.0434782608695654
92,3,3,0,875640583,875640609,26,410,106,2.8125
92,3,3,0,875640609,875640740,131,106,225,3.0714285714285716
92,3,4,1,875640740,875640800,60,225,515,4.202898550724638
92,4,2,-2,875640800,875641428,628,515,678,2.8181818181818183
92,2,5,3,875641428,875641516,88,678,582,3.7457627118644066
92,5,1,-4,875641516,875644796,3280,582,820,3.0444444444444443
92,1,5,4,875644796,875652981,8185,820,195,3.9072164948453607
92,5,5,0,875652981,875653016,35,195,180,3.9473684210526314
92,5,3,-2,875653016,875653050,34,180,28,3.923076923076923
92,3,5,2,875653050,875653077,27,28,179,3.8823529411764706
92,5,4,-1,875653077,875653121,44,179,531,3.7435897435897436
92,4,4,0,875653121,875653162,41,531,707,3.909090909090909
92,4,5,1,875653162,875653198,36,707,69,3.8015873015873014
92,5,5,0,875653198,875653242,44,69,789,3.7777777777777777
92,5,5,0,875653242,875653271,29,789,1073,3.6315789473684212
92,5,3,-2,875653271,875653363,92,1073,32,3.7222222222222223
92,3,4,1,875653363,875653519,156,32,189,3.88
92,4,4,0,875653519,875653549,30,189,175,3.8354430379746836
92,4,3,-1,875653549,875653664,115,175,95,3.8194444444444446
92,3,2,-1,875653664,875653665,1,95,501,3.289473684210526
92,2,3,1,875653665,875653699,34,501,2,3.0851063829787235
92,3,4,1,875653699,875653723,24,2,168,4.0476190476190474
92,4,4,0,875653723,875653769,46,168,731,3.4
92,4,4,0,875653769,875653836,67,731,182,3.842857142857143
92,4,3,-1,875653836,875653867,31,182,216,3.8454545454545452
92,3,4,1,875653867,875653913,46,216,204,3.6744186046511627
92,4,4,0,875653913,875653914,1,204,663,3.948717948717949
92,4,4,0,875653914,875653960,46,663,183,3.951219512195122
92,4,4,0,875653960,875653988,28,183,157,3.5714285714285716
92,4,4,0,875653988,875654125,137,157,660,3.71875
92,4,3,-1,875654125,875654159,34,660,627,3.3823529411764706
92,3,5,2,875654159,875654189,30,627,174,4.253521126760563
92,5,4,-1,875654189,875654222,33,174,193,3.883720930232558
92,4,3,-1,875654222,875654245,23,193,55,4.051282051282051
92,3,4,1,875654245,875654297,52,55,234,3.7674418604651163
92,4,3,-1,875654297,875654353,56,234,658,3.393939393939394
92,3,4,1,875654353,875654432,79,658,1194,4.181818181818182
92,4,4,0,875654432,875654533,101,1194,655,3.7857142857142856
92,4,4,0,875654533,875654534,1,655,421,3.462962962962963
92,4,3,-1,875654534,875654637,103,421,77,3.3857142857142857
92,3,5,2,875654637,875654665,28,77,433,3.8035714285714284
92,5,4,-1,875654665,875654732,67,433,47,3.5869565217391304
92,4,3,-1,875654732,875654733,1,47,396,2.84
92,3,3,0,875654733,875654798,65,396,794,3.6
92,3,2,-1,875654798,875654929,131,794,145,2.3636363636363638
92,2,3,1,875654929,875655990,1061,145,423,3.7016129032258065
92,3,4,1,875655990,875656025,35,423,96,3.9130434782608696
92,4,3,-1,875656025,875656054,29,96,702,2.764705882352941
92,3,4,1,875656054,875656086,32,702,212,3.230769230769231
92,4,3,-1,875656086,875656121,35,212,735,3.58
92,3,4,1,875656121,875656164,43,735,747,3.5526315789473686
92,4,3,-1,875656164,875656201,37,747,229,3.185185185185185
92,3,4,1,875656201,875656288,87,229,715,3.257142857142857
92,4,4,0,875656288,875656317,29,715,382,3.764705882352941
92,4,3,-1,875656317,875656349,32,382,88,3.433734939759036
92,3,3,0,875656349,875656392,43,88,53,2.9523809523809526
92,3,3,0,875656392,875656419,27,53,39,3.107142857142857
92,3,3,0,875656419,875656474,55,39,73,3.588235294117647
92,3,3,0,875656474,875656502,28,73,684,3.847826086956522
92,3,3,0,875656502,875656624,122,684,29,2.5714285714285716
92,3,4,1,875656624,875657620,996,29,265,3.710144927536232
92,4,3,-1,875657620,875657640,20,265,38,2.784313725490196
92,3,4,1,875657640,875657681,41,38,528,4.241379310344827
92,4,3,-1,875657681,875658159,478,528,72,3.175438596491228
92,3,4,1,875658159,875658312,153,72,955,3.2666666666666666
92,4,3,-1,875658312,875660083,1771,955,451,3.207792207792208
92,3,3,0,875660083,875660164,81,451,91,3.6
92,3,3,0,875660164,875660304,140,91,785,3.4375
92,3,3,0,875660304,875660408,104,785,587,3.4
92,3,3,0,875660408,875660468,60,587,62,3.048780487804878
92,3,3,0,875660468,875660494,26,62,393,3.5125
92,3,4,1,875660494,875810543,150049,393,159,3.3902439024390243
92,4,4,0,875810543,875810741,198,159,144,3.9545454545454546
92,4,4,0,875810741,875811549,808,144,466,3.5
92,4,3,-1,875811549,875811628,79,466,199,4.191489361702128
92,3,3,0,875811628,875811717,89,199,200,3.8157894736842106
92,3,3,0,875811717,875812121,404,200,704,3.125
92,3,3,0,875812121,875812211,90,704,132,3.929411764705882
92,3,4,1,875812211,875812305,94,132,51,3.5277777777777777
92,4,3,-1,875812305,875812331,26,51,281,3.2
92,3,3,0,875812331,875812364,33,281,85,3.3157894736842106
92,3,3,0,875812364,875812413,49,85,561,3.1515151515151514
92,3,2,-1,875812413,875812435,22,561,1157,3.142857142857143
92,2,3,1,875812435,875812511,76,1157,449,2.9069767441860463
92,3,3,0,875812511,875812841,330,449,732,3.6266666666666665
92,3,3,0,875812841,875812876,35,732,94,2.8823529411764706
92,3,4,1,875812876,875812898,22,94,425,3.7027027027027026
92,4,3,-1,875812898,875813022,124,425,720,3.2
92,3,2,-1,875813022,875813171,149,720,576,3.125
92,2,3,1,875813171,875813224,53,576,620,3.0
92,3,2,-1,875813224,875813376,152,620,102,3.3684210526315788
92,2,4,2,875813376,875813412,36,102,521,3.787878787878788
92,4,3,-1,875813412,875906802,93390,521,800,3.2222222222222223
92,3,2,-1,875906802,875906828,26,800,452,2.6129032258064515
92,2,1,-1,875906828,875906882,54,452,453,2.0
92,1,3,2,875906882,875906989,107,453,44,3.1333333333333333
92,3,3,0,875906989,875907078,89,44,552,2.8095238095238093
92,3,3,0,875907078,875907079,1,552,1042,3.625
92,3,3,0,875907079,875907134,55,1042,583,3.4285714285714284
92,3,3,0,875907134,875907179,45,583,1207,2.125
92,3,2,-1,875907179,875907180,1,1207,554,2.9555555555555557
92,2,3,1,875907180,875907366,186,554,376,2.9166666666666665
92,3,3,0,875907366,875907416,50,376,49,3.3
92,3,3,0,875907416,875907436,20,49,67,3.106382978723404
92,3,2,-1,875907436,875907504,68,67,80,2.967741935483871
92,2,3,1,875907504,875907535,31,80,122,2.282608695652174
92,3,3,0,875907535,875907574,39,122,728,3.05
92,3,3,0,875907574,875907618,44,728,790,2.8518518518518516
92,3,2,-1,875907618,875907649,31,790,998,2.7777777777777777
92,2,3,1,875907649,875907675,26,998,1041,3.3333333333333335
92,3,3,0,875907675,875907702,27,1041,364,2.8095238095238093
92,3,3,0,875907702,875907727,25,364,725,3.0
92,3,2,-1,875907727,876174925,267198,725,1214,1.8
92,2,4,2,876174925,876175052,127,1214,181,3.98974358974359
92,4,1,-3,876175052,876175191,139,181,383,2.5
92,1,3,2,876175191,876175626,435,383,1212,3.0
92,3,3,0,876175626,876175640,14,1212,278,3.0357142857142856
92,3,3,0,876175640,876175658,18,278,1040,2.2666666666666666
92,3,4,1,876175658,876175754,96,1040,7,3.76056338028169
92,4,2,-2,876175754,876769302,593548,7,455,3.1702127659574466
92,2,4,2,876769302,876769303,1,455,282,3.610526315789474
92,4,4,0,876769303,886440557,9671254,282,222,3.578125
92,4,4,0,886440557,886442422,1865,222,1142,4.0476190476190474
92,4,4,0,886442422,886442565,143,1142,248,3.746268656716418
92,4,4,0,886442565,886443231,666,248,1012,3.2916666666666665
92,4,4,0,886443231,886443277,46,1012,291,3.2
92,4,2,-2,886443277,886443328,51,291,597,3.2771084337349397
92,2,3,1,886443328,886443351,23,597,109,3.282608695652174
92,3,2,-1,886443351,886443416,65,109,108,3.107142857142857
92,2,3,1,886443416,886443455,39,108,1079,2.1923076923076925
92,3,3,0,886443455,886443471,16,1079,1011,3.1
92,3,3,0,886443471,886443494,23,1011,149,2.4
92,3,3,0,886443494,886443582,88,149,928,3.142857142857143
92,3,2,-1,886443582,886443626,44,928,974,3.125
92,2,3,1,886443626,886443672,46,974,369,2.5714285714285716
92,3,2,-1,886443672,886443708,36,369,831,2.6097560975609757
92,2,2,0,886443708,888469687,2025979,831,984,2.6666666666666665
92,2,3,1,888469687,890251484,1781797,984,1014,3.1
92,3,4,1,890251484,890251534,50,1014,250,3.4698795180722892
92,4,2,-2,890251534,890251592,58,250,1033,3.0
92,2,3,1,890251592,890251700,108,1033,322,3.0476190476190474
92,3,2,-1,890251700,890251716,16,322,986,2.5555555555555554
92,2,2,0,890251716,890251747,31,986,1215,2.0714285714285716
92,2,3,1,890251747,890251791,44,1215,409,2.9615384615384617
92,3,2,-1,890251791,890251826,35,409,743,1.9545454545454546
92,2,2,0,890251826,890251841,15,743,1052,2.4545454545454546
92,2,2,0,890251841,892655775,2403934,1052,1023,2.5714285714285716
92,2,3,1,892655775,892655791,16,1023,748,3.1043478260869564
241,5,4,-1,887249576,887249685,109,750,887,3.5789473684210527
241,4,2,-2,887249685,887249745,60,887,682,3.0476190476190474
241,2,4,2,887249745,887249795,50,682,307,3.6031746031746033
241,4,3,-1,887249795,887249841,46,307,332,3.6511627906976742
241,3,2,-1,887249841,887249889,48,332,350,3.2
241,2,3,1,887249889,887250026,137,350,270,3.7804878048780486
241,3,4,1,887250026,887250084,58,270,292,3.6666666666666665
241,4,3,-1,887250084,887250085,1,292,335,2.5
254,2,3,1,886470859,886470904,45,259,892,2.9615384615384617
254,3,2,-1,886470904,886470931,27,892,457,1.7
254,2,3,1,886470931,886471307,376,457,15,3.725663716814159
254,3,3,0,886471307,886471695,388,15,265,3.710144927536232
254,3,5,2,886471695,886471880,185,265,135,3.7974683544303796
254,5,3,-2,886471880,886471959,79,135,612,4.0
254,3,4,1,886471959,886471982,23,612,496,4.094594594594595
254,4,4,0,886471982,886472022,40,496,132,3.929411764705882
254,4,3,-1,886472022,886472023,1,132,186,3.905263157894737
254,3,5,2,886472023,886472051,28,186,172,4.225225225225225
254,5,4,-1,886472051,886472089,38,172,199,4.191489361702128
254,4,3,-1,886472089,886472139,50,199,967,3.3333333333333335
254,3,5,2,886472139,886472172,33,967,210,3.921259842519685
254,5,4,-1,886472172,886472201,29,210,98,4.240875912408759
254,4,4,0,886472201,886472231,30,98,419,3.8208955223880596
254,4,2,-2,886472231,886472291,60,419,610,3.1818181818181817
254,2,2,0,886472291,886472337,46,610,629,3.3333333333333335
254,2,4,2,886472337,886472369,32,629,28,3.923076923076923
254,4,1,-3,886472369,886472400,31,28,168,4.0476190476190474
254,1,4,3,886472400,886472434,34,168,204,3.6744186046511627
254,4,3,-1,886472434,886472466,32,204,1060,3.235294117647059
254,3,3,0,886472466,886472504,38,1060,200,3.8157894736842106
254,3,4,1,886472504,886472609,105,200,228,3.7246376811594204
254,4,3,-1,886472609,886472643,34,228,162,3.4651162790697674
254,3,4,1,886472643,886472713,70,162,416,3.3846153846153846
254,4,4,0,886472713,886472767,54,416,82,3.6741573033707864
254,4,4,0,886472767,886472768,1,82,164,3.6140350877192984
254,4,3,-1,886472768,886472836,68,164,141,3.4827586206896552
254,3,3,0,886472836,886473120,284,141,699,3.736842105263158
254,3,2,-1,886473120,886473158,38,699,432,3.719298245614035
254,2,4,2,886473158,886473190,32,432,241,3.5625
254,4,2,-2,886473190,886473254,64,241,624,3.0
254,2,3,1,886473254,886473283,29,624,584,3.5238095238095237
254,3,3,0,886473283,886473408,125,584,417,3.0588235294117645
254,3,3,0,886473408,886473448,40,417,1116,3.5714285714285716
254,3,3,0,886473448,886473547,99,1116,443,3.8421052631578947
254,3,2,-1,886473547,886473631,84,443,112,2.7
254,2,3,1,886473631,886473672,41,112,188,3.625
254,3,3,0,886473672,886473701,29,188,588,3.8358208955223883
254,3,1,-2,886473701,886473736,35,588,616,3.1052631578947367
254,1,3,2,886473736,886473775,39,616,448,3.466666666666667
254,3,3,0,886473775,886473808,33,448,625,3.25
254,3,4,1,886473808,886473852,44,625,596,3.180327868852459
254,4,3,-1,886473852,886474009,157,596,62,3.048780487804878
254,3,1,-2,886474009,886474122,113,62,138,2.6
254,1,2,1,886474122,886474216,94,138,436,3.5
254,2,1,-1,886474216,886474426,210,436,1263,3.1666666666666665
254,1,3,2,886474426,886474456,30,1263,472,2.984375
254,3,3,0,886474456,886474489,33,472,142,3.1481481481481484
254,3,3,0,886474489,886474518,29,142,21,2.9210526315789473
254,3,4,1,886474518,886474580,62,21,229,3.185185185185185
254,4,1,-3,886474580,886474650,70,229,379,3.35
254,1,2,1,886474650,886474807,157,379,843,2.933333333333333
254,2,2,0,886474807,886474847,40,843,29,2.5714285714285716
254,2,3,1,886474847,886475034,187,29,1033,3.0
254,3,2,-1,886475034,886475319,285,1033,548,2.0
254,2,4,2,886475319,886475406,87,548,118,3.2764227642276422
254,4,3,-1,886475406,886475446,40,118,561,3.1515151515151514
254,3,2,-1,886475446,886475476,30,561,573,2.909090909090909
254,2,3,1,886475476,886475523,47,573,415,2.6666666666666665
254,3,3,0,886475523,886475558,35,415,1444,2.3333333333333335
254,3,2,-1,886475558,886475616,58,1444,386,2.769230769230769
254,2,2,0,886475616,886475755,139,386,35,1.75
254,2,3,1,886475755,886475790,35,35,400,2.375
254,3,3,0,886475790,886475831,41,400,441,2.4
254,3,3,0,886475831,886475952,121,441,225,3.0714285714285716
254,3,1,-2,886475952,886475980,28,225,219,2.735294117647059
254,1,2,1,886475980,886476123,143,219,103,2.2
254,2,3,1,886476123,886476165,42,103,575,2.619047619047619
254,3,2,-1,886476165,887346935,870770,575,269,4.085106382978723
254,2,5,3,887346935,887346963,28,269,97,3.7282608695652173
254,5,4,-1,887346963,887347382,419,97,1443,4.5
254,4,4,0,887347382,887347560,178,1443,258,3.7547169811320753
293,3,4,1,888904180,888904220,40,751,303,3.75
293,4,3,-1,888904220,888904265,45,303,286,3.442857142857143
293,3,2,-1,888904265,888904285,20,286,328,3.4895833333333335
293,2,2,0,888904285,888904327,42,328,748,3.1043478260869564
293,2,2,0,888904327,888904353,26,748,347,3.59375
293,2,2,0,888904353,888904410,57,347,294,3.1052631578947367
293,2,2,0,888904410,888904439,29,294,678,2.8181818181818183
293,2,2,0,888904439,888904456,17,678,322,3.0476190476190474
293,2,5,3,888904456,888904632,176,322,285,4.181818181818182
293,5,3,-2,888904632,888904696,64,285,25,3.3185840707964602
293,3,4,1,888904696,888904734,38,25,100,4.0162162162162165
293,4,3,-1,888904734,888904777,43,100,15,3.725663716814159
293,3,4,1,888904777,888904795,18,15,298,3.779220779220779
293,4,2,-2,888904795,888904814,19,298,924,3.3703703703703702
293,2,3,1,888904814,888904838,24,924,150,3.803921568627451
293,3,2,-1,888904838,888904861,23,150,1,3.902439024390244
293,2,3,1,888904861,888904862,1,1,1017,3.0
293,3,3,0,888904862,888904884,22,1017,471,3.5714285714285716
293,3,4,1,888904884,888904901,17,471,273,3.5238095238095237
293,4,4,0,888904901,888904927,26,273,151,3.6544117647058822
293,4,3,-1,888904927,888905004,77,151,628,3.573529411764706
293,3,3,0,888905004,888905005,1,628,460,3.0
293,3,2,-1,888905005,888905034,29,460,410,3.0434782608695654
293,2,2,0,888905034,888905062,28,410,111,3.5106382978723403
293,2,2,0,888905062,888905086,24,111,240,3.0350877192982457
293,2,2,0,888905086,888905122,36,240,284,3.1547619047619047
293,2,2,0,888905122,888905170,48,284,282,3.610526315789474
293,2,3,1,888905170,888905252,82,282,824,2.590909090909091
293,3,3,0,888905252,888905286,34,824,831,2.6097560975609757
293,3,2,-1,888905286,888905306,20,831,820,3.0444444444444443
293,2,3,1,888905306,888905322,16,820,866,3.3962264150943398
293,3,2,-1,888905322,888905377,55,866,291,3.2
293,2,2,0,888905377,888905399,22,291,933,2.5
293,2,3,1,888905399,888905416,17,933,1132,2.588235294117647
293,3,2,-1,888905416,888905519,103,1132,461,3.3333333333333335
293,2,3,1,888905519,888905520,1,461,166,4.0
293,3,5,2,888905520,888905582,62,166,199,4.191489361702128
293,5,5,0,888905582,888905618,36,199,172,4.225225225225225
293,5,4,-1,888905618,888905642,24,172,531,3.7435897435897436
293,4,3,-1,888905642,888905665,23,531,210,3.921259842519685
293,3,5,2,888905665,888905685,20,210,474,4.172413793103448
293,5,3,-2,888905685,888905716,31,474,430,4.136363636363637
293,3,5,2,888905716,888905819,103,430,48,4.055555555555555
293,5,5,0,888905819,888905840,21,48,496,4.094594594594595
293,5,4,-1,888905840,888905865,25,496,23,3.9047619047619047
293,4,5,1,888905865,888905898,33,23,603,4.315789473684211
293,5,5,0,888905898,888905923,25,603,174,4.253521126760563
293,5,3,-2,888905923,888905948,25,174,485,3.717948717948718
293,3,3,0,888905948,888905991,43,485,165,3.9130434782608696
293,3,3,0,888905991,888906012,21,165,204,3.6744186046511627
293,3,3,0,888906012,888906045,33,204,1298,3.0
293,3,3,0,888906045,888906070,25,1298,423,3.7016129032258065
293,3,3,0,888906070,888906071,1,423,28,3.923076923076923
293,3,5,2,888906071,888906096,25,28,492,4.117647058823529
293,5,3,-2,888906096,888906119,23,492,195,3.9072164948453607
293,3,4,1,888906119,888906143,24,195,198,4.04
293,4,4,0,888906143,888906193,50,198,177,3.875
293,4,5,1,888906193,888906217,24,177,484,4.116279069767442
293,5,3,-2,888906217,888906244,27,484,646,3.9285714285714284
293,3,4,1,888906244,888906263,19,646,467,4.071428571428571
293,4,2,-2,888906263,888906288,25,467,367,3.4242424242424243
293,2,4,2,888906288,888906315,27,367,445,3.727272727272727
293,4,5,1,888906315,888906338,23,445,705,3.7857142857142856
293,5,4,-1,888906338,888906378,40,705,514,4.033333333333333
293,4,4,0,888906378,888906464,86,514,238,3.888888888888889
293,4,4,0,888906464,888906490,26,238,528,4.241379310344827
293,4,5,1,888906490,888906516,26,528,432,3.719298245614035
293,5,4,-1,888906516,888906536,20,432,176,3.967032967032967
293,4,4,0,888906536,888906576,40,176,636,3.4146341463414633
293,4,4,0,888906576,888906598,22,636,164,3.6140350877192984
293,4,1,-3,888906598,888906655,57,164,1119,3.5185185185185186
293,1,3,2,888906655,888906699,44,1119,419,3.8208955223880596
293,3,3,0,888906699,888906726,27,419,956,3.5714285714285716
293,3,3,0,888906726,888906748,22,956,588,3.8358208955223883
293,3,1,-2,888906748,888906781,33,588,550,3.272727272727273
293,1,3,2,888906781,888906804,23,550,642,3.4285714285714284
293,3,4,1,888906804,888906844,40,642,1286,3.5714285714285716
293,4,3,-1,888906844,888906869,25,1286,403,3.298507462686567
293,3,1,-2,888906869,888906906,37,403,226,3.378787878787879
293,1,3,2,888906906,888906927,21,226,464,3.8
293,3,3,0,888906927,888906945,18,464,65,3.511111111111111
293,3,3,0,888906945,888906966,21,65,1267,2.909090909090909
293,3,3,0,888906966,888906990,24,1267,436,3.5
293,3,1,-2,888906990,888907015,25,436,148,3.2131147540983607
293,1,4,3,888907015,888907036,21,148,160,3.4
293,4,3,-1,888907036,888907061,25,160,724,3.64
293,3,4,1,888907061,888907081,20,724,1147,3.4
293,4,3,-1,888907081,888907101,20,1147,2,3.0851063829787235
293,3,4,1,888907101,888907122,21,2,404,3.6578947368421053
293,4,3,-1,888907122,888907166,44,404,549,3.4871794871794872
293,3,3,0,888907166,888907186,20,549,637,2.888888888888889
293,3,3,0,888907186,888907245,59,637,451,3.207792207792208
293,3,3,0,888907245,888907266,21,451,88,3.433734939759036
293,3,4,1,888907266,888907290,24,88,163,3.53125
293,4,1,-3,888907290,888907291,1,163,426,3.1
293,1,3,2,888907291,888907312,21,426,49,3.3
293,3,2,-1,888907312,888907335,23,49,17,3.032258064516129
293,2,4,2,888907335,888907356,21,17,420,3.5652173913043477
293,4,2,-2,888907356,888907384,28,420,230,3.3518518518518516
293,2,2,0,888907384,888907433,49,230,660,3.71875
293,2,3,1,888907433,888907453,20,660,553,3.5
293,3,1,-2,888907453,888907499,46,553,29,2.5714285714285716
293,1,3,2,888907499,888907527,28,29,708,3.3157894736842106
293,3,4,1,888907527,888907575,48,708,416,3.3846153846153846
293,4,3,-1,888907575,888907603,28,416,1311,2.125
293,3,1,-2,888907603,888907624,21,1311,62,3.048780487804878
293,1,2,1,888907624,888907674,50,62,1041,3.3333333333333335
293,2,2,0,888907674,888907702,28,1041,402,3.3076923076923075
293,2,3,1,888907702,888907753,51,402,616,3.1052631578947367
293,3,1,-2,888907753,888907794,41,616,554,2.9555555555555557
293,1,1,0,888907794,888907816,22,554,804,3.0
293,1,3,2,888907816,888907836,20,804,765,3.0
293,3,3,0,888907836,888907891,55,765,53,2.9523809523809526
293,3,1,-2,888907891,888907913,22,53,1217,3.4166666666666665
293,1,3,2,888907913,888907955,42,1217,356,3.2
293,3,2,-1,888907955,888907981,26,356,761,3.0588235294117645
293,2,1,-1,888907981,888908041,60,761,36,2.4
293,1,2,1,888908041,888908065,24,36,386,2.769230769230769
293,2,1,-1,888908065,888908066,1,386,779,2.2
293,1,2,1,888908066,888908117,51,779,1044,3.2777777777777777
127,1,1,0,884363851,884363990,139,750,268,3.9838709677419355
127,1,5,4,884363990,884364017,27,268,300,3.6861313868613137
127,5,5,0,884364017,884364108,91,300,748,3.1043478260869564
127,5,5,0,884364108,884364151,43,748,343,3.0
127,5,4,-1,884364151,884364866,715,343,50,4.306532663316583
222,5,3,-2,877562772,877562795,23,328,294,3.1052631578947367
222,3,4,1,877562795,877562819,24,294,326,3.262295081967213
222,4,3,-1,877562819,877562839,20,326,323,3.0
222,3,3,0,877562839,877562973,134,323,678,2.8181818181818183
222,3,5,2,877562973,877563052,79,678,100,4.0162162162162165
222,5,4,-1,877563052,877563168,116,100,181,3.98974358974359
222,4,4,0,877563168,877563194,26,181,50,4.306532663316583
222,4,2,-2,877563194,877563326,132,50,410,3.0434782608695654
222,2,3,1,877563326,877563462,136,410,284,3.1547619047619047
222,3,5,2,877563462,877563485,23,284,628,3.573529411764706
222,5,4,-1,877563485,877563506,21,628,248,3.746268656716418
222,4,3,-1,877563506,877563530,24,248,762,3.3962264150943398
222,3,5,2,877563530,877563550,20,762,276,3.6036036036036037
222,5,3,-2,877563550,877563570,20,276,405,3.25
222,3,5,2,877563570,877563597,27,405,742,3.5555555555555554
222,5,1,-4,877563597,877563622,25,742,473,2.9166666666666665
222,1,1,0,877563622,877563659,37,473,1089,2.1363636363636362
222,1,4,3,877563659,877563694,35,1089,147,3.3142857142857145
222,4,2,-2,877563694,877563758,64,147,934,3.0294117647058822
222,2,2,0,877563758,877563801,43,934,250,3.4698795180722892
222,2,4,2,877563801,877563802,1,250,118,3.2764227642276422
222,4,3,-1,877563802,877563820,18,118,111,3.5106382978723403
222,3,2,-1,877563820,877563852,32,111,363,3.0
222,2,3,1,877563852,877563873,21,363,620,3.0
222,3,2,-1,877563873,877563913,40,620,278,3.0357142857142856
222,2,4,2,877563913,877563953,40,278,619,3.4782608695652173
222,4,2,-2,877563953,877563998,45,619,472,2.984375
222,2,2,0,877563998,877564031,33,472,1291,2.125
222,2,1,-1,877564031,877564050,19,1291,412,2.272727272727273
222,1,1,0,877564050,878181287,617237,412,457,1.7
222,1,1,0,878181287,878181351,64,457,426,3.1
222,1,4,3,878181351,878181387,36,426,98,4.240875912408759
222,4,3,-1,878181387,878181421,34,98,642,3.4285714285714284
222,3,3,0,878181421,878181457,36,642,159,3.3902439024390243
222,3,4,1,878181457,878181534,77,159,806,3.6666666666666665
222,4,2,-2,878181534,878181563,29,806,367,3.4242424242424243
222,2,3,1,878181563,878181592,29,367,770,3.25
222,3,4,1,878181592,878181616,24,770,168,4.0476190476190474
222,4,2,-2,878181616,878181647,31,168,90,3.0
222,2,5,3,878181647,878181673,26,90,238,3.888888888888889
222,5,5,0,878181673,878181739,66,238,89,3.9615384615384617
222,5,4,-1,878181739,878181768,29,89,164,3.6140350877192984
222,4,3,-1,878181768,878181804,36,164,180,3.9473684210526314
222,3,2,-1,878181804,878181829,25,180,132,3.929411764705882
222,2,2,0,878181829,878181906,77,132,191,4.168674698795181
222,2,4,2,878181906,878181976,70,191,157,3.5714285714285716
222,4,2,-2,878181976,878182005,29,157,231,2.938775510204082
222,2,4,2,878182005,878182058,53,231,230,3.3518518518518516
222,4,3,-1,878182058,878182109,51,230,151,3.6544117647058822
222,3,4,1,878182109,878182132,23,151,195,3.9072164948453607
222,4,1,-3,878182132,878182154,22,195,160,3.4
222,1,4,3,878182154,878182210,56,160,655,3.7857142857142856
222,4,3,-1,878182210,878182211,1,655,939,3.6333333333333333
222,3,2,-1,878182211,878182237,26,939,946,3.1153846153846154
222,2,3,1,878182237,878182337,100,946,869,3.0
222,3,5,2,878182337,878182338,1,869,69,3.8015873015873014
222,5,4,-1,878182338,878182416,78,69,153,3.7865168539325844
222,4,3,-1,878182416,878182479,63,153,58,3.543859649122807
222,3,3,0,878182479,878182632,153,58,92,3.7142857142857144
222,3,4,1,878182632,878182686,54,92,399,3.317073170731707
222,4,1,-3,878182686,878182880,194,399,375,2.076923076923077
222,1,2,1,878182880,878183043,163,375,102,3.3684210526315788
222,2,5,3,878183043,878183079,36,102,172,4.225225225225225
222,5,5,0,878183079,878183110,31,172,196,3.9404761904761907
222,5,4,-1,878183110,878183111,1,196,54,3.3714285714285714
222,4,5,1,878183111,878183136,25,54,64,4.373737373737374
222,5,5,0,878183136,878183137,1,64,746,3.7560975609756095
222,5,1,-4,878183137,878183218,81,746,1218,3.2
222,1,2,1,878183218,878183264,46,1218,506,3.566666666666667
222,2,5,3,878183264,878183285,21,506,22,4.215909090909091
222,5,4,-1,878183285,878183311,26,22,72,3.175438596491228
222,4,4,0,878183311,878183336,25,72,88,3.433734939759036
222,4,4,0,878183336,878183425,89,88,732,3.6266666666666665
222,4,2,-2,878183425,878183449,24,732,1078,2.625
222,2,5,3,878183449,878183481,32,1078,568,3.5853658536585367
222,5,4,-1,878183481,878183539,58,568,101,3.4827586206896552
222,4,1,-3,878183539,878183565,26,101,81,3.2857142857142856
222,1,3,2,878183565,878183588,23,81,167,2.8181818181818183
222,3,4,1,878183588,878183616,28,167,77,3.3857142857142857
222,4,2,-2,878183616,878183713,97,77,637,2.888888888888889
222,2,3,1,878183713,878183747,34,637,154,3.6031746031746033
222,3,1,-2,878183747,878183777,30,154,672,2.7222222222222223
222,1,4,3,878183777,878183837,60,672,66,3.4705882352941178
222,4,2,-2,878183837,878183898,61,66,465,3.75
222,2,4,2,878183898,878183924,26,465,385,3.6129032258064515
222,4,3,-1,878183924,878183951,27,385,1439,3.0
222,3,1,-2,878183951,878183984,33,1439,1079,2.1923076923076925
222,1,4,3,878183984,878183985,1,1079,232,3.0789473684210527
222,4,1,-3,878183985,878184007,22,232,35,1.75
222,1,4,3,878184007,878184055,48,35,636,3.4146341463414633
222,4,5,1,878184055,878184087,32,636,735,3.58
222,5,4,-1,878184087,878184113,26,735,155,3.0588235294117645
222,4,3,-1,878184113,878184136,23,155,109,3.282608695652174
222,3,3,0,878184136,878184171,35,109,158,2.7027027027027026
222,3,5,2,878184171,878184195,24,158,186,3.905263157894737
222,5,4,-1,878184195,878184290,95,186,1220,2.9166666666666665
222,4,4,0,878184290,878184315,25,1220,729,3.3793103448275863
222,4,4,0,878184315,878184338,23,729,210,3.921259842519685
222,4,4,0,878184338,878184358,20,210,436,3.5
222,4,2,-2,878184358,878184392,34,436,1178,2.375
222,2,3,1,878184392,878184393,1,1178,188,3.625
222,3,4,1,878184393,878184422,29,188,1284,2.5454545454545454
222,4,2,-2,878184422,878184446,24,1284,810,2.9473684210526314
222,2,1,-1,878184446,878184514,68,810,452,2.6129032258064515
222,1,3,2,878184514,878184545,31,452,280,3.103448275862069
222,3,3,0,878184545,878184571,26,280,29,2.5714285714285716
222,3,2,-1,878184571,878184596,25,29,552,2.8095238095238093
222,2,3,1,878184596,878184623,27,552,550,3.272727272727273
222,3,3,0,878184623,878184697,74,550,1440,3.0
222,3,1,-2,878184697,878184719,22,1440,665,2.72972972972973
222,1,3,2,878184719,878184812,93,665,723,3.5384615384615383
222,3,3,0,878184812,878184833,21,723,722,2.9642857142857144
222,3,2,-1,878184833,878184866,33,722,569,2.4285714285714284
222,2,2,0,878184866,878184899,33,569,783,2.388888888888889
222,2,1,-1,878184899,878184947,48,783,1419,1.7142857142857142
222,1,2,1,878184947,878184973,26,1419,541,2.9473684210526314
222,2,3,1,878184973,878185014,41,541,451,3.207792207792208
222,3,4,1,878185014,878185044,30,451,402,3.3076923076923075
222,4,1,-3,878185044,878185068,24,402,790,2.8518518518518516
222,1,2,1,878185068,878185102,34,790,38,2.784313725490196
222,2,1,-1,878185102,878185137,35,38,577,1.7058823529411764
222,1,3,2,878185137,878715168,530031,577,580,3.625
222,3,3,0,878715168,878715192,24,580,944,2.75
222,3,1,-2,878715192,881058145,2342953,944,338,2.75
222,1,2,1,881058145,881059117,972,338,812,3.375
222,2,4,2,881059117,881059461,344,812,431,3.422222222222222
222,4,3,-1,881059461,881059677,216,431,781,3.4166666666666665
222,3,3,0,881059677,881059678,1,781,658,3.393939393939394
222,3,4,1,881059678,881059714,36,658,710,3.41025641025641
222,4,4,0,881059714,881059876,162,710,68,3.5714285714285716
222,4,3,-1,881059876,881059877,1,68,44,3.1333333333333333
222,3,2,-1,881059877,881059920,43,44,441,2.4
222,2,3,1,881059920,881060062,142,441,217,3.1538461538461537
222,3,2,-1,881060062,881060205,143,217,386,2.769230769230769
222,2,2,0,881060205,881060331,126,386,501,3.289473684210526
222,2,3,1,881060331,881060370,39,501,780,3.08
222,3,3,0,881060370,881060412,42,780,1045,3.2
222,3,2,-1,881060412,881060435,23,1045,554,2.9555555555555557
222,2,3,1,881060435,881060550,115,554,575,2.619047619047619
222,3,1,-2,881060550,881060578,28,575,719,2.6666666666666665
222,1,2,1,881060578,881060608,30,719,769,2.2222222222222223
222,2,1,-1,881060608,881060635,27,769,1250,1.6
222,1,3,2,881060635,881060659,24,1250,41,3.0625
222,3,3,0,881060659,881060735,76,41,1053,3.3846153846153846
222,3,2,-1,881060735,881060762,27,1053,1239,2.25
222,2,2,0,881060762,881060823,61,1239,571,2.5
222,2,2,0,881060823,881061164,341,571,148,3.2131147540983607
222,2,3,1,881061164,881061165,1,148,763,3.347826086956522
222,3,1,-2,881061165,881061213,48,763,929,2.8421052631578947
222,1,2,1,881061213,881061304,91,929,120,2.3421052631578947
222,2,1,-1,881061304,881061326,22,120,368,1.8823529411764706
222,1,4,3,881061326,881061370,44,368,1057,2.7142857142857144
222,4,4,0,881061370,883815252,2753882,1057,288,3.5214285714285714
222,4,4,0,883815252,883815361,109,288,895,3.142857142857143
222,4,2,-2,883815361,883815749,388,895,477,3.1666666666666665
222,2,1,-1,883815749,883815768,19,477,249,3.3275862068965516
222,1,3,2,883815768,883815804,36,249,255,3.2027027027027026
222,3,4,1,883815804,883815840,36,255,1226,3.5454545454545454
222,4,1,-3,883815840,883816150,310,1226,1059,2.764705882352941
222,1,2,1,883816150,883816184,34,1059,106,2.8125
222,2,1,-1,883816184,883816441,257,106,1054,2.5454545454545454
267,3,5,2,878970155,878970399,244,294,250,3.4698795180722892
267,5,5,0,878970399,878970427,28,250,100,4.0162162162162165
267,5,5,0,878970427,878970473,46,100,124,4.052631578947368
267,5,4,-1,878970473,878970503,30,124,240,3.0350877192982457
267,4,5,1,878970503,878970529,26,240,127,4.162790697674419
267,5,3,-2,878970529,878970578,49,127,235,3.106382978723404
267,3,3,0,878970578,878970621,43,235,742,3.5555555555555554
267,3,3,0,878970621,878970681,60,742,121,3.521212121212121
267,3,5,2,878970681,878970710,29,121,515,4.202898550724638
267,5,2,-3,878970710,878970785,75,515,926,2.7857142857142856
267,2,3,1,878970785,878970805,20,926,597,3.2771084337349397
267,3,3,0,878970805,878970877,72,597,546,2.9789473684210526
267,3,4,1,878970877,878970901,24,546,3,3.0625
267,4,4,0,878970901,878970926,25,3,840,3.090909090909091
267,4,4,0,878970926,878970953,27,840,824,2.590909090909091
267,4,3,-1,878970953,878970978,25,824,685,3.2666666666666666
267,3,3,0,878970978,878971143,165,685,1028,2.857142857142857
267,3,4,1,878971143,878971224,81,1028,108,3.107142857142857
267,4,3,-1,878971224,878971266,42,108,826,2.5555555555555554
267,3,4,1,878971266,878971438,172,826,480,4.283018867924528
267,4,4,0,878971438,878971514,76,480,92,3.7142857142857144
267,4,5,1,878971514,878971599,85,92,156,4.017857142857143
267,5,4,-1,878971599,878971629,30,156,204,3.6744186046511627
267,4,5,1,878971629,878971659,30,204,12,4.358974358974359
267,5,5,0,878971659,878971690,31,12,180,3.9473684210526314
267,5,4,-1,878971690,878971716,26,180,168,4.0476190476190474
267,4,5,1,878971716,878971745,29,168,188,3.625
267,5,5,0,878971745,878971773,28,188,518,3.5833333333333335
267,5,4,-1,878971773,878971816,43,518,1401,3.0
267,4,4,0,878971816,878971874,58,1401,189,3.88
267,4,5,1,878971874,878971902,28,189,654,4.119047619047619
267,5,5,0,878971902,878971989,87,654,98,4.240875912408759
267,5,5,0,878971989,878972015,26,98,614,3.727272727272727
267,5,3,-2,878972015,878972040,25,614,554,2.9555555555555557
267,3,4,1,878972040,878972092,52,554,195,3.9072164948453607
267,4,4,0,878972092,878972147,55,195,141,3.4827586206896552
267,4,5,1,878972147,878972170,23,141,128,3.45
267,5,5,0,878972170,878972241,71,128,203,3.826923076923077
267,5,4,-1,878972241,878972266,25,203,693,3.6285714285714286
267,4,4,0,878972266,878972289,23,693,727,3.5517241379310347
267,4,5,1,878972289,878972314,25,727,433,3.8035714285714284
267,5,5,0,878972314,878972369,55,433,47,3.5869565217391304
267,5,3,-2,878972369,878972399,30,47,5,3.1481481481481484
267,3,5,2,878972399,878972434,35,5,228,3.7246376811594204
267,5,3,-2,878972434,878972463,29,228,226,3.378787878787879
267,3,4,1,878972463,878972493,30,226,230,3.3518518518518516
267,4,5,1,878972493,878972558,65,230,175,3.8354430379746836
267,5,5,0,878972558,878972614,56,175,169,4.548387096774194
267,5,4,-1,878972614,878972650,36,169,218,3.5555555555555554
267,4,5,1,878972650,878972682,32,218,24,3.3728813559322033
267,5,4,-1,878972682,878972706,24,24,161,3.5844155844155843
267,4,4,0,878972706,878972731,25,161,233,3.323529411764706
267,4,5,1,878972731,878972756,25,233,177,3.875
267,5,4,-1,878972756,878972785,29,177,55,4.051282051282051
267,4,3,-1,878972785,878972842,57,55,423,3.7016129032258065
267,3,4,1,878972842,878972931,89,423,470,3.72
267,4,4,0,878972931,878972955,24,470,568,3.5853658536585367
267,4,3,-1,878972955,878973088,133,568,227,3.169811320754717
267,3,4,1,878973088,878973126,38,227,158,2.7027027027027026
267,4,4,0,878973126,878973153,27,158,231,2.938775510204082
267,4,3,-1,878973153,878973179,26,231,944,2.75
267,3,4,1,878973179,878973250,71,944,780,3.08
267,4,4,0,878973250,878973276,26,780,739,3.391304347826087
267,4,3,-1,878973276,878973358,82,739,449,2.9069767441860463
267,3,4,1,878973358,878973426,68,449,431,3.422222222222222
267,4,3,-1,878973426,878973483,57,431,393,3.5125
267,3,3,0,878973483,878973568,85,393,810,2.9473684210526314
267,3,3,0,878973568,878973597,29,810,386,2.769230769230769
267,3,4,1,878973597,878973650,53,386,732,3.6266666666666665
267,4,3,-1,878973650,878973675,25,732,391,2.4285714285714284
267,3,3,0,878973675,878973701,26,391,774,3.0
267,3,3,0,878973701,878973734,33,774,384,2.7941176470588234
267,3,4,1,878973734,878973760,26,384,217,3.1538461538461537
267,4,4,0,878973760,878973825,65,217,665,2.72972972972973
267,4,3,-1,878973825,878973854,29,665,1090,2.3529411764705883
267,3,3,0,878973854,878973900,46,1090,771,2.5714285714285716
267,3,3,0,878973900,878973946,46,771,720,3.2
267,3,4,1,878973946,878973971,25,720,1035,3.03125
267,4,3,-1,878973971,878974052,81,1035,575,2.619047619047619
267,3,3,0,878974052,878974077,25,575,622,3.3333333333333335
267,3,2,-1,878974077,878974128,51,622,450,2.2758620689655173
267,2,3,1,878974128,878974325,197,450,411,2.911764705882353
267,3,2,-1,878974325,878974460,135,411,364,2.8095238095238093
267,2,2,0,878974460,878974509,49,364,1471,2.75
267,2,3,1,878974509,878974608,99,1471,1145,2.6666666666666665
267,3,4,1,878974608,878974659,51,1145,159,3.3902439024390243
267,4,2,-2,878974659,878974723,64,159,545,1.7142857142857142
267,2,5,3,878974723,878974783,60,545,1240,3.5454545454545454
11,5,5,0,891901629,891901652,23,750,268,3.9838709677419355
11,5,5,0,891901652,891901696,44,268,258,3.7547169811320753
11,5,4,-1,891901696,891901716,20,258,690,3.260869565217391
11,4,5,1,891901716,891901769,53,690,332,3.6511627906976742
11,5,5,0,891901769,891901797,28,332,749,3.2777777777777777
11,5,4,-1,891901797,891901991,194,749,350,3.2
11,4,2,-2,891901991,891902092,101,350,751,3.3896103896103895
11,2,4,2,891902092,891902157,65,751,301,3.2465753424657535
11,4,1,-3,891902157,891902222,65,301,324,3.2291666666666665
11,1,1,0,891902222,891902270,48,324,748,3.1043478260869564
11,1,1,0,891902270,891902426,156,748,260,2.4716981132075473
11,1,3,2,891902426,891902745,319,260,123,3.297872340425532
11,3,4,1,891902745,891902815,70,123,291,3.2
11,4,3,-1,891902815,891902880,65,291,370,2.8125
11,3,5,2,891902880,891902970,90,370,9,3.8878504672897196
11,5,4,-1,891902970,891903005,35,9,744,3.5714285714285716
11,4,5,1,891903005,891903024,19,744,713,3.5
11,5,5,0,891903024,891903067,43,713,15,3.725663716814159
11,5,4,-1,891903067,891903108,41,15,125,3.5555555555555554
11,4,4,0,891903108,891903226,118,125,544,3.185185185185185
11,4,4,0,891903226,891903276,50,544,107,3.45
11,4,3,-1,891903276,891903862,586,107,455,3.1702127659574466
11,3,3,0,891903862,891903877,15,455,290,3.108108108108108
11,3,2,-1,891903877,891903935,58,290,120,2.3421052631578947
11,2,3,1,891903935,891904016,81,120,405,3.25
11,3,2,-1,891904016,891904065,49,405,743,1.9545454545454546
11,2,2,0,891904065,891904194,129,743,12,4.358974358974359
11,2,3,1,891904194,891904214,20,12,558,3.75
11,3,4,1,891904214,891904241,27,558,22,4.215909090909091
11,4,5,1,891904241,891904335,94,22,83,4.204081632653061
11,5,4,-1,891904335,891904389,54,83,699,3.736842105263158
11,4,4,0,891904389,891904413,24,699,733,3.3333333333333335
11,4,3,-1,891904413,891904551,138,733,724,3.64
11,3,2,-1,891904551,891904552,1,724,57,4.133333333333334
11,2,4,2,891904552,891904617,65,57,549,3.4871794871794872
11,4,4,0,891904617,891904637,20,549,729,3.3793103448275863
11,4,4,0,891904637,891904662,25,729,402,3.3076923076923075
11,4,1,-3,891904662,891904717,55,402,720,3.2
11,1,3,2,891904717,891904764,47,720,365,2.95
11,3,4,1,891904764,891904789,25,365,737,3.12
11,4,3,-1,891904789,891904805,16,737,29,2.5714285714285716
11,3,5,2,891904805,891904920,115,29,173,4.1441441441441444
11,5,4,-1,891904920,891904949,29,173,524,4.166666666666667
11,4,4,0,891904949,891905003,54,524,692,3.56
11,4,4,0,891905003,891905032,29,692,663,3.948717948717949
11,4,3,-1,891905032,891905058,26,663,42,3.893617021276596
11,3,3,0,891905058,891905279,221,42,719,2.6666666666666665
11,3,5,2,891905279,891905324,45,719,745,4.0
11,5,3,-2,891905324,891905349,25,745,734,3.0
11,3,3,0,891905349,891905568,219,734,725,3.0
11,3,3,0,891905568,891905856,288,725,654,4.119047619047619
11,3,4,1,891905856,891905878,22,654,229,3.185185185185185
11,4,2,-2,891905878,891905896,18,229,431,3.422222222222222
11,2,3,1,891905896,891905936,40,431,54,3.3714285714285714
11,3,4,1,891905936,891906389,453,54,213,3.943396226415094
11,4,4,0,891906389,891906411,22,213,736,4.083333333333333
11,4,3,-1,891906411,891906426,15,736,747,3.5526315789473686
11,3,4,1,891906426,891906439,13,747,51,3.5277777777777777
11,4,3,-1,891906439,891906510,71,51,274,3.5609756097560976
8,4,1,-3,879361550,879361604,54,301,259,2.492063492063492
8,1,3,2,879361604,879361664,60,259,336,2.4
8,3,3,0,879361664,879361665,1,336,260,2.4716981132075473
8,3,2,-1,879361665,879361732,67,260,243,2.357142857142857
8,2,1,-1,879361732,879361825,93,243,687,2.1481481481481484
8,1,4,3,879361825,879361873,48,687,689,3.1538461538461537
8,4,1,-3,879361873,879362124,251,689,385,3.6129032258064515
8,1,5,4,879362124,879362183,59,385,56,4.051724137931035
8,5,4,-1,879362183,879362234,51,56,403,3.298507462686567
8,4,5,1,879362234,879362286,52,403,144,3.9545454545454546
8,5,5,0,879362286,879362356,70,144,222,3.578125
8,5,4,-1,879362356,879362423,67,222,227,3.169811320754717
162,4,5,1,877635573,877635662,89,25,508,3.6923076923076925
162,5,4,-1,877635662,877635690,28,508,298,3.779220779220779
162,4,4,0,877635690,877635758,68,298,742,3.5555555555555554
162,4,4,0,877635758,877635798,40,742,181,3.98974358974359
162,4,4,0,877635798,877635869,71,181,117,3.689189189189189
162,4,4,0,877635869,877635897,28,117,628,3.573529411764706
162,4,3,-1,877635897,877635917,20,628,685,3.2666666666666666
162,3,3,0,877635917,877635965,48,685,826,2.5555555555555554
162,3,4,1,877635965,877635980,15,826,237,3.7315436241610738
162,4,4,0,877635980,877636147,167,237,147,3.3142857142857145
162,4,3,-1,877636147,877636191,44,147,151,3.6544117647058822
162,3,2,-1,877636191,877636300,109,151,122,2.282608695652174
162,2,4,2,877636300,877636370,70,122,1011,3.1
162,4,2,-2,877636370,877636458,88,1011,105,2.6176470588235294
162,2,3,1,877636458,877636476,18,105,254,2.7419354838709675
162,3,4,1,877636476,877636556,80,254,1019,3.7777777777777777
162,4,4,0,877636556,877636604,48,1019,943,3.6666666666666665
162,4,3,-1,877636604,877636713,109,943,403,3.298507462686567
162,3,3,0,877636713,877636746,33,403,144,3.9545454545454546
162,3,4,1,877636746,877636772,26,144,11,3.8904109589041096
162,4,3,-1,877636772,877636794,22,11,179,3.8823529411764706
162,3,4,1,877636794,877636860,66,179,710,3.41025641025641
279,1,5,4,875249134,875249210,76,990,408,4.4772727272727275
279,5,3,-2,875249210,875249232,22,408,275,4.087912087912088
279,3,3,0,875249232,875249259,27,275,250,3.4698795180722892
279,3,5,2,875249259,875295736,46477,250,25,3.3185840707964602
279,5,4,-1,875295736,875295838,102,25,10,3.85
279,4,3,-1,875295838,875296005,167,10,411,2.911764705882353
279,3,4,1,875296005,875296104,99,411,1028,2.857142857142857
279,4,5,1,875296104,875296291,187,1028,154,3.6031746031746033
279,5,3,-2,875296291,875296292,1,154,432,3.719298245614035
279,3,1,-2,875296292,875296374,82,432,22,4.215909090909091
279,1,4,3,875296374,875296375,1,22,47,3.5869565217391304
279,4,5,1,875296375,875296435,60,47,491,3.55
279,5,4,-1,875296435,875296461,26,491,4,3.5538461538461537
279,4,3,-1,875296461,875296652,191,4,283,3.901639344262295
279,3,3,0,875296652,875296676,24,283,952,3.3529411764705883
279,3,4,1,875296676,875296696,20,952,926,2.7857142857142856
279,4,3,-1,875296696,875296792,96,926,274,3.5609756097560976
279,3,5,2,875296792,875296813,21,274,236,3.2666666666666666
279,5,5,0,875296813,875296829,16,236,864,3.2142857142857144
279,5,3,-2,875296829,875296891,62,864,1017,3.0
279,3,4,1,875296891,875296924,33,1017,290,3.108108108108108
279,4,1,-3,875296924,875297281,357,290,146,2.3333333333333335
279,1,4,3,875297281,875297381,100,146,105,2.6176470588235294
279,4,4,0,875297381,875297410,29,105,871,2.3823529411764706
279,4,1,-3,875297410,875297433,23,871,122,2.282608695652174
279,1,4,3,875297433,875297456,23,122,826,2.5555555555555554
279,4,3,-1,875297456,875297522,66,826,763,3.347826086956522
279,3,4,1,875297522,875298330,808,763,1093,3.0
279,4,1,-3,875298330,875298353,23,1093,1336,1.75
279,1,3,2,875298353,875298419,66,1336,1496,2.0
279,3,5,2,875298419,875298447,28,1496,1012,3.2916666666666665
279,5,3,-2,875298447,875298494,47,1012,181,3.98974358974359
279,3,1,-2,875298494,875298597,103,181,532,2.7777777777777777
279,1,3,2,875298597,875298652,55,532,1244,2.7777777777777777
279,3,3,0,875298652,875298696,44,1244,32,3.7222222222222223
279,3,4,1,875298696,875306515,7819,32,56,4.051724137931035
279,4,5,1,875306515,875306552,37,56,654,4.119047619047619
279,5,4,-1,875306552,875306580,28,654,156,4.017857142857143
279,4,4,0,875306580,875306636,56,156,174,4.253521126760563
279,4,1,-3,875306636,875306767,131,174,65,3.511111111111111
279,1,3,2,875306767,875306820,53,65,461,3.3333333333333335
279,3,3,0,875306820,875306910,90,461,214,3.272727272727273
279,3,3,0,875306910,875307379,469,214,1110,2.85
279,3,3,0,875307379,875307407,28,1110,190,4.233333333333333
279,3,2,-1,875307407,875307443,36,190,753,3.3333333333333335
279,2,4,2,875307443,875307587,144,753,202,3.730337078651685
279,4,2,-2,875307587,875308670,1083,202,180,3.9473684210526314
279,2,4,2,875308670,875308843,173,180,59,4.0
279,4,5,1,875308843,875308987,144,59,209,3.8275862068965516
279,5,1,-4,875308987,875309141,154,209,70,3.5833333333333335
279,1,3,2,875309141,875309189,48,70,480,4.283018867924528
279,3,4,1,875309189,875309351,162,480,385,3.6129032258064515
279,4,5,1,875309351,875309482,131,385,186,3.905263157894737
279,5,4,-1,875309482,875309616,134,186,211,3.958904109589041
279,4,3,-1,875309616,875309667,51,211,31,3.642857142857143
279,3,3,0,875309667,875309760,93,31,1070,4.0
279,3,3,0,875309760,875309861,101,1070,367,3.4242424242424243
279,3,3,0,875309861,875309911,50,367,462,3.7954545454545454
279,3,3,0,875309911,875309935,24,462,1035,3.03125
279,3,3,0,875309935,875309950,15,1035,95,3.8194444444444446
279,3,4,1,875309950,875310041,91,95,73,3.588235294117647
279,4,4,0,875310041,875310101,60,73,1121,3.5
279,4,4,0,875310101,875310117,16,1121,372,3.6666666666666665
279,4,5,1,875310117,875310157,40,372,465,3.75
279,5,5,0,875310157,875310233,76,465,746,3.7560975609756095
279,5,3,-2,875310233,875310303,70,746,62,3.048780487804878
279,3,4,1,875310303,875310418,115,62,239,3.423076923076923
279,4,4,0,875310418,875310419,1,239,67,3.106382978723404
279,4,3,-1,875310419,875310606,187,67,176,3.967032967032967
279,3,5,2,875310606,875310730,124,176,401,2.6774193548387095
279,5,4,-1,875310730,875310764,34,401,398,2.1
279,4,3,-1,875310764,875312378,1614,398,449,2.9069767441860463
279,3,5,2,875312378,875312745,367,449,233,3.323529411764706
279,5,5,0,875312745,875313015,270,233,27,3.235294117647059
279,5,3,-2,875313015,875313032,17,27,946,3.1153846153846154
279,3,4,1,875313032,875313351,319,946,630,3.25
279,4,4,0,875313351,875313406,55,630,1305,2.3333333333333335
279,4,4,0,875313406,875313473,67,1305,660,3.71875
279,4,1,-3,875313473,875313514,41,660,44,3.1333333333333333
279,1,4,3,875313514,875313616,102,44,759,2.6
279,4,4,0,875313616,875313859,243,759,399,3.317073170731707
279,4,5,1,875313859,875313883,24,399,998,2.7777777777777777
279,5,4,-1,875313883,875313925,42,998,1481,4.0
279,4,4,0,875313925,875314001,76,1481,1181,2.6
279,4,4,0,875314001,875314165,164,1181,780,3.08
279,4,4,0,875314165,875314231,66,780,971,4.0
279,4,3,-1,875314231,875314287,56,971,90,3.0
279,3,3,0,875314287,875314313,26,90,415,2.6666666666666665
279,3,3,0,875314313,875314370,57,415,1182,2.4285714285714284
279,3,3,0,875314370,875314386,16,1182,379,3.35
279,3,5,2,875314386,875314434,48,379,1413,3.75
279,5,3,-2,875314434,875659844,345410,1413,388,2.5833333333333335
279,3,2,-1,875659844,875659924,80,388,1247,1.5
279,2,3,1,875659924,875734031,74107,1247,191,4.168674698795181
279,3,4,1,875734031,875744416,10385,191,804,3.0
279,4,4,0,875744416,875744512,96,804,797,3.1538461538461537
279,4,2,-2,875744512,875744584,72,797,1151,2.6666666666666665
279,2,4,2,875744584,875744641,57,1151,1178,2.375
279,4,3,-1,875744641,877756647,2012006,1178,242,3.5217391304347827
279,3,5,2,877756647,877756699,52,242,659,4.027777777777778
279,5,4,-1,877756699,877756804,105,659,1088,2.4
279,4,2,-2,877756804,877756984,180,1088,30,3.8181818181818183
279,2,5,3,877756984,878082781,325797,30,83,4.204081632653061
279,5,3,-2,878082781,878082804,23,83,1224,2.6666666666666665
279,3,3,0,878082804,878261977,179173,1224,124,4.052631578947368
279,3,4,1,878261977,878262195,218,124,1485,4.0
279,4,4,0,878262195,879572893,1310698,1485,166,4.0
279,4,3,-1,879572893,879572960,67,166,254,2.7419354838709675
279,3,3,0,879572960,879573022,62,254,805,3.909090909090909
279,3,2,-1,879573022,879573041,19,805,29,2.5714285714285716
279,2,3,1,879573041,880666808,1093767,29,556,2.7142857142857144
279,3,2,-1,880666808,882146492,1479684,556,66,3.4705882352941178
279,2,1,-1,882146492,882146554,62,66,88,3.433734939759036
279,1,1,0,882146554,884556678,2410124,88,375,2.076923076923077
279,1,1,0,884556678,884982882,426204,375,1239,2.25
279,1,1,0,884982882,886015853,1032971,1239,284,3.1547619047619047
279,1,1,0,886015853,886016480,627,284,1095,2.8
279,1,3,2,886016480,888465209,2448729,1095,1428,3.2857142857142856
279,3,3,0,888465209,888806035,340826,1428,1113,3.0
279,3,1,-2,888806035,888806649,614,1113,374,2.111111111111111
279,1,1,0,888806649,889151559,344910,374,577,1.7058823529411764
279,1,2,1,889151559,889984640,833081,577,810,2.9473684210526314
279,2,3,1,889984640,890282225,297585,810,490,3.5454545454545454
279,3,2,-1,890282225,890451373,169148,490,666,2.0
279,2,4,2,890451373,890451408,35,666,710,3.41025641025641
279,4,1,-3,890451408,890451433,25,710,544,3.185185185185185
279,1,5,4,890451433,890451473,40,544,363,3.0
279,5,3,-2,890451473,890780576,329103,363,52,3.727272727272727
279,3,1,-2,890780576,890780603,27,52,1142,4.0476190476190474
279,1,4,3,890780603,890780735,132,1142,1072,3.0
279,4,3,-1,890780735,890780864,129,1072,727,3.5517241379310347
279,3,3,0,890780864,890780962,98,727,1312,2.8333333333333335
279,3,2,-1,890780962,890781034,72,1312,1180,2.6666666666666665
279,2,4,2,890781034,891208908,427874,1180,238,3.888888888888889
279,4,3,-1,891208908,891208945,37,238,809,2.7058823529411766
279,3,1,-2,891208945,891209021,76,809,594,2.3333333333333335
279,1,4,3,891209021,891209077,56,594,364,2.8095238095238093
279,4,3,-1,891209077,891209078,1,364,948,2.2962962962962963
279,3,1,-2,891209078,891209102,24,948,1170,3.1666666666666665
279,1,3,2,891209102,891209153,51,1170,235,3.106382978723404
279,3,3,0,891209153,891209189,36,235,1120,3.1
279,3,4,1,891209189,891209332,143,1120,436,3.5
279,4,3,-1,891209332,892173418,964086,436,1437,2.3333333333333335
279,3,2,-1,892173418,892173598,180,1437,1133,3.076923076923077
279,2,3,1,892173598,892174339,741,1133,1435,2.5
279,3,4,1,892174339,892174381,42,1435,108,3.107142857142857
279,4,1,-3,892174381,892174404,23,108,1240,3.5454545454545454
279,1,4,3,892174404,892864663,690259,1240,1047,2.6923076923076925
279,4,1,-3,892864663,892864707,44,1047,130,1.8461538461538463
279,1,3,2,892864707,892864867,160,130,421,3.462962962962963
279,3,3,0,892864867,892865054,187,421,94,2.8823529411764706
145,4,4,0,875269822,875269871,49,688,294,3.1052631578947367
145,4,3,-1,875269871,875270322,451,294,111,3.5106382978723403
145,3,5,2,875270322,875270458,136,111,100,4.0162162162162165
145,5,2,-3,875270458,875270507,49,100,121,3.521212121212121
145,2,2,0,875270507,875270508,1,121,924,3.3703703703703702
145,2,3,1,875270508,875270616,108,924,993,3.4838709677419355
145,3,3,0,875270616,875270692,76,993,406,2.5294117647058822
145,3,5,2,875270692,875270764,72,406,240,3.0350877192982457
145,5,3,-2,875270764,875270800,36,240,274,3.5609756097560976
145,3,2,-1,875270800,875270932,132,274,628,3.573529411764706
145,2,3,1,875270932,875271047,115,628,546,2.9789473684210526
145,3,3,0,875271047,875271094,47,546,926,2.7857142857142856
145,3,3,0,875271094,875271128,34,926,472,2.984375
145,3,4,1,875271128,875271229,101,472,685,3.2666666666666666
145,4,1,-3,875271229,875271312,83,685,460,3.0
145,1,1,0,875271312,875271357,45,460,1087,1.0
145,1,3,2,875271357,875271442,85,1087,696,3.138888888888889
145,3,3,0,875271442,875271522,80,696,1132,2.588235294117647
145,3,3,0,875271522,875271562,40,1132,3,3.0625
145,3,4,1,875271562,875271607,45,3,363,3.0
145,4,5,1,875271607,875271838,231,363,176,3.967032967032967
145,5,5,0,875271838,875271896,58,176,98,4.240875912408759
145,5,5,0,875271896,875272009,113,98,183,3.951219512195122
145,5,4,-1,875272009,875272050,41,183,939,3.6333333333333333
145,4,5,1,875272050,875272131,81,939,265,3.710144927536232
145,5,3,-2,875272131,875272195,64,265,1248,3.0
145,3,5,2,875272195,875272196,1,1248,1273,2.5714285714285716
145,5,2,-3,875272196,875272245,49,1273,53,2.9523809523809526
145,2,4,2,875272245,875272299,54,53,673,3.393939393939394
145,4,3,-1,875272299,875272348,49,673,77,3.3857142857142857
145,3,2,-1,875272348,875272652,304,77,727,3.5517241379310347
145,2,1,-1,875272652,875272732,80,727,1290,1.0
145,1,2,1,875272732,875272786,54,1290,740,3.423076923076923
145,2,3,1,875272786,875272833,47,740,821,3.076923076923077
145,3,2,-1,875272833,875272871,38,821,155,3.0588235294117645
145,2,3,1,875272871,875272926,55,155,49,3.3
145,3,3,0,875272926,875272927,1,49,738,3.0
145,3,5,2,875272927,875272987,60,738,1041,3.3333333333333335
145,5,2,-3,875272987,875272988,1,1041,728,3.05
145,2,4,2,875272988,875273120,132,728,650,3.1363636363636362
145,4,5,1,875273120,875273174,54,650,393,3.5125
145,5,4,-1,875273174,875273234,60,393,358,2.6551724137931036
145,4,3,-1,875273234,877343000,2069766,358,266,2.6666666666666665
145,3,4,1,877343000,877343020,20,266,1025,2.95
145,4,5,1,877343020,877343121,101,1025,448,3.466666666666667
145,5,4,-1,877343121,877343156,35,448,569,2.4285714285714284
145,4,4,0,877343156,877343184,28,569,674,2.6875
145,4,5,1,877343184,877343185,1,674,219,2.735294117647059
145,5,5,0,877343185,877343212,27,219,665,2.72972972972973
145,5,3,-2,877343212,877343280,68,665,413,2.5652173913043477
145,3,3,0,877343280,879161554,1818274,413,331,3.5517241379310347
145,3,5,2,879161554,879161576,22,331,269,4.085106382978723
145,5,5,0,879161576,879161577,1,269,270,3.7804878048780486
145,5,3,-2,879161577,879161624,47,270,682,3.0476190476190474
145,3,3,0,879161624,879161674,50,682,683,2.176470588235294
145,3,1,-2,879161674,879161805,131,683,983,2.5
145,1,4,3,879161805,879161848,43,983,123,3.297872340425532
145,4,2,-2,879161848,879161882,34,123,767,3.0
145,2,3,1,879161882,879161931,49,767,977,2.473684210526316
145,3,4,1,879161931,882181205,3019274,977,342,2.64
145,4,2,-2,882181205,882181335,130,342,687,2.1481481481481484
145,2,3,1,882181335,882181396,61,687,1,3.902439024390244
145,3,4,1,882181396,882181605,209,1,89,3.9615384615384617
145,4,5,1,882181605,882181632,27,89,172,4.225225225225225
145,5,4,-1,882181632,882181659,27,172,209,3.8275862068965516
145,4,1,-3,882181659,882181695,36,209,59,4.0
145,1,4,3,882181695,882181785,90,59,64,4.373737373737374
145,4,4,0,882181785,882181859,74,64,238,3.888888888888889
145,4,3,-1,882181859,882182658,799,238,443,3.8421052631578947
145,3,3,0,882182658,882182689,31,443,637,2.888888888888889
145,3,1,-2,882182689,882182802,113,637,590,1.8888888888888888
145,1,5,4,882182802,882182917,115,590,12,4.358974358974359
145,5,4,-1,882182917,883840666,1657749,12,751,3.3896103896103895
145,4,5,1,883840666,883840797,131,751,315,4.15
145,5,1,-4,883840797,883840965,168,315,894,2.0
145,1,1,0,883840965,885555980,1715015,894,898,3.0869565217391304
145,1,4,3,885555980,885556043,63,898,352,1.8333333333333333
145,4,2,-2,885556043,885557506,1463,352,756,2.6885245901639343
145,2,1,-1,885557506,885557545,39,756,1023,2.5714285714285716
145,1,1,0,885557545,885557579,34,1023,298,3.779220779220779
145,1,5,4,885557579,885557660,81,298,50,4.306532663316583
145,5,3,-2,885557660,885557699,39,50,229,3.185185185185185
145,3,5,2,885557699,885557731,32,229,135,3.7974683544303796
145,5,4,-1,885557731,885622707,64976,135,471,3.5714285714285716
145,4,5,1,885622707,888396966,2774259,471,316,4.285714285714286
145,5,3,-2,888396966,888396967,1,316,355,2.75
145,3,1,-2,888396967,888397981,1014,355,236,3.2666666666666666
145,1,2,1,888397981,888398069,88,236,929,2.8421052631578947
145,2,2,0,888398069,888398087,18,929,1051,3.625
145,2,4,2,888398087,888398104,17,1051,284,3.1547619047619047
145,4,2,-2,888398104,888398123,19,284,760,2.35
145,2,5,3,888398123,888398162,39,760,1011,3.1
145,5,4,-1,888398162,888398197,35,1011,1288,2.5
145,4,2,-2,888398197,888398238,41,1288,827,2.4375
145,2,2,0,888398238,888398257,19,827,764,3.1176470588235294
145,2,1,-1,888398257,888398307,50,764,122,2.282608695652174
145,1,1,0,888398307,888398400,93,122,1002,2.0
145,1,1,0,888398400,888398492,92,1002,1040,2.2666666666666666
145,1,1,0,888398492,888398516,24,1040,743,1.9545454545454546
145,1,2,1,888398516,888398563,47,743,120,2.3421052631578947
145,2,5,3,888398563,888398669,106,120,54,3.3714285714285714
145,5,5,0,888398669,888398747,78,54,572,2.857142857142857
145,5,1,-4,888398747,888398766,19,572,1210,2.7142857142857144
145,1,2,1,888398766,888398833,67,1210,574,2.0
145,2,2,0,888398833,888398867,34,574,771,2.5714285714285716
145,2,3,1,888398867,891509921,3111054,771,347,3.59375
145,3,1,-2,891509921,891510040,119,347,988,2.5555555555555554
28,5,2,-3,881955018,881955343,325,258,322,3.0476190476190474
28,2,4,2,881955343,881956082,739,322,31,3.642857142857143
28,4,4,0,881956082,881956144,62,31,234,3.7674418604651163
28,4,3,-1,881956144,881956220,76,234,609,3.7058823529411766
28,3,5,2,881956220,881956334,114,609,174,4.253521126760563
28,5,5,0,881956334,881956445,111,174,176,3.967032967032967
28,5,4,-1,881956445,881956564,119,176,143,3.56
28,4,3,-1,881956564,881956917,353,143,95,3.8194444444444446
28,3,4,1,881956917,881957002,85,95,117,3.689189189189189
28,4,4,0,881957002,881957090,88,117,50,4.306532663316583
28,4,4,0,881957090,881957147,57,50,568,3.5853658536585367
28,4,4,0,881957147,881957250,103,568,195,3.9072164948453607
28,4,4,0,881957250,881957425,175,195,282,3.610526315789474
28,4,5,1,881957425,881957479,54,282,56,4.051724137931035
28,5,4,-1,881957479,881960945,3466,56,164,3.6140350877192984
28,4,4,0,881960945,881961003,58,164,646,3.9285714285714284
28,4,4,0,881961003,881961104,101,646,89,3.9615384615384617
28,4,4,0,881961104,881961157,53,89,479,4.25
28,4,4,0,881961157,881961311,154,479,70,3.5833333333333335
28,4,5,1,881961311,881961393,82,70,228,3.7246376811594204
28,5,5,0,881961393,881961531,138,228,98,4.240875912408759
28,5,3,-2,881961531,881961532,1,98,447,3.46875
28,3,4,1,881961532,881961600,68,447,670,2.9375
28,4,5,1,881961600,881961601,1,670,436,3.5
28,5,2,-3,881961601,881961671,70,436,200,3.8157894736842106
28,2,3,1,881961671,881961728,57,200,672,2.7222222222222223
28,3,4,1,881961728,881961782,54,672,567,3.272727272727273
28,4,3,-1,881961782,881961842,60,567,859,2.75
28,3,4,1,881961842,881961904,62,859,800,3.2222222222222223
28,4,3,-1,881961904,882826399,864495,800,760,2.35
28,3,5,2,882826399,882826496,97,760,223,4.108695652173913
28,5,3,-2,882826496,882826593,97,223,323,3.0
135,4,4,0,879857592,879857612,20,475,744,3.5714285714285716
135,4,4,0,879857612,879857723,111,744,173,4.1441441441441444
135,4,4,0,879857723,879857764,41,173,12,4.358974358974359
135,4,4,0,879857764,879857765,1,12,23,3.9047619047619047
135,4,4,0,879857765,879857797,32,23,55,4.051282051282051
135,4,3,-1,879857797,879857843,46,55,230,3.3518518518518516
135,3,3,0,879857843,879857868,25,230,5,3.1481481481481484
135,3,3,0,879857868,879857930,62,5,566,3.543859649122807
135,3,4,1,879857930,879857931,1,566,581,3.130434782608696
135,4,1,-3,879857931,879857956,25,581,564,2.0
135,1,3,2,879857956,879858003,47,564,1208,2.6666666666666665
32,4,4,0,883709840,883709915,75,313,288,3.5214285714285714
32,4,3,-1,883709915,883709953,38,288,271,3.3134328358208953
32,3,2,-1,883709953,883709986,33,271,259,2.492063492063492
32,2,2,0,883709986,883710047,61,259,245,3.056179775280899
32,2,4,2,883710047,883717537,7490,245,257,3.7154471544715446
32,4,3,-1,883717537,883717555,18,257,117,3.689189189189189
32,3,4,1,883717555,883717581,26,117,508,3.6923076923076925
32,4,3,-1,883717581,883717628,47,508,742,3.5555555555555554
32,3,4,1,883717628,883717645,17,742,249,3.3275862068965516
32,4,3,-1,883717645,883717662,17,249,100,4.0162162162162165
32,3,3,0,883717662,883717684,22,100,408,4.4772727272727275
32,3,3,0,883717684,883717747,63,408,9,3.8878504672897196
32,3,4,1,883717747,883717766,19,9,7,3.76056338028169
32,4,2,-2,883717766,883717796,30,7,455,3.1702127659574466
32,2,3,1,883717796,883717850,54,455,151,3.6544117647058822
32,3,2,-1,883717850,883717967,117,151,240,3.0350877192982457
32,2,3,1,883717967,883717986,19,240,111,3.5106382978723403
32,3,3,0,883717986,883718031,45,111,866,3.3962264150943398
32,3,4,1,883718031,883718121,90,866,628,3.573529411764706
32,4,2,-2,883718121,883718250,129,628,122,2.282608695652174
90,3,3,0,891382163,891382240,77,300,310,3.6666666666666665
90,3,4,1,891382240,891382309,69,310,900,4.2
90,4,5,1,891382309,891382310,1,900,269,4.085106382978723
90,5,4,-1,891382310,891382392,82,269,301,3.2465753424657535
90,4,3,-1,891382392,891382490,98,301,328,3.4895833333333335
90,3,3,0,891382490,891382522,32,328,990,2.769230769230769
90,3,3,0,891382522,891382612,90,990,245,3.056179775280899
90,3,3,0,891382612,891382634,22,245,323,3.0
90,3,5,2,891382634,891382658,24,323,316,4.285714285714286
90,5,4,-1,891382658,891382708,50,316,995,3.0
90,4,3,-1,891382708,891382731,23,995,889,3.6666666666666665
90,3,5,2,891382731,891383204,473,889,198,4.04
90,5,4,-1,891383204,891383241,37,198,512,3.888888888888889
90,4,5,1,891383241,891383319,78,512,307,3.6031746031746033
90,5,5,0,891383319,891383350,31,307,604,3.8181818181818183
90,5,4,-1,891383350,891383423,73,604,166,4.0
90,4,5,1,891383423,891383424,1,166,211,3.958904109589041
90,5,5,0,891383424,891383599,175,211,474,4.172413793103448
90,5,4,-1,891383599,891383600,1,474,33,3.2941176470588234
90,4,5,1,891383600,891383626,26,33,275,4.087912087912088
90,5,5,0,891383626,891383718,92,275,213,3.943396226415094
90,5,4,-1,891383718,891383752,34,213,193,3.883720930232558
90,4,5,1,891383752,891383866,114,193,174,4.253521126760563
90,5,4,-1,891383866,891383987,121,174,221,3.6923076923076925
90,4,4,0,891383987,891384020,33,221,614,3.727272727272727
90,4,4,0,891384020,891384066,46,614,1200,3.5
90,4,4,0,891384066,891384113,47,1200,11,3.8904109589041096
90,4,4,0,891384113,891384114,1,11,863,3.727272727272727
90,4,5,1,891384114,891384147,33,863,730,3.8
90,5,5,0,891384147,891384423,276,730,519,4.291666666666667
90,5,4,-1,891384423,891384476,53,519,692,3.56
90,4,4,0,891384476,891384516,40,692,811,4.166666666666667
90,4,4,0,891384516,891384570,54,811,1101,3.793103448275862
90,4,5,1,891384570,891384611,41,1101,178,4.378378378378378
90,5,4,-1,891384611,891384673,62,178,31,3.642857142857143
90,4,2,-2,891384673,891384721,48,31,962,3.142857142857143
90,2,4,2,891384721,891384754,33,962,648,3.9545454545454546
90,4,5,1,891384754,891384789,35,648,611,4.384615384615385
90,5,4,-1,891384789,891384959,170,611,1204,4.0
90,4,5,1,891384959,891384996,37,1204,497,3.35
90,5,4,-1,891384996,891384997,1,497,813,4.055555555555555
90,4,3,-1,891384997,891385039,42,813,45,4.130434782608695
90,3,5,2,891385039,891385040,1,45,155,3.0588235294117645
90,5,5,0,891385040,891385132,92,155,529,4.142857142857143
90,5,5,0,891385132,891385165,33,529,568,3.5853658536585367
90,5,5,0,891385165,891385190,25,568,162,3.4651162790697674
90,5,5,0,891385190,891385215,25,162,387,3.5357142857142856
90,5,4,-1,891385215,891385250,35,387,971,4.0
90,4,4,0,891385250,891385298,48,971,65,3.511111111111111
90,4,5,1,891385298,891385335,37,65,402,3.3076923076923075
90,5,5,0,891385335,891385389,54,402,179,3.8823529411764706
90,5,3,-2,891385389,891385465,76,179,475,3.956043956043956
90,3,5,2,891385465,891385466,1,475,602,3.533333333333333
90,5,3,-2,891385466,891385522,56,602,530,4.125
90,3,4,1,891385522,891385751,229,530,753,3.3333333333333335
90,4,3,-1,891385751,891385752,1,753,1134,2.888888888888889
90,3,2,-1,891385752,891385787,35,1134,148,3.2131147540983607
90,2,5,3,891385787,891385842,55,148,662,3.4583333333333335
90,5,5,0,891385842,891385843,1,662,966,4.7
90,5,3,-2,891385843,891385899,56,966,1136,3.3076923076923075
216,4,4,0,880232615,880232637,22,129,50,4.306532663316583
216,4,5,1,880232637,880232719,82,50,7,3.76056338028169
216,5,5,0,880232719,880232752,33,7,237,3.7315436241610738
216,5,5,0,880232752,880232768,16,237,475,3.956043956043956
216,5,4,-1,880232768,880232787,19,475,147,3.3142857142857145
216,4,5,1,880232787,880232812,25,147,150,3.803921568627451
216,5,4,-1,880232812,880232830,18,150,276,3.6036036036036037
216,4,3,-1,880232830,880232917,87,276,249,3.3275862068965516
216,3,4,1,880232917,880232953,36,249,763,3.347826086956522
216,4,3,-1,880232953,880232970,17,763,405,3.25
216,3,3,0,880232970,880233026,56,405,928,3.142857142857143
216,3,3,0,880233026,880233061,35,928,274,3.5609756097560976
216,3,2,-1,880233061,880233153,92,274,764,3.1176470588235294
216,2,3,1,880233153,880233253,100,764,824,2.590909090909091
216,3,2,-1,880233253,880233298,45,824,368,1.8823529411764706
216,2,5,3,880233298,880233608,310,368,56,4.051724137931035
216,5,4,-1,880233608,880233635,27,56,357,4.063291139240507
216,4,4,0,880233635,880233651,16,357,134,4.174603174603175
216,4,4,0,880233651,880233726,75,134,81,3.2857142857142856
216,4,4,0,880233726,880233810,84,81,531,3.7435897435897436
216,4,5,1,880233810,880233912,102,531,651,3.8627450980392157
216,5,4,-1,880233912,880234347,435,651,466,3.5
216,4,5,1,880234347,880234469,122,466,42,3.893617021276596
216,5,4,-1,880234469,880234639,170,42,144,3.9545454545454546
216,4,5,1,880234639,880235120,481,144,215,3.662921348314607
216,5,5,0,880235120,880235229,109,215,69,3.8015873015873014
216,5,3,-2,880235229,880235329,100,69,498,4.290909090909091
216,3,4,1,880235329,880235473,144,498,1101,3.793103448275862
216,4,4,0,880235473,880235546,73,1101,628,3.573529411764706
216,4,4,0,880235546,880235571,25,628,97,3.7282608695652173
216,4,3,-1,880235571,880235734,163,97,201,3.75
216,3,4,1,880235734,880244779,9045,201,673,3.393939393939394
216,4,4,0,880244779,880244802,23,673,153,3.7865168539325844
216,4,3,-1,880244802,880244803,1,153,226,3.378787878787879
216,3,4,1,880244803,880244870,67,226,234,3.7674418604651163
216,4,4,0,880244870,880244902,32,234,28,3.923076923076923
216,4,3,-1,880244902,880244972,70,28,189,3.88
216,3,3,0,880244972,880245029,57,189,658,3.393939393939394
216,3,5,2,880245029,880245075,46,658,188,3.625
216,5,3,-2,880245075,880245125,50,188,356,3.2
216,3,5,2,880245125,880245145,20,356,55,4.051282051282051
216,5,3,-2,880245145,880245165,20,55,416,3.3846153846153846
216,3,4,1,880245165,880245213,48,416,721,3.4583333333333335
216,4,1,-3,880245213,880245238,25,721,1035,3.03125
216,1,4,3,880245238,880245260,22,1035,747,3.5526315789473686
216,4,3,-1,880245260,880245291,31,747,569,2.4285714285714284
216,3,2,-1,880245291,881432430,1187139,569,402,3.3076923076923075
216,2,1,-1,881432430,881432453,23,402,577,1.7058823529411764
216,1,4,3,881432453,881432467,14,577,423,3.7016129032258065
216,4,4,0,881432467,881432501,34,423,286,3.442857142857143
216,4,4,0,881432501,881432523,22,286,204,3.6744186046511627
216,4,4,0,881432523,881432564,41,204,508,3.6923076923076925
216,4,4,0,881432564,881432609,45,508,1161,3.4
216,4,3,-1,881432609,881721843,289234,1161,67,3.106382978723404
216,3,2,-1,881721843,881721890,47,67,72,3.175438596491228
216,2,5,3,881721890,883981737,2259847,72,313,4.323076923076923
216,5,4,-1,883981737,883981859,122,313,182,3.842857142857143
216,4,4,0,883981859,883981877,18,182,216,3.8454545454545452
250,4,2,-2,878088970,878089033,63,288,324,3.2291666666666665
250,2,5,3,878089033,878089099,66,324,321,3.0172413793103448
250,5,2,-3,878089099,878089100,1,321,323,3.0
250,2,4,2,878089100,878089144,44,323,260,2.4716981132075473
250,4,2,-2,878089144,878089182,38,260,678,2.8181818181818183
250,2,2,0,878089182,878089202,20,678,991,2.4545454545454546
250,2,4,2,878089202,878089436,234,991,475,3.956043956043956
250,4,3,-1,878089436,878089467,31,475,933,2.5
250,3,4,1,878089467,878089547,80,933,222,3.578125
250,4,5,1,878089547,878089581,34,222,813,4.055555555555555
250,5,3,-2,878089581,878089628,47,813,117,3.689189189189189
250,3,4,1,878089628,878089677,49,117,129,3.744186046511628
250,4,4,0,878089677,878089716,39,129,7,3.76056338028169
250,4,2,-2,878089716,878089753,37,7,237,3.7315436241610738
250,2,5,3,878089753,878089786,33,237,100,4.0162162162162165
250,5,4,-1,878089786,878089881,95,100,127,4.162790697674419
250,4,4,0,878089881,878089921,40,127,116,3.6666666666666665
250,4,4,0,878089921,878089963,42,116,238,3.888888888888889
250,4,5,1,878089963,878090004,41,238,175,3.8354430379746836
250,5,2,-3,878090004,878090066,62,175,153,3.7865168539325844
250,2,4,2,878090066,878090114,48,153,628,3.573529411764706
250,4,4,0,878090114,878090253,139,628,202,3.730337078651685
250,4,2,-2,878090253,878090254,1,202,96,3.9130434782608696
250,2,5,3,878090254,878090365,111,96,98,4.240875912408759
250,5,5,0,878090365,878090414,49,98,480,4.283018867924528
250,5,5,0,878090414,878090499,85,480,95,3.8194444444444446
250,5,4,-1,878090499,878091735,1236,95,527,3.823529411764706
250,4,3,-1,878091735,878091736,1,527,234,3.7674418604651163
250,3,5,2,878091736,878091771,35,234,1426,4.0
250,5,4,-1,878091771,878091772,1,1426,469,3.6842105263157894
250,4,4,0,878091772,878091818,46,469,196,3.9404761904761907
250,4,5,1,878091818,878091869,51,196,191,4.168674698795181
250,5,4,-1,878091869,878091870,1,191,183,3.951219512195122
250,4,5,1,878091870,878091915,45,183,135,3.7974683544303796
250,5,4,-1,878091915,878091965,50,135,629,3.3333333333333335
250,4,5,1,878091965,878092002,37,629,969,3.8947368421052633
250,5,4,-1,878092002,878092059,57,969,378,3.6904761904761907
250,4,4,0,878092059,878092143,84,378,81,3.2857142857142856
250,4,4,0,878092143,878092144,1,81,159,3.3902439024390243
250,4,4,0,878092144,878092171,27,159,240,3.0350877192982457
250,4,2,-2,878092171,883262694,5170523,240,751,3.3896103896103895
250,2,3,1,883262694,883262792,98,751,328,3.4895833333333335
250,3,1,-2,883262792,883263007,215,328,687,2.1481481481481484
250,1,4,3,883263007,883263375,368,687,1161,3.4
250,4,2,-2,883263375,883263390,15,1161,248,3.746268656716418
250,2,4,2,883263390,883263439,49,248,1014,3.1
271,4,3,-1,885844495,885844547,52,242,311,3.761904761904762
271,3,4,1,885844547,885844666,119,311,289,2.988888888888889
271,4,2,-2,885844666,885844746,80,289,328,3.4895833333333335
271,2,2,0,885844746,885847280,2534,328,312,3.0
271,2,3,1,885847280,885847357,77,312,258,3.7547169811320753
271,3,2,-1,885847357,885847666,309,258,1282,3.3333333333333335
271,2,4,2,885847666,885847693,27,1282,275,4.087912087912088
271,4,4,0,885847693,885847714,21,275,277,3.6
271,4,4,0,885847714,885847738,24,277,9,3.8878504672897196
271,4,3,-1,885847738,885847763,25,9,1117,3.0
271,3,2,-1,885847763,885847800,37,1117,1120,3.1
271,2,4,2,885847800,885847901,101,1120,591,3.7169811320754715
271,4,4,0,885847901,885847926,25,591,847,3.7333333333333334
271,4,3,-1,885847926,885847927,1,847,221,3.6923076923076925
271,3,3,0,885847927,885847955,28,221,477,3.1666666666666665
271,3,3,0,885847955,885847956,1,477,284,3.1547619047619047
271,3,3,0,885847956,885847974,18,284,924,3.3703703703703702
271,3,3,0,885847974,885848014,40,924,274,3.5609756097560976
271,3,3,0,885848014,885848034,20,274,126,3.8620689655172415
271,3,3,0,885848034,885848062,28,126,125,3.5555555555555554
271,3,2,-1,885848062,885848102,40,125,1028,2.857142857142857
271,2,4,2,885848102,885848132,30,1028,866,3.3962264150943398
271,4,3,-1,885848132,885848153,21,866,815,3.135135135135135
271,3,2,-1,885848153,885848179,26,815,405,3.25
271,2,1,-1,885848179,885848218,39,405,130,1.8461538461538463
271,1,3,2,885848218,885848237,19,130,823,2.75
271,3,2,-1,885848237,885848238,1,823,410,3.0434782608695654
271,2,4,2,885848238,885848314,76,410,204,3.6744186046511627
271,4,5,1,885848314,885848343,29,204,187,4.215189873417722
271,5,5,0,885848343,885848373,30,187,521,3.787878787878788
271,5,4,-1,885848373,885848447,74,521,210,3.921259842519685
271,4,4,0,885848447,885848475,28,210,480,4.283018867924528
271,4,5,1,885848475,885848518,43,480,22,4.215909090909091
271,5,5,0,885848518,885848519,1,22,482,3.9444444444444446
271,5,3,-2,885848519,885848559,40,482,481,3.8421052631578947
271,3,4,1,885848559,885848584,25,481,651,3.8627450980392157
271,4,5,1,885848584,885848615,31,651,520,4.136363636363637
271,5,4,-1,885848615,885848616,1,520,198,4.04
271,4,5,1,885848616,885848640,24,198,234,3.7674418604651163
271,5,4,-1,885848640,885848672,32,234,79,3.956989247311828
271,4,3,-1,885848672,885848707,35,79,470,3.72
271,3,4,1,885848707,885848770,63,470,8,3.903225806451613
271,4,3,-1,885848770,885848802,32,8,87,3.9
271,3,5,2,885848802,885848827,25,87,170,4.242424242424242
271,5,3,-2,885848827,885848863,36,170,136,3.764705882352941
271,3,4,1,885848863,885848886,23,136,490,3.5454545454545454
271,4,4,0,885848886,885848915,29,490,186,3.905263157894737
271,4,4,0,885848915,885848916,1,186,208,3.8125
271,4,2,-2,885848916,885848943,27,208,630,3.25
271,2,4,2,885848943,885848997,54,630,956,3.5714285714285716
271,4,4,0,885848997,885849025,28,956,202,3.730337078651685
271,4,4,0,885849025,885849052,27,202,705,3.7857142857142856
271,4,3,-1,885849052,885849087,35,705,178,4.378378378378378
271,3,3,0,885849087,885849113,26,178,81,3.2857142857142856
271,3,4,1,885849113,885849114,1,81,141,3.4827586206896552
271,4,5,1,885849114,885849164,50,141,211,3.958904109589041
271,5,5,0,885849164,885849188,24,211,526,3.909090909090909
271,5,3,-2,885849188,885849207,19,526,241,3.5625
271,3,4,1,885849207,885849231,24,241,549,3.4871794871794872
271,4,5,1,885849231,885849275,44,549,265,3.710144927536232
271,5,3,-2,885849275,885849325,50,265,58,3.543859649122807
271,3,5,2,885849325,885849356,31,58,200,3.8157894736842106
271,5,4,-1,885849356,885849386,30,200,51,3.5277777777777777
271,4,4,0,885849386,885849447,61,51,516,4.055555555555555
271,4,4,0,885849447,885849470,23,516,414,3.3076923076923075
271,4,4,0,885849470,885849490,20,414,466,3.5
271,4,3,-1,885849490,885849510,20,466,649,3.625
271,3,4,1,885849510,885849536,26,649,792,3.793103448275862
271,4,1,-3,885849536,885849558,22,792,40,2.7037037037037037
271,1,2,1,885849558,885849606,48,40,951,2.6666666666666665
271,2,2,0,885849606,885849648,42,951,38,2.784313725490196
271,2,3,1,885849648,885849707,59,38,1139,2.611111111111111
271,3,3,0,885849707,885849742,35,1139,570,3.526315789473684
271,3,4,1,885849742,885849791,49,570,402,3.3076923076923075
271,4,3,-1,885849791,885849817,26,402,43,3.1
271,3,2,-1,885849817,885849895,78,43,1411,2.4615384615384617
271,2,3,1,885849895,886106003,256108,1411,117,3.689189189189189
271,3,3,0,886106003,886106038,35,117,1,3.902439024390244
271,3,2,-1,886106038,886106039,1,1,244,2.9411764705882355
271,2,4,2,886106039,886106129,90,244,248,3.746268656716418
271,4,2,-2,886106129,886106165,36,248,472,2.984375
271,2,3,1,886106165,886106209,44,472,742,3.5555555555555554
265,4,2,-2,875320052,875320084,32,294,688,2.111111111111111
265,2,4,2,875320084,875320112,28,688,245,3.056179775280899
265,4,2,-2,875320112,875320180,68,245,181,3.98974358974359
265,2,5,3,875320180,875320332,152,181,117,3.689189189189189
265,5,3,-2,875320332,875320371,39,117,477,3.1666666666666665
265,3,2,-1,875320371,875320398,27,477,50,4.306532663316583
265,2,3,1,875320398,875320462,64,50,1016,3.559322033898305
265,3,2,-1,875320462,875320487,25,1016,676,3.3142857142857145
265,2,4,2,875320487,875320516,29,676,628,3.573529411764706
265,4,3,-1,875320516,875320542,26,628,472,2.984375
265,3,3,0,875320542,875320574,32,472,15,3.725663716814159
265,3,5,2,875320574,875320601,27,15,100,4.0162162162162165
265,5,4,-1,875320601,875320633,32,100,410,3.0434782608695654
265,4,4,0,875320633,875320661,28,410,293,3.630434782608696
265,4,2,-2,875320661,875320689,28,293,7,3.76056338028169
265,2,5,3,875320689,875320714,25,7,282,3.610526315789474
198,4,2,-2,884204501,884204637,136,258,323,3.0
198,2,3,1,884204637,884204666,29,323,343,3.0
198,3,3,0,884204666,884204709,43,343,682,3.0476190476190474
198,3,3,0,884204709,884204993,284,682,222,3.578125
198,3,4,1,884204993,884205081,88,222,1,3.902439024390244
198,4,5,1,884205081,884205114,33,1,1142,4.0476190476190474
198,5,3,-2,884205114,884205185,71,1142,15,3.725663716814159
198,3,2,-1,884205185,884205219,34,15,291,3.2
198,2,4,2,884205219,884205252,33,291,137,3.9545454545454546
198,4,2,-2,884205252,884205277,25,137,249,3.3275862068965516
198,2,3,1,884205277,884205317,40,249,276,3.6036036036036037
198,3,3,0,884205317,884205346,29,276,93,3.5641025641025643
198,3,3,0,884205346,884206330,984,93,121,3.521212121212121
198,3,3,0,884206330,884206401,71,121,148,3.2131147540983607
198,3,2,-1,884206401,884206428,27,148,405,3.25
198,2,3,1,884206428,884206482,54,405,763,3.347826086956522
198,3,2,-1,884206482,884206513,31,763,118,3.2764227642276422
198,2,2,0,884206513,884206587,74,118,823,2.75
198,2,2,0,884206587,884206659,72,823,1244,2.7777777777777777
198,2,1,-1,884206659,884206806,147,1244,369,2.5714285714285716
198,1,1,0,884206806,884206807,1,369,122,2.282608695652174
198,1,2,1,884206807,884206847,40,122,824,2.590909090909091
198,2,4,2,884206847,884207009,162,824,427,4.2025316455696204
198,4,3,-1,884207009,884207058,49,427,156,4.017857142857143
198,3,4,1,884207058,884207136,78,156,176,3.967032967032967
198,4,3,-1,884207136,884207206,70,176,228,3.7246376811594204
198,3,4,1,884207206,884207239,33,228,480,4.283018867924528
198,4,5,1,884207239,884207298,59,480,474,4.172413793103448
198,5,1,-4,884207298,884207325,27,474,100,4.0162162162162165
198,1,4,3,884207325,884207392,67,100,11,3.8904109589041096
198,4,4,0,884207392,884207424,32,11,651,3.8627450980392157
198,4,3,-1,884207424,884207492,68,651,498,4.290909090909091
198,3,3,0,884207492,884207525,33,498,55,4.051282051282051
198,3,4,1,884207525,884207560,35,55,318,4.5046728971962615
198,4,3,-1,884207560,884207584,24,318,204,3.6744186046511627
198,3,4,1,884207584,884207612,28,204,210,3.921259842519685
198,4,4,0,884207612,884207654,42,210,198,4.04
198,4,4,0,884207654,884207733,79,198,238,3.888888888888889
198,4,3,-1,884207733,884207734,1,238,693,3.6285714285714286
198,3,4,1,884207734,884207858,124,693,153,3.7865168539325844
198,4,3,-1,884207858,884207897,39,153,31,3.642857142857143
198,3,4,1,884207897,884207946,49,31,182,3.842857142857143
198,4,5,1,884207946,884208061,115,182,135,3.7974683544303796
198,5,4,-1,884208061,884208098,37,135,215,3.662921348314607
198,4,3,-1,884208098,884208173,75,215,58,3.543859649122807
198,3,5,2,884208173,884208200,27,58,188,3.625
198,5,3,-2,884208200,884208273,73,188,381,3.2758620689655173
198,3,4,1,884208273,884208326,53,381,511,4.096153846153846
198,4,2,-2,884208326,884208377,51,511,692,3.56
198,2,3,1,884208377,884208419,42,692,71,3.6575342465753424
198,3,3,0,884208419,884208455,36,71,51,3.5277777777777777
198,3,4,1,884208455,884208490,35,51,216,3.8454545454545452
198,4,4,0,884208490,884208491,1,216,23,3.9047619047619047
198,4,3,-1,884208491,884208518,27,23,549,3.4871794871794872
198,3,3,0,884208518,884208571,53,549,470,3.72
198,3,5,2,884208571,884208623,52,470,89,3.9615384615384617
198,5,4,-1,884208623,884208624,1,89,660,3.71875
198,4,3,-1,884208624,884208651,27,660,640,2.75
198,3,4,1,884208651,884208682,31,640,191,4.168674698795181
198,4,4,0,884208682,884208710,28,191,509,3.7058823529411766
198,4,3,-1,884208710,884208739,29,509,559,3.477272727272727
198,3,4,1,884208739,884208834,95,559,1169,4.0
198,4,3,-1,884208834,884208876,42,1169,518,3.5833333333333335
198,3,3,0,884208876,884208951,75,518,143,3.56
198,3,3,0,884208951,884208952,1,143,131,3.731707317073171
198,3,3,0,884208952,884209147,195,131,402,3.3076923076923075
198,3,4,1,884209147,884209221,74,402,629,3.3333333333333335
198,4,3,-1,884209221,884209264,43,629,185,3.9726027397260273
198,3,3,0,884209264,884209291,27,185,33,3.2941176470588234
198,3,3,0,884209291,884209353,62,33,636,3.4146341463414633
198,3,3,0,884209353,884209379,26,636,367,3.4242424242424243
198,3,3,0,884209379,884209412,33,367,939,3.6333333333333333
198,3,3,0,884209412,884209451,39,939,82,3.6741573033707864
198,3,3,0,884209451,884209504,53,82,581,3.130434782608696
198,3,5,2,884209504,884209569,65,581,101,3.4827586206896552
168,4,3,-1,884286863,884286990,127,258,323,3.0
168,3,5,2,884286990,884287011,21,323,300,3.6861313868613137
168,5,1,-4,884287011,884287073,62,300,325,2.625
168,1,1,0,884287073,884287109,36,325,678,2.8181818181818183
168,1,2,1,884287109,884287145,36,678,988,2.5555555555555554
168,2,5,3,884287145,884287318,173,988,117,3.689189189189189
168,5,5,0,884287318,884287509,191,117,1,3.902439024390244
168,5,3,-2,884287509,884287536,27,1,619,3.4782608695652173
168,3,3,0,884287536,884287560,24,619,1278,3.8333333333333335
168,3,2,-1,884287560,884287614,54,1278,924,3.3703703703703702
168,2,4,2,884287614,884287615,1,924,295,3.769230769230769
168,4,4,0,884287615,884287668,53,295,845,3.661290322580645
168,4,4,0,884287668,884287731,63,845,121,3.521212121212121
168,4,3,-1,884287731,884287759,28,121,685,3.2666666666666666
168,3,3,0,884287759,884287822,63,685,123,3.297872340425532
168,3,4,1,884287822,884287865,43,123,274,3.5609756097560976
168,4,4,0,884287865,884288009,144,274,118,3.2764227642276422
168,4,2,-2,884288009,884288033,24,118,763,3.347826086956522
168,2,5,3,884288033,884288058,25,763,151,3.6544117647058822
168,5,2,-3,884288058,884288080,22,151,1047,2.6923076923076925
168,2,2,0,884288080,884288112,32,1047,284,3.1547619047619047
168,2,2,0,884288112,884288178,66,284,473,2.9166666666666665
168,2,3,1,884288178,884288243,65,473,930,2.793103448275862
168,3,2,-1,884288243,884288270,27,930,235,3.106382978723404
168,2,1,-1,884288270,884288304,34,235,252,2.911392405063291
110,5,3,-2,886987183,886987236,53,313,905,3.357142857142857
110,3,4,1,886987236,886987260,24,905,307,3.6031746031746033
110,4,3,-1,886987260,886987287,27,307,332,3.6511627906976742
110,3,4,1,886987287,886987288,1,332,333,3.546666666666667
110,4,4,0,886987288,886987354,66,333,682,3.0476190476190474
110,4,4,0,886987354,886987417,63,682,326,3.262295081967213
110,4,3,-1,886987417,886987442,25,326,327,3.5076923076923077
110,3,2,-1,886987442,886987505,63,327,873,2.7586206896551726
110,2,3,1,886987505,886987540,35,873,294,3.1052631578947367
110,3,1,-2,886987540,886987605,65,294,688,2.111111111111111
110,1,4,3,886987605,886987726,121,688,315,4.15
110,4,4,0,886987726,886987860,134,315,69,3.8015873015873014
110,4,4,0,886987860,886987922,62,69,11,3.8904109589041096
110,4,4,0,886987922,886987952,30,11,423,3.7016129032258065
110,4,4,0,886987952,886987978,26,423,196,3.9404761904761907
110,4,3,-1,886987978,886988018,40,196,732,3.6266666666666665
110,3,4,1,886988018,886988042,24,732,939,3.6333333333333333
110,4,3,-1,886988042,886988100,58,939,43,3.1
110,3,2,-1,886988100,886988134,34,43,1055,3.125
110,2,2,0,886988134,886988250,116,1055,808,2.4444444444444446
110,2,4,2,886988250,886988293,43,808,402,3.3076923076923075
110,4,3,-1,886988293,886988341,48,402,366,3.4285714285714284
110,3,3,0,886988341,886988374,33,366,29,2.5714285714285716
110,3,2,-1,886988374,886988413,39,29,1247,1.5
110,2,4,2,886988413,886988449,36,1247,96,3.9130434782608696
110,4,4,0,886988449,886988480,31,96,684,3.847826086956522
110,4,3,-1,886988480,886988536,56,684,226,3.378787878787879
110,3,4,1,886988536,886988574,38,226,188,3.625
110,4,5,1,886988574,886988631,57,188,161,3.5844155844155843
110,5,2,-3,886988631,886988664,33,161,1231,2.7
110,2,3,1,886988664,886988689,25,1231,1228,2.5
110,3,3,0,886988689,886988750,61,1228,230,3.3518518518518516
110,3,3,0,886988750,886988793,43,230,779,2.2
110,3,3,0,886988793,886988818,25,779,1250,1.6
110,3,3,0,886988818,886988850,32,1250,759,2.6
110,3,4,1,886988850,886988873,23,759,421,3.462962962962963
110,4,4,0,886988873,886988909,36,421,451,3.207792207792208
110,4,4,0,886988909,886988937,28,451,692,3.56
110,4,3,-1,886988937,886988967,30,692,783,2.388888888888889
110,3,3,0,886988967,886989028,61,783,722,2.9642857142857144
110,3,3,0,886989028,886989126,98,722,1248,3.0
110,3,3,0,886989126,886989191,65,1248,1210,2.7142857142857144
110,3,3,0,886989191,886989276,85,1210,204,3.6744186046511627
110,3,3,0,886989276,886989340,64,204,238,3.888888888888889
110,3,3,0,886989340,886989363,23,238,63,3.125
110,3,3,0,886989363,886989399,36,63,401,2.6774193548387095
110,3,2,-1,886989399,886989440,41,401,715,3.257142857142857
110,2,2,0,886989440,886989473,33,715,791,3.0
110,2,2,0,886989473,886989524,51,791,384,2.7941176470588234
110,2,3,1,886989524,886989612,88,384,1249,3.2
110,3,2,-1,886989612,886989613,1,1249,1246,2.0
58,4,5,1,884304328,884304377,49,50,408,4.4772727272727275
58,5,4,-1,884304377,884304396,19,408,237,3.7315436241610738
58,4,5,1,884304396,884304409,13,237,116,3.6666666666666665
58,5,5,0,884304409,884304430,21,116,813,4.055555555555555
58,5,3,-2,884304430,884304447,17,813,181,3.98974358974359
58,3,5,2,884304447,884304483,36,181,124,4.052631578947368
58,5,4,-1,884304483,884304503,20,124,127,4.162790697674419
58,4,4,0,884304503,884304519,16,127,284,3.1547619047619047
58,4,1,-3,884304519,884304538,19,284,20,3.375
58,1,4,3,884304538,884304570,32,20,25,3.3185840707964602
58,4,5,1,884304570,884304609,39,25,475,3.956043956043956
58,5,4,-1,884304609,884304627,18,475,1012,3.2916666666666665
58,4,4,0,884304627,884304638,11,1012,111,3.5106382978723403
58,4,4,0,884304638,884304656,18,111,222,3.578125
58,4,4,0,884304656,884304701,45,222,182,3.842857142857143
58,4,2,-2,884304701,884304728,27,182,663,3.948717948717949
58,2,4,2,884304728,884304747,19,663,98,4.240875912408759
58,4,5,1,884304747,884304766,19,98,134,4.174603174603175
58,5,5,0,884304766,884304767,1,134,640,2.75
58,5,3,-2,884304767,884304790,23,640,189,3.88
58,3,5,2,884304790,884304812,22,189,32,3.7222222222222223
58,5,5,0,884304812,884304865,53,32,655,3.7857142857142856
58,5,5,0,884304865,884304895,30,655,12,4.358974358974359
58,5,5,0,884304895,884304896,1,12,153,3.7865168539325844
58,5,5,0,884304896,884304955,59,153,156,4.017857142857143
58,5,5,0,884304955,884304979,24,156,511,4.096153846153846
58,5,5,0,884304979,884305019,40,511,11,3.8904109589041096
58,5,4,-1,884305019,884305042,23,11,210,3.921259842519685
58,4,4,0,884305042,884305062,20,210,955,3.2666666666666666
58,4,3,-1,884305062,884305087,25,955,318,4.5046728971962615
58,3,2,-1,884305087,884305123,36,318,497,3.35
58,2,5,3,884305123,884305150,27,497,1103,3.5555555555555554
58,5,5,0,884305150,884305165,15,1103,558,3.75
58,5,5,0,884305165,884305185,20,558,238,3.888888888888889
58,5,3,-2,884305185,884305220,35,238,480,4.283018867924528
58,3,3,0,884305220,884305241,21,480,463,3.6818181818181817
58,3,5,2,884305241,884305271,30,463,61,4.190476190476191
58,5,5,0,884305271,884305295,24,61,64,4.373737373737374
58,5,3,-2,884305295,884305321,26,64,732,3.6266666666666665
58,3,3,0,884305321,884305338,17,732,216,3.8454545454545452
58,3,5,2,884305338,884305353,15,216,173,4.1441441441441444
58,5,5,0,884305353,884305369,16,173,56,4.051724137931035
58,5,4,-1,884305369,884305708,339,56,340,3.7419354838709675
58,4,1,-3,884305708,884663351,357643,340,69,3.8015873015873014
58,1,5,4,884663351,884663379,28,69,171,4.090909090909091
58,5,4,-1,884663379,884794774,131395,171,248,3.746268656716418
58,4,2,-2,884794774,891611593,6816819,248,496,4.094594594594595
58,2,2,0,891611593,892242047,630454,496,405,3.25
58,2,2,0,892242047,892242159,112,405,741,3.3043478260869565
58,2,1,-1,892242159,892242190,31,741,1048,2.857142857142857
58,1,4,3,892242190,892242272,82,1048,249,3.3275862068965516
58,4,1,-3,892242272,892242419,147,249,823,2.75
58,1,4,3,892242419,892242478,59,823,240,3.0350877192982457
58,4,1,-3,892242478,892242818,340,240,1089,2.1363636363636362
58,1,1,0,892242818,892242891,73,1089,1102,2.6
58,1,5,4,892242891,892243053,162,1102,367,3.4242424242424243
58,5,2,-3,892243053,892243079,26,367,1099,3.7142857142857144
237,4,3,-1,879376327,879376328,1,98,176,3.967032967032967
237,3,5,2,879376328,879376381,53,176,169,4.548387096774194
237,5,5,0,879376381,879376434,53,169,408,4.4772727272727275
237,5,4,-1,879376434,879376487,53,408,423,3.7016129032258065
237,4,4,0,879376487,879376553,66,423,494,3.8333333333333335
237,4,4,0,879376553,879376641,88,494,179,3.8823529411764706
237,4,5,1,879376641,879376671,30,179,127,4.162790697674419
237,5,4,-1,879376671,879376698,27,127,498,4.290909090909091
237,4,4,0,879376698,879376730,32,498,656,3.75
237,4,4,0,879376730,879376773,43,656,174,4.253521126760563
94,3,5,2,885870057,885870115,58,69,483,4.475609756097561
94,5,5,0,885870115,885870231,116,483,190,4.233333333333333
94,5,3,-2,885870231,885870284,53,190,89,3.9615384615384617
94,3,5,2,885870284,885870322,38,89,474,4.172413793103448
94,5,4,-1,885870322,885870323,1,474,1,3.902439024390244
94,4,5,1,885870323,885870362,39,1,64,4.373737373737374
94,5,4,-1,885870362,885870418,56,64,435,3.8933333333333335
94,4,4,0,885870418,885870577,159,435,42,3.893617021276596
94,4,5,1,885870577,885870612,35,42,504,4.085714285714285
94,5,4,-1,885870612,885870613,1,504,175,3.8354430379746836
94,4,4,0,885870613,885872758,2145,175,173,4.1441441441441444
94,4,4,0,885872758,885872942,184,173,181,3.98974358974359
94,4,4,0,885872942,885873006,64,181,792,3.793103448275862
94,4,4,0,885873006,885873089,83,792,7,3.76056338028169
94,4,4,0,885873089,885873159,70,7,28,3.923076923076923
94,4,5,1,885873159,885873160,1,28,949,3.392857142857143
94,5,4,-1,885873160,885873302,142,949,423,3.7016129032258065
94,4,4,0,885873302,885873423,121,423,24,3.3728813559322033
94,4,5,1,885873423,885873684,261,24,185,3.9726027397260273
94,5,4,-1,885873684,886008354,134670,185,1147,3.4
94,4,5,1,886008354,886008390,36,1147,644,3.7
94,5,4,-1,886008390,886008459,69,644,210,3.921259842519685
94,4,5,1,886008459,886008764,305,210,45,4.130434782608695
94,5,5,0,886008764,886008791,27,45,154,3.6031746031746033
94,5,4,-1,886008791,891720540,5711749,154,686,3.9
94,4,4,0,891720540,891720570,30,686,176,3.967032967032967
94,4,3,-1,891720570,891720590,20,176,1101,3.793103448275862
94,3,4,1,891720590,891720643,53,1101,208,3.8125
94,4,5,1,891720643,891720712,69,208,508,3.6923076923076925
94,5,5,0,891720712,891720761,49,508,61,4.190476190476191
94,5,4,-1,891720761,891720827,66,61,76,3.1875
94,4,4,0,891720827,891720862,35,76,655,3.7857142857142856
94,4,5,1,891720862,891720921,59,655,357,4.063291139240507
94,5,5,0,891720921,891720950,29,357,631,3.581818181818182
94,5,5,0,891720950,891720971,21,631,86,3.869565217391304
94,5,5,0,891720971,891720996,25,86,484,4.116279069767442
94,5,5,0,891720996,891721026,30,484,52,3.727272727272727
94,5,4,-1,891721026,891721048,22,52,469,3.6842105263157894
94,4,4,0,891721048,891721078,30,469,433,3.8035714285714284
94,4,4,0,891721078,891721142,64,433,192,4.090909090909091
94,4,4,0,891721142,891721167,25,192,652,3.9642857142857144
94,4,5,1,891721167,891721168,1,652,238,3.888888888888889
94,5,4,-1,891721168,891721192,24,238,98,4.240875912408759
94,4,3,-1,891721192,891721216,24,98,732,3.6266666666666665
94,3,2,-1,891721216,891721238,22,732,226,3.378787878787879
94,2,3,1,891721238,891721258,20,226,222,3.578125
94,3,4,1,891721258,891721286,28,222,629,3.3333333333333335
94,4,4,0,891721286,891721317,31,629,420,3.5652173913043477
94,4,4,0,891721317,891721351,34,420,636,3.4146341463414633
94,4,4,0,891721351,891721352,1,636,741,3.3043478260869565
94,4,4,0,891721352,891721378,26,741,201,3.75
94,4,4,0,891721378,891721414,36,201,421,3.462962962962963
94,4,4,0,891721414,891721439,25,421,443,3.8421052631578947
94,4,4,0,891721439,891721494,55,443,410,3.0434782608695654
94,4,4,0,891721494,891721562,68,410,447,3.46875
94,4,3,-1,891721562,891721584,22,447,232,3.0789473684210527
94,3,3,0,891721584,891721615,31,232,419,3.8208955223880596
94,3,5,2,891721615,891721642,27,419,506,3.566666666666667
94,5,3,-2,891721642,891721684,42,506,393,3.5125
94,3,5,2,891721684,891721716,32,393,151,3.6544117647058822
94,5,4,-1,891721716,891721777,61,151,559,3.477272727272727
94,4,2,-2,891721777,891721815,38,559,121,3.521212121212121
94,2,3,1,891721815,891721889,74,121,90,3.0
94,3,3,0,891721889,891721919,30,90,33,3.2941176470588234
94,3,2,-1,891721919,891721975,56,33,385,3.6129032258064515
94,2,5,3,891721975,891722006,31,385,91,3.6
94,5,3,-2,891722006,891722174,168,91,583,3.4285714285714284
94,3,3,0,891722174,891722214,40,583,951,2.6666666666666665
94,3,4,1,891722214,891722278,64,951,186,3.905263157894737
94,4,3,-1,891722278,891722338,60,186,943,3.6666666666666665
94,3,4,1,891722338,891722382,44,943,386,2.769230769230769
94,4,3,-1,891722382,891722383,1,386,365,2.95
94,3,4,1,891722383,891722432,49,365,68,3.5714285714285716
94,4,5,1,891722432,891722458,26,68,1211,3.5714285714285716
94,5,4,-1,891722458,891722482,24,1211,1118,3.533333333333333
94,4,4,0,891722482,891722511,29,1118,70,3.5833333333333335
94,4,3,-1,891722511,891722533,22,70,658,3.393939393939394
94,3,4,1,891722533,891722555,22,658,1044,3.2777777777777777
94,4,3,-1,891722555,891722576,21,1044,281,3.2
94,3,3,0,891722576,891722609,33,281,768,3.238095238095238
94,3,3,0,891722609,891722678,69,768,627,3.3823529411764706
94,3,3,0,891722678,891722758,80,627,282,3.610526315789474
94,3,3,0,891722758,891722760,2,282,380,3.4878048780487805
94,3,3,0,891722760,891722799,39,380,417,3.0588235294117645
94,3,4,1,891722799,891722801,2,417,1110,2.85
94,4,4,0,891722801,891722802,1,1110,399,3.317073170731707
94,4,4,0,891722802,891722843,41,399,206,3.0
94,4,4,0,891722843,891722845,2,206,1009,3.2962962962962963
94,4,3,-1,891722845,891722882,37,1009,556,2.7142857142857144
94,3,3,0,891722882,891722933,51,556,62,3.048780487804878
94,3,3,0,891722933,891722934,1,62,233,3.323529411764706
94,3,5,2,891722934,891722939,5,233,448,3.466666666666667
94,5,1,-4,891722939,891723033,94,448,550,3.272727272727273
94,1,3,2,891723033,891723076,43,550,810,2.9473684210526314
94,3,3,0,891723076,891723081,5,810,159,3.3902439024390243
94,3,4,1,891723081,891723124,43,159,372,3.6666666666666665
94,4,2,-2,891723124,891723155,31,372,809,2.7058823529411766
94,2,2,0,891723155,891723156,1,809,739,3.391304347826087
94,2,1,-1,891723156,891723186,30,739,820,3.0444444444444443
94,1,3,2,891723186,891723188,2,820,403,3.298507462686567
94,3,4,1,891723188,891723190,2,403,997,2.7142857142857144
94,4,3,-1,891723190,891723217,27,997,946,3.1153846153846154
94,3,3,0,891723217,891723220,3,946,72,3.175438596491228
94,3,4,1,891723220,891723261,41,72,1119,3.5185185185185186
94,4,2,-2,891723261,891723262,1,1119,1046,3.3529411764705883
94,2,3,1,891723262,891723295,33,1046,731,3.4
94,3,3,0,891723295,891723296,1,731,800,3.2222222222222223
94,3,3,0,891723296,891723355,59,800,41,3.0625
94,3,2,-1,891723355,891723395,40,41,1028,2.857142857142857
94,2,2,0,891723395,891723397,2,1028,864,3.2142857142857144
94,2,2,0,891723397,891723427,30,864,700,2.7142857142857144
94,2,2,0,891723427,891723459,32,700,1209,2.3333333333333335
94,2,4,2,891723459,891723494,35,1209,451,3.207792207792208
94,4,2,-2,891723494,891723495,1,451,783,2.388888888888889
94,2,3,1,891723495,891723525,30,783,1188,2.45
94,3,2,-1,891723525,891723558,33,1188,738,3.0
94,2,1,-1,891723558,891723593,35,738,720,3.2
94,1,1,0,891723593,891723619,26,720,944,2.75
94,1,3,2,891723619,891723644,25,944,391,2.4285714285714284
94,3,2,-1,891723644,891723706,62,391,860,1.8
94,2,3,1,891723706,891723707,1,860,472,2.984375
94,3,2,-1,891723707,891723748,41,472,728,3.05
94,2,3,1,891723748,891723774,26,728,928,3.142857142857143
94,3,2,-1,891723774,891723807,33,928,155,3.0588235294117645
94,2,3,1,891723807,891723848,41,155,1222,2.6363636363636362
94,3,2,-1,891723848,891723883,35,1222,29,2.5714285714285716
94,2,2,0,891723883,891723931,48,29,808,2.4444444444444446
94,2,5,3,891723931,891724044,113,808,258,3.7547169811320753
94,5,4,-1,891724044,891724064,20,258,246,4.0
94,4,4,0,891724064,891724081,17,246,1226,3.5454545454545454
94,4,4,0,891724081,891724122,41,1226,286,3.442857142857143
94,4,3,-1,891724122,891724142,20,286,25,3.3185840707964602
94,3,4,1,891724142,891724178,36,25,257,3.7154471544715446
94,4,4,0,891724178,891724257,79,257,250,3.4698795180722892
94,4,4,0,891724257,891724282,25,250,93,3.5641025641025643
94,4,4,0,891724282,891724303,21,93,993,3.4838709677419355
94,4,4,0,891724303,891724341,38,993,248,3.746268656716418
94,4,2,-2,891724341,891724485,144,248,412,2.272727272727273
94,2,3,1,891724485,891724508,23,412,411,2.911764705882353
94,3,2,-1,891724508,891724691,183,411,932,2.5
94,2,2,0,891724691,891724747,56,932,930,2.793103448275862
94,2,3,1,891724747,891724798,51,930,1199,2.6666666666666665
94,3,2,-1,891724798,891724800,2,1199,829,2.4615384615384617
94,2,2,0,891724800,891724829,29,829,1089,2.1363636363636362
94,2,4,2,891724829,891724925,96,1089,313,4.323076923076923
94,4,5,1,891724925,891724950,25,313,347,3.59375
94,5,4,-1,891724950,891725009,59,347,343,3.0
94,4,4,0,891725009,891725030,21,343,338,2.75
94,4,2,-2,891725030,891725049,19,338,260,2.4716981132075473
94,2,2,0,891725049,891725090,41,260,355,2.75
94,2,5,3,891725090,891725332,242,355,157,3.5714285714285716
94,5,5,0,891725332,891725333,1,157,390,4.0
94,5,5,0,891725333,891725362,29,390,170,4.242424242424242
94,5,4,-1,891725362,891725410,48,170,346,3.5128205128205128
94,4,3,-1,891725410,891725440,30,346,334,3.4210526315789473
94,3,4,1,891725440,891928703,203263,334,690,3.260869565217391
128,2,5,3,879966299,879966355,56,258,300,3.6861313868613137
128,5,4,-1,879966355,879966376,21,300,294,3.1052631578947367
128,4,2,-2,879966376,879966406,30,294,328,3.4895833333333335
128,2,2,0,879966406,879966447,41,328,322,3.0476190476190474
128,2,1,-1,879966447,879966524,77,322,873,2.7586206896551726
128,1,3,2,879966524,879966603,79,873,652,3.9642857142857144
128,3,5,2,879966603,879966729,126,652,283,3.901639344262295
128,5,5,0,879966729,879966756,27,283,173,4.1441441441441444
128,5,5,0,879966756,879966785,29,173,483,4.475609756097561
128,5,5,0,879966785,879966839,54,483,603,4.315789473684211
128,5,4,-1,879966839,879966867,28,603,69,3.8015873015873014
128,4,5,1,879966867,879966895,28,69,186,3.905263157894737
128,5,4,-1,879966895,879966919,24,186,1,3.902439024390244
128,4,5,1,879966919,879966983,64,1,651,3.8627450980392157
128,5,5,0,879966983,879967016,33,651,275,4.087912087912088
128,5,2,-3,879967016,879967047,31,275,1063,3.642857142857143
128,2,3,1,879967047,879967102,55,1063,497,3.35
128,3,5,2,879967102,879967136,34,497,588,3.8358208955223883
128,5,3,-2,879967136,879967197,61,588,742,3.5555555555555554
128,3,5,2,879967197,879967225,28,742,496,4.094594594594595
128,5,5,0,879967225,879967248,23,496,133,3.7777777777777777
128,5,3,-2,879967248,879967268,20,133,419,3.8208955223880596
128,3,3,0,879967268,879967300,32,419,213,3.943396226415094
128,3,5,2,879967300,879967341,41,213,14,4.101694915254237
128,5,3,-2,879967341,879967367,26,14,416,3.3846153846153846
128,3,4,1,879967367,879967432,65,416,482,3.9444444444444446
128,4,2,-2,879967432,879967576,144,482,1192,3.0
128,2,5,3,879967576,879967631,55,1192,117,3.689189189189189
128,5,5,0,879967631,879967691,60,117,83,4.204081632653061
128,5,4,-1,879967691,879967729,38,83,633,3.9
128,4,4,0,879967729,879967767,38,633,48,4.055555555555555
128,4,5,1,879967767,879967804,37,48,378,3.6904761904761907
128,5,4,-1,879967804,879967840,36,378,99,3.8392857142857144
128,4,3,-1,879967840,879967879,39,99,614,3.727272727272727
128,3,4,1,879967879,879967966,87,614,423,3.7016129032258065
128,4,4,0,879967966,879968029,63,423,317,3.774193548387097
128,4,3,-1,879968029,879968096,67,317,705,3.7857142857142856
128,3,4,1,879968096,879968125,29,705,238,3.888888888888889
128,4,5,1,879968125,879968185,60,238,82,3.6741573033707864
128,5,2,-3,879968185,879968243,58,82,785,3.4375
128,2,3,1,879968243,879968279,36,785,1221,3.4285714285714284
128,3,4,1,879968279,879968308,29,1221,140,3.238095238095238
128,4,4,0,879968308,879968332,24,140,622,3.3333333333333335
128,4,1,-3,879968332,879968352,20,622,220,3.433333333333333
128,1,4,3,879968352,879968390,38,220,159,3.3902439024390243
128,4,2,-2,879968390,879968415,25,159,660,3.71875
128,2,4,2,879968415,879968447,32,660,417,3.0588235294117645
128,4,3,-1,879968447,879968494,47,417,1053,3.3846153846153846
128,3,4,1,879968494,879968544,50,1053,568,3.5853658536585367
128,4,2,-2,879968544,879968579,35,568,202,3.730337078651685
128,2,3,1,879968579,879968663,84,202,284,3.1547619047619047
128,3,4,1,879968663,879968718,55,284,763,3.347826086956522
128,4,3,-1,879968718,879968742,24,763,747,3.5526315789473686
128,3,2,-1,879968742,879968774,32,747,387,3.5357142857142856
128,2,2,0,879968774,879968858,84,387,1048,2.857142857142857
128,2,4,2,879968858,879968859,1,1048,405,3.25
128,4,5,1,879968859,879968896,37,405,118,3.2764227642276422
128,5,3,-2,879968896,879968921,25,118,1035,3.03125
128,3,4,1,879968921,879968946,25,1035,380,3.4878048780487805
128,4,4,0,879968946,879969032,86,380,26,3.36
128,4,3,-1,879969032,879969033,1,26,381,3.2758620689655173
128,3,4,1,879969033,879969084,51,381,274,3.5609756097560976
128,4,1,-3,879969084,879969136,52,274,402,3.3076923076923075
128,1,3,2,879969136,879969215,79,402,111,3.5106382978723403
128,3,3,0,879969215,879969244,29,111,218,3.5555555555555554
128,3,4,1,879969244,879969277,33,218,790,2.8518518518518516
128,4,3,-1,879969277,879969329,52,790,66,3.4705882352941178
128,3,4,1,879969329,879969349,20,66,739,3.391304347826087
44,4,3,-1,878340848,878340887,39,328,678,2.8181818181818183
44,3,4,1,878340887,878340905,18,678,260,2.4716981132075473
44,4,4,0,878340905,878340940,35,260,307,3.6031746031746033
44,4,5,1,878340940,878341246,306,307,7,3.76056338028169
44,5,4,-1,878341246,878341290,44,7,181,3.98974358974359
44,4,4,0,878341290,878341343,53,181,147,3.3142857142857145
44,4,4,0,878341343,878341370,27,147,151,3.6544117647058822
44,4,3,-1,878341370,878346470,5100,151,717,2.9696969696969697
44,3,3,0,878346470,878346575,105,717,24,3.3728813559322033
44,3,4,1,878346575,878346630,55,24,249,3.3275862068965516
44,4,5,1,878346630,878346709,79,249,250,3.4698795180722892
44,5,2,-3,878346709,878346748,39,250,252,2.911392405063291
44,2,2,0,878346748,878346789,41,252,21,2.9210526315789473
44,2,3,1,878346789,878346904,115,21,756,2.6885245901639343
44,3,4,1,878346904,878346946,42,756,121,3.521212121212121
44,4,4,0,878346946,878346997,51,121,240,3.0350877192982457
44,4,2,-2,878346997,878347076,79,240,106,2.8125
44,2,4,2,878347076,878347234,158,106,191,4.168674698795181
44,4,5,1,878347234,878347259,25,191,135,3.7974683544303796
44,5,5,0,878347259,878347340,81,135,318,4.5046728971962615
44,5,4,-1,878347340,878347392,52,318,143,3.56
44,4,2,-2,878347392,878347420,28,143,98,4.240875912408759
44,2,3,1,878347420,878347455,35,98,655,3.7857142857142856
44,3,5,2,878347455,878347504,49,655,168,4.0476190476190474
44,5,4,-1,878347504,878347569,65,168,185,3.9726027397260273
44,4,4,0,878347569,878347598,29,185,211,3.958904109589041
44,4,4,0,878347598,878347633,35,211,317,3.774193548387097
44,4,4,0,878347633,878347634,1,317,161,3.5844155844155843
44,4,5,1,878347634,878347662,28,161,174,4.253521126760563
44,5,4,-1,878347662,878347711,49,174,157,3.5714285714285716
44,4,4,0,878347711,878347742,31,157,588,3.8358208955223883
44,4,4,0,878347742,878347791,49,588,429,3.742857142857143
44,4,3,-1,878347791,878347818,27,429,644,3.7
44,3,3,0,878347818,878347847,29,644,946,3.1153846153846154
44,3,5,2,878347847,878347874,27,946,195,3.9072164948453607
44,5,5,0,878347874,878347915,41,195,660,3.71875
44,5,4,-1,878347915,878347942,27,660,22,4.215909090909091
44,4,4,0,878347942,878347972,30,22,175,3.8354430379746836
44,4,4,0,878347972,878348035,63,175,164,3.6140350877192984
44,4,4,0,878348035,878348036,1,164,274,3.5609756097560976
44,4,4,0,878348036,878348111,75,274,423,3.7016129032258065
44,4,4,0,878348111,878348521,410,423,172,4.225225225225225
44,4,3,-1,878348521,878348547,26,172,427,4.2025316455696204
44,3,2,-1,878348547,878348601,54,427,56,4.051724137931035
44,2,4,2,878348601,878348627,26,56,163,3.53125
44,4,3,-1,878348627,878348691,64,163,625,3.25
44,3,4,1,878348691,878348784,93,625,419,3.8208955223880596
44,4,4,0,878348784,878348885,101,419,82,3.6741573033707864
44,4,3,-1,878348885,878348947,62,82,155,3.0588235294117645
44,3,4,1,878348947,878348969,22,155,636,3.4146341463414633
44,4,4,0,878348969,878348998,29,636,31,3.642857142857143
44,4,4,0,878348998,883612356,5263358,31,294,3.1052631578947367
44,4,1,-3,883612356,883613298,942,294,737,3.12
44,1,4,3,883613298,883613334,36,737,227,3.169811320754717
44,4,2,-2,883613334,883613335,1,227,450,2.2758620689655173
44,2,4,2,883613335,883613372,37,450,183,3.951219512195122
264,3,3,0,886121516,886121517,1,294,873,2.7586206896551726
264,3,5,2,886121517,886121631,114,873,288,3.5214285714285714
264,5,2,-3,886121631,886121691,60,288,286,3.442857142857143
264,2,2,0,886121691,886121811,120,286,683,2.176470588235294
264,2,4,2,886121811,886122099,288,683,656,3.75
264,4,4,0,886122099,886122194,95,656,602,3.533333333333333
264,4,5,1,886122194,886122261,67,602,7,3.76056338028169
264,5,5,0,886122261,886122352,91,7,200,3.8157894736842106
264,5,5,0,886122352,886122447,95,200,558,3.75
264,5,5,0,886122447,886122508,61,558,654,4.119047619047619
264,5,2,-3,886122508,886122578,70,654,742,3.5555555555555554
264,2,3,1,886122578,886122644,66,742,33,3.2941176470588234
264,3,3,0,886122644,886122771,127,33,762,3.3962264150943398
264,3,3,0,886122771,886122892,121,762,137,3.9545454545454546
264,3,5,2,886122892,886123359,467,137,514,4.033333333333333
264,5,4,-1,886123359,886123415,56,514,1070,4.0
264,4,3,-1,886123415,886123530,115,1070,1225,2.5
264,3,4,1,886123530,886123531,1,1225,702,2.764705882352941
264,4,4,0,886123531,886123596,65,702,382,3.764705882352941
264,4,5,1,886123596,886123655,59,382,516,4.055555555555555
264,5,4,-1,886123655,886123727,72,516,1074,2.857142857142857
264,4,5,1,886123727,886123728,1,1074,186,3.905263157894737
264,5,4,-1,886123728,886124197,469,186,25,3.3185840707964602
264,4,4,0,886124197,886124352,155,25,240,3.0350877192982457
264,4,4,0,886124352,886124417,65,240,1009,3.2962962962962963
41,4,4,0,890686872,890687019,147,751,96,3.9130434782608696
41,4,4,0,890687019,890687087,68,96,153,3.7865168539325844
41,4,4,0,890687087,890687145,58,153,69,3.8015873015873014
41,4,2,-2,890687145,890687175,30,69,423,3.7016129032258065
41,2,4,2,890687175,890687264,89,423,174,4.253521126760563
41,4,2,-2,890687264,890687304,40,174,276,3.6036036036036037
41,2,4,2,890687304,890687305,1,276,486,3.9565217391304346
41,4,2,-2,890687305,890687326,21,486,202,3.730337078651685
41,2,3,1,890687326,890687353,27,202,58,3.543859649122807
41,3,4,1,890687353,890687374,21,58,98,4.240875912408759
41,4,3,-1,890687374,890687412,38,98,518,3.5833333333333335
41,3,5,2,890687412,890687472,60,518,238,3.888888888888889
41,5,3,-2,890687472,890687473,1,238,31,3.642857142857143
41,3,5,2,890687473,890687526,53,31,175,3.8354430379746836
41,5,3,-2,890687526,890687550,24,175,435,3.8933333333333335
41,3,4,1,890687550,890687571,21,435,188,3.625
41,4,3,-1,890687571,890687593,22,188,196,3.9404761904761907
41,3,4,1,890687593,890687713,120,196,170,4.242424242424242
82,4,3,-1,876311146,876311195,49,9,596,3.180327868852459
82,3,3,0,876311195,876311217,22,596,7,3.76056338028169
82,3,4,1,876311217,876311241,24,7,181,3.98974358974359
82,4,3,-1,876311241,876311280,39,181,919,4.0
82,3,5,2,876311280,876311299,19,919,100,4.0162162162162165
82,5,3,-2,876311299,876311319,20,100,237,3.7315436241610738
82,3,3,0,876311319,876311365,46,237,222,3.578125
82,3,4,1,876311365,876311387,22,222,121,3.521212121212121
82,4,3,-1,876311387,876311423,36,121,405,3.25
82,3,3,0,876311423,876311473,50,405,147,3.3142857142857145
82,3,3,0,876311473,876311492,19,147,274,3.5609756097560976
82,3,3,0,876311492,876311518,26,274,288,3.5214285714285714
82,3,2,-1,876311518,876311547,29,288,151,3.6544117647058822
82,2,2,0,876311547,876311577,30,151,1028,2.857142857142857
82,2,3,1,876311577,876311646,69,1028,826,2.5555555555555554
82,3,3,0,876311646,877452380,1140734,826,125,3.5555555555555554
82,3,2,-1,877452380,878768435,1316055,125,25,3.3185840707964602
82,2,3,1,878768435,878768510,75,25,118,3.2764227642276422
82,3,2,-1,878768510,878768615,105,118,13,3.5454545454545454
82,2,2,0,878768615,878768665,50,13,103,2.2
82,2,1,-1,878768665,878768741,76,103,756,2.6885245901639343
82,1,2,1,878768741,878768765,24,756,473,2.9166666666666665
82,2,3,1,878768765,878768790,25,473,225,3.0714285714285716
82,3,1,-2,878768790,878768811,21,225,424,1.4
82,1,2,1,878768811,878768840,29,424,220,3.433333333333333
82,2,3,1,878768840,878768882,42,220,597,3.2771084337349397
82,3,3,0,878768882,878768902,20,597,820,3.0444444444444443
82,3,2,-1,878768902,878769262,360,820,822,2.0
82,2,3,1,878769262,878769334,72,822,185,3.9726027397260273
82,3,5,2,878769334,878769373,39,185,523,4.159090909090909
82,5,4,-1,878769373,878769410,37,523,582,3.7457627118644066
82,4,4,0,878769410,878769442,32,582,514,4.033333333333333
82,4,1,-3,878769442,878769478,36,514,671,3.4285714285714284
82,1,5,4,878769478,878769479,1,671,603,4.315789473684211
82,5,3,-2,878769479,878769597,118,603,474,4.172413793103448
82,3,3,0,878769597,878769598,1,474,705,3.7857142857142856
82,3,3,0,878769598,878769629,31,705,228,3.7246376811594204
82,3,4,1,878769629,878769703,74,228,661,4.133333333333334
82,4,2,-2,878769703,878769777,74,661,127,4.162790697674419
82,2,4,2,878769777,878769815,38,127,211,3.958904109589041
82,4,4,0,878769815,878769847,32,211,197,4.112676056338028
82,4,5,1,878769847,878769848,1,197,660,3.71875
82,5,4,-1,878769848,878769888,40,660,70,3.5833333333333335
82,4,5,1,878769888,878769917,29,70,588,3.8358208955223883
82,5,3,-2,878769917,878769948,31,588,511,4.096153846153846
82,3,4,1,878769948,878769992,44,511,11,3.8904109589041096
82,4,3,-1,878769992,878770059,67,11,81,3.2857142857142856
82,3,2,-1,878770059,879788343,1018284,81,326,3.262295081967213
82,2,3,1,879788343,884713664,4925321,326,304,3.5306122448979593
82,3,3,0,884713664,884713704,40,304,539,2.6666666666666665
82,3,1,-2,884713704,884713755,51,539,343,3.0
82,1,1,0,884713755,884714145,390,343,458,3.0588235294117645
82,1,1,0,884714145,884714181,36,458,475,3.956043956043956
82,1,1,0,884714181,884714204,23,475,109,3.282608695652174
82,1,2,1,884714204,884714249,45,109,740,3.423076923076923
82,2,3,1,884714249,884714290,41,740,281,3.2
82,3,1,-2,884714290,884714361,71,281,1128,3.0
82,1,1,0,884714361,884714385,24,1128,240,3.0350877192982457
82,1,2,1,884714385,884714402,17,240,1134,2.888888888888889
82,2,1,-1,884714402,884714421,19,1134,409,2.9615384615384617
82,1,1,0,884714421,884714456,35,409,1059,2.764705882352941
82,1,1,0,884714456,884714492,36,1059,717,2.9696969696969697
82,1,1,0,884714492,884714513,21,717,412,2.272727272727273
82,1,1,0,884714513,884714560,47,412,1033,3.0
82,1,1,0,884714560,884714593,33,1033,413,2.5652173913043477
82,1,1,0,884714593,884714618,25,413,456,2.2
82,1,1,0,884714618,884714726,108,456,678,2.8181818181818183
262,3,3,0,879790603,879790741,138,252,278,3.0357142857142856
262,3,2,-1,879790741,879790783,42,278,235,3.106382978723404
262,2,3,1,879790783,879790816,33,235,255,3.2027027027027026
262,3,2,-1,879790816,879790906,90,255,293,3.630434782608696
262,2,3,1,879790906,879791031,125,293,929,2.8421052631578947
262,3,2,-1,879791031,879791049,18,929,546,2.9789473684210526
262,2,2,0,879791049,879791130,81,546,411,2.911764705882353
262,2,2,0,879791130,879791160,30,411,369,2.5714285714285716
262,2,2,0,879791160,879791216,56,369,473,2.9166666666666665
262,2,2,0,879791216,879791335,119,473,1048,2.857142857142857
262,2,2,0,879791335,879791471,136,1048,1013,2.388888888888889
262,2,2,0,879791471,879791536,65,1013,1054,2.5454545454545454
262,2,2,0,879791536,879791537,1,1054,1095,2.8
262,2,2,0,879791537,879791755,218,1095,195,3.9072164948453607
262,2,4,2,879791755,879791790,35,195,433,3.8035714285714284
262,4,3,-1,879791790,879791816,26,433,223,4.108695652173913
262,3,3,0,879791816,879791844,28,223,169,4.548387096774194
262,3,2,-1,879791844,879791875,31,169,172,4.225225225225225
262,2,3,1,879791875,879791948,73,172,86,3.869565217391304
262,3,4,1,879791948,879791999,51,86,427,4.2025316455696204
262,4,3,-1,879791999,879792027,28,427,443,3.8421052631578947
262,3,3,0,879792027,879792220,193,443,28,3.923076923076923
262,3,3,0,879792220,879792262,42,28,99,3.8392857142857144
262,3,4,1,879792262,879792402,140,99,496,4.094594594594595
262,4,3,-1,879792402,879792452,50,496,58,3.543859649122807
262,3,2,-1,879792452,879792604,152,58,955,3.2666666666666666
262,2,3,1,879792604,879792713,109,955,91,3.6
262,3,3,0,879792713,879792751,38,91,625,3.25
262,3,4,1,879792751,879792773,22,625,949,3.392857142857143
262,4,3,-1,879792773,879792818,45,949,217,3.1538461538461537
262,3,3,0,879792818,879792897,79,217,727,3.5517241379310347
262,3,5,2,879792897,879793022,125,727,318,4.5046728971962615
262,5,4,-1,879793022,879793075,53,318,588,3.8358208955223883
262,4,3,-1,879793075,879793164,89,588,185,3.9726027397260273
262,3,3,0,879793164,879793188,24,185,491,3.55
262,3,3,0,879793188,879793216,28,491,216,3.8454545454545452
262,3,3,0,879793216,879793346,130,216,153,3.7865168539325844
262,3,4,1,879793346,879793363,17,153,485,3.717948717948718
262,4,4,0,879793363,879793479,116,485,69,3.8015873015873014
262,4,3,-1,879793479,879793503,24,69,95,3.8194444444444446
262,3,4,1,879793503,879793536,33,95,631,3.581818181818182
262,4,4,0,879793536,879793597,61,631,11,3.8904109589041096
262,4,3,-1,879793597,879793667,70,11,781,3.4166666666666665
262,3,3,0,879793667,879793715,48,781,617,3.8
262,3,3,0,879793715,879793736,21,617,609,3.7058823529411766
262,3,4,1,879793736,879793854,118,609,735,3.58
262,4,4,0,879793854,879793897,43,735,65,3.511111111111111
262,4,4,0,879793897,879793938,41,65,655,3.7857142857142856
262,4,4,0,879793938,879793939,1,655,365,2.95
262,4,3,-1,879793939,879794113,174,365,568,3.5853658536585367
262,3,2,-1,879794113,879794140,27,568,393,3.5125
262,2,3,1,879794140,879794205,65,393,92,3.7142857142857144
262,3,3,0,879794205,879794223,18,92,418,3.825
262,3,3,0,879794223,879794267,44,418,432,3.719298245614035
262,3,3,0,879794267,879794338,71,432,66,3.4705882352941178
262,3,3,0,879794338,879794359,21,66,234,3.7674418604651163
262,3,4,1,879794359,879794419,60,234,660,3.71875
262,4,2,-2,879794419,879794635,216,660,140,3.238095238095238
262,2,3,1,879794635,879794667,32,140,581,3.130434782608696
262,3,2,-1,879794667,879794739,72,581,959,3.4583333333333335
262,2,3,1,879794739,879794829,90,959,736,4.083333333333333
262,3,3,0,879794829,879794887,58,736,821,3.076923076923077
262,3,3,0,879794887,879794918,31,821,200,3.8157894736842106
262,3,4,1,879794918,879794951,33,200,71,3.6575342465753424
262,4,4,0,879794951,879795059,108,71,402,3.3076923076923075
262,4,5,1,879795059,879795122,63,402,709,4.171428571428572
262,5,1,-4,879795122,879795155,33,709,145,2.3636363636363638
262,1,2,1,879795155,879795319,164,145,417,3.0588235294117645
262,2,3,1,879795319,879795379,60,417,790,2.8518518518518516
262,3,1,-2,879795379,879795430,51,790,567,3.272727272727273
262,1,3,2,879795430,879961283,165853,567,269,4.085106382978723
262,3,3,0,879961283,879961374,91,269,288,3.5214285714285714
262,3,3,0,879961374,879961438,64,288,332,3.6511627906976742
262,3,3,0,879961438,879961474,36,332,336,2.4
262,3,4,1,879961474,879961532,58,336,338,2.75
262,4,3,-1,879961532,879961882,350,338,125,3.5555555555555554
262,3,5,2,879961882,879961954,72,125,1014,3.1
262,5,4,-1,879961954,879961980,26,1014,275,4.087912087912088
262,4,4,0,879961980,879962052,72,275,845,3.661290322580645
262,4,3,-1,879962052,879962366,314,845,476,3.1216216216216215
262,3,2,-1,879962366,879962367,1,476,405,3.25
262,2,4,2,879962367,879962517,150,405,582,3.7457627118644066
262,4,4,0,879962517,879962542,25,582,923,4.142857142857143
262,4,4,0,879962542,879962570,28,923,179,3.8823529411764706
174,3,5,2,886432770,886432901,131,288,332,3.6511627906976742
174,5,5,0,886432901,886432989,88,332,937,3.5
174,5,5,0,886432989,886433166,177,937,126,3.8620689655172415
174,5,5,0,886433166,886433804,638,126,471,3.5714285714285716
174,5,4,-1,886433804,886433862,58,471,458,3.0588235294117645
174,4,4,0,886433862,886433881,19,458,244,2.9411764705882355
174,4,5,1,886433881,886433898,17,244,111,3.5106382978723403
174,5,1,-4,886433898,886433919,21,111,412,2.272727272727273
174,1,4,3,886433919,886433936,17,412,147,3.3142857142857145
174,4,5,1,886433936,886433981,45,147,248,3.746268656716418
174,5,5,0,886433981,886433996,15,248,846,3.1052631578947367
174,5,3,-2,886433996,886434013,17,846,151,3.6544117647058822
174,3,5,2,886434013,886434047,34,151,1086,3.857142857142857
174,5,4,-1,886434047,886434087,40,1086,696,3.138888888888889
174,4,5,1,886434087,886434114,27,696,255,3.2027027027027026
174,5,5,0,886434114,886434136,22,255,117,3.689189189189189
174,5,1,-4,886434136,886434166,30,117,871,2.3823529411764706
174,1,2,1,886434166,886434186,20,871,118,3.2764227642276422
174,2,2,0,886434186,886434187,1,118,1017,3.0
174,2,1,-1,886434187,886434241,54,1017,323,3.0
174,1,1,0,886434241,886434260,19,323,763,3.347826086956522
174,1,3,2,886434260,886434261,1,763,597,3.2771084337349397
174,3,4,1,886434261,886434343,82,597,764,3.1176470588235294
174,4,5,1,886434343,886434361,18,764,107,3.45
174,5,4,-1,886434361,886434376,15,107,823,2.75
174,4,1,-3,886434376,886434402,26,823,368,1.8823529411764706
174,1,4,3,886434402,886434484,82,368,1312,2.8333333333333335
174,4,5,1,886434484,886434547,63,1312,197,4.112676056338028
174,5,5,0,886434547,886434566,19,197,1262,5.0
174,5,1,-4,886434566,886434621,55,1262,168,4.0476190476190474
174,1,5,4,886434621,886439516,4895,168,216,3.8454545454545452
174,5,4,-1,886439516,886439537,21,216,239,3.423076923076923
174,4,5,1,886439537,886452583,13046,239,98,4.240875912408759
174,5,5,0,886452583,886513674,61091,98,716,3.1904761904761907
174,5,5,0,886513674,886513752,78,716,88,3.433734939759036
174,5,4,-1,886513752,886513767,15,88,155,3.0588235294117645
174,4,5,1,886513767,886513788,21,155,1041,3.3333333333333335
174,5,4,-1,886513788,886513896,108,1041,722,2.9642857142857144
174,4,5,1,886513896,886513947,51,722,178,4.378378378378378
174,5,5,0,886513947,886514069,122,178,125,3.5555555555555554
174,5,5,0,886514069,886514108,39,125,162,3.4651162790697674
174,5,5,0,886514108,886514123,15,162,65,3.511111111111111
174,5,5,0,886514123,886514168,45,65,655,3.7857142857142856
174,5,5,0,886514168,886514201,33,655,69,3.8015873015873014
174,5,5,0,886514201,886514220,19,69,699,3.736842105263158
174,5,5,0,886514220,886514243,23,699,708,3.3157894736842106
174,5,5,0,886514243,886514261,18,708,660,3.71875
174,5,3,-2,886514261,886514323,62,660,546,2.9789473684210526
174,3,5,2,886514323,886514398,75,546,1221,3.4285714285714284
174,5,3,-2,886514398,886514430,32,1221,1311,2.125
174,3,5,2,886514430,886514448,18,1311,723,3.5384615384615383
174,5,2,-3,886514448,886514469,21,723,29,2.5714285714285716
174,2,4,2,886514469,886514529,60,29,1074,2.857142857142857
174,4,5,1,886514529,886514757,228,1074,433,3.8035714285714284
174,5,4,-1,886514757,886514788,31,433,210,3.921259842519685
174,4,4,0,886514788,886514837,49,210,393,3.5125
174,4,2,-2,886514837,886514889,52,393,721,3.4583333333333335
174,2,2,0,886514889,886514921,32,721,158,2.7027027027027026
174,2,3,1,886514921,886514953,32,158,167,2.8181818181818183
174,3,4,1,886514953,886514985,32,167,63,3.125
174,4,2,-2,886514985,886515062,77,63,94,2.8823529411764706
174,2,1,-1,886515062,886515063,1,94,401,2.6774193548387095
174,1,1,0,886515063,886515104,41,401,396,2.84
174,1,1,0,886515104,886515121,17,396,384,2.7941176470588234
174,1,1,0,886515121,886515130,9,384,67,3.106382978723404
174,1,1,0,886515130,886515154,24,67,395,2.5714285714285716
174,1,1,0,886515154,886515172,18,395,862,1.6666666666666667
174,1,1,0,886515172,886515209,37,862,21,2.9210526315789473
174,1,1,0,886515209,886515210,1,21,80,2.967741935483871
174,1,1,0,886515210,886515240,30,80,364,2.8095238095238093
174,1,1,0,886515240,886515272,32,364,369,2.5714285714285716
174,1,1,0,886515272,886515295,23,369,577,1.7058823529411764
174,1,1,0,886515295,886515335,40,577,988,2.5555555555555554
174,1,5,4,886515335,886515457,122,988,143,3.56
174,5,1,-4,886515457,886515472,15,143,82,3.6741573033707864
174,1,4,3,886515472,886515490,18,82,417,3.0588235294117645
174,4,4,0,886515490,886515514,24,417,140,3.238095238095238
174,4,3,-1,886515514,886515532,18,140,623,3.0454545454545454
174,3,1,-2,886515532,886515551,19,623,951,2.6666666666666665
174,1,1,0,886515551,886515569,18,951,768,3.238095238095238
174,1,3,2,886515569,886515591,22,768,139,2.7222222222222223
174,3,3,0,886515591,890168415,3652824,139,905,3.357142857142857
174,3,5,2,890168415,890168505,90,905,293,3.630434782608696
174,5,5,0,890168505,890168700,195,293,238,3.888888888888889
43,3,4,1,875975061,875975085,24,321,289,2.988888888888889
43,4,3,-1,875975085,875975110,25,289,323,3.0
43,3,5,2,875975110,875975135,25,323,301,3.2465753424657535
43,5,3,-2,875975135,875975211,76,301,993,3.4838709677419355
43,3,4,1,875975211,875975276,65,993,257,3.7154471544715446
43,4,3,-1,875975276,875975323,47,257,254,2.7419354838709675
43,3,4,1,875975323,875975363,40,254,252,2.911392405063291
43,4,2,-2,875975363,875975383,20,252,250,3.4698795180722892
43,2,4,2,875975383,875975468,85,250,285,4.181818181818182
43,4,4,0,875975468,875975520,52,285,7,3.76056338028169
43,4,5,1,875975520,875975546,26,7,15,3.725663716814159
43,5,4,-1,875975546,875975613,67,15,151,3.6544117647058822
43,4,5,1,875975613,875975687,74,151,56,4.051724137931035
43,5,4,-1,875975687,875975717,30,56,8,3.903225806451613
43,4,4,0,875975717,875981159,5442,8,168,4.0476190476190474
43,4,5,1,875981159,875981190,31,168,173,4.1441441441441444
43,5,5,0,875981190,875981220,30,173,98,4.240875912408759
43,5,5,0,875981220,875981247,27,98,191,4.168674698795181
43,5,4,-1,875981247,875981275,28,191,735,3.58
43,4,4,0,875981275,875981304,29,735,127,4.162790697674419
43,4,4,0,875981304,875981365,61,127,479,4.25
43,4,4,0,875981365,875981390,25,479,724,3.64
43,4,4,0,875981390,875981421,31,724,5,3.1481481481481484
43,4,5,1,875981421,875981452,31,5,516,4.055555555555555
43,5,4,-1,875981452,875981483,31,516,133,3.7777777777777777
43,4,4,0,875981483,875981506,23,133,66,3.4705882352941178
43,4,4,0,875981506,880317271,4335765,66,336,2.4
43,4,5,1,880317271,883953545,3636274,336,272,4.2
43,5,2,-3,883953545,883954803,1258,272,751,3.3896103896103895
43,2,4,2,883954803,883954876,73,751,276,3.6036036036036037
43,4,5,1,883954876,883954901,25,276,26,3.36
43,5,5,0,883954901,883954950,49,26,114,4.3478260869565215
43,5,4,-1,883954950,883954970,20,114,705,3.7857142857142856
43,4,3,-1,883954970,883954997,27,705,131,3.731707317073171
43,3,4,1,883954997,883955048,51,131,70,3.5833333333333335
43,4,4,0,883955048,883955110,62,70,140,3.238095238095238
43,4,4,0,883955110,883955135,25,140,172,4.225225225225225
43,4,4,0,883955135,883955160,25,172,531,3.7435897435897436
43,4,4,0,883955160,883955224,64,531,52,3.727272727272727
43,4,4,0,883955224,883955269,45,52,371,3.0
43,4,5,1,883955269,883955293,24,371,648,3.9545454545454546
43,5,3,-2,883955293,883955319,26,648,471,3.5714285714285716
43,3,4,1,883955319,883955363,44,471,568,3.5853658536585367
43,4,5,1,883955363,883955387,24,568,385,3.6129032258064515
43,5,5,0,883955387,883955441,54,385,274,3.5609756097560976
43,5,5,0,883955441,883955467,26,274,210,3.921259842519685
43,5,4,-1,883955467,883955498,31,210,82,3.6741573033707864
43,4,4,0,883955498,883955546,48,82,118,3.2764227642276422
43,4,4,0,883955546,883955547,1,118,222,3.578125
43,4,5,1,883955547,883955605,58,222,496,4.094594594594595
43,5,3,-2,883955605,883955650,45,496,596,3.180327868852459
43,3,2,-1,883955650,883955675,25,596,631,3.581818181818182
43,2,4,2,883955675,883955702,27,631,684,3.847826086956522
43,4,4,0,883955702,883955745,43,684,588,3.8358208955223883
43,4,4,0,883955745,883955785,40,588,211,3.958904109589041
43,4,5,1,883955785,883955884,99,211,692,3.56
43,5,4,-1,883955884,883955907,23,692,121,3.521212121212121
43,4,2,-2,883955907,883955930,23,121,217,3.1538461538461537
43,2,2,0,883955930,883955969,39,217,1055,3.125
43,2,3,1,883955969,883955995,26,1055,291,3.2
43,3,4,1,883955995,883956040,45,291,699,3.736842105263158
43,4,4,0,883956040,883956099,59,699,73,3.588235294117647
43,4,4,0,883956099,883956122,23,73,204,3.6744186046511627
43,4,4,0,883956122,883956169,47,204,747,3.5526315789473686
43,4,1,-3,883956169,883956259,90,747,956,3.5714285714285716
43,1,3,2,883956259,883956260,1,956,91,3.6
43,3,4,1,883956260,883956305,45,91,403,3.298507462686567
43,4,3,-1,883956305,883956353,48,403,63,3.125
43,3,3,0,883956353,883956417,64,63,580,3.625
43,3,3,0,883956417,883956442,25,580,226,3.378787878787879
43,3,3,0,883956442,883956468,26,226,40,2.7037037037037037
43,3,3,0,883956468,883956494,26,40,54,3.3714285714285714
43,3,3,0,883956494,883956518,24,54,542,2.888888888888889
43,3,3,0,883956518,883956538,20,542,785,3.4375
43,3,1,-2,883956538,883956562,24,785,51,3.5277777777777777
43,1,3,2,883956562,884029259,72697,51,278,3.0357142857142856
43,3,3,0,884029259,884029309,50,278,473,2.9166666666666665
43,3,3,0,884029309,884029493,184,473,409,2.9615384615384617
43,3,3,0,884029493,884029519,26,409,411,2.911764705882353
43,3,3,0,884029519,884029658,139,411,1054,2.5454545454545454
43,3,1,-2,884029658,884029742,84,1054,931,2.2758620689655173
43,1,2,1,884029742,884029777,35,931,1057,2.7142857142857144
43,2,4,2,884029777,891294050,7264273,1057,124,4.052631578947368
84,3,4,1,883449317,883449347,30,294,258,3.7547169811320753
84,4,5,1,883449347,883449419,72,258,289,2.988888888888889
84,5,4,-1,883449419,883449530,111,289,748,3.1043478260869564
84,4,3,-1,883449530,883449567,37,748,322,3.0476190476190474
84,3,4,1,883449567,883449965,398,322,744,3.5714285714285716
84,4,4,0,883449965,883449993,28,744,15,3.725663716814159
84,4,4,0,883449993,883450020,27,15,222,3.578125
84,4,5,1,883450020,883450066,46,222,64,4.373737373737374
84,5,3,-2,883450066,883450093,27,64,284,3.1547619047619047
84,3,4,1,883450093,883450553,460,284,117,3.689189189189189
84,4,3,-1,883450553,883450643,90,117,742,3.5555555555555554
84,3,2,-1,883450643,883452108,1465,742,1,3.902439024390244
84,2,4,2,883452108,883452155,47,1,7,3.76056338028169
84,4,4,0,883452155,883452174,19,7,866,3.3962264150943398
84,4,3,-1,883452174,883452200,26,866,597,3.2771084337349397
84,3,4,1,883452200,883452274,74,597,148,3.2131147540983607
84,4,4,0,883452274,883452307,33,148,121,3.521212121212121
84,4,3,-1,883452307,883452363,56,121,405,3.25
84,3,4,1,883452363,883452462,99,405,815,3.135135135135135
84,4,2,-2,883452462,883452516,54,815,411,2.911764705882353
84,2,3,1,883452516,883452630,114,411,1040,2.2666666666666666
84,3,3,0,883452630,883452672,42,1040,823,2.75
84,3,4,1,883452672,883452711,39,823,1033,3.0
84,4,3,-1,883452711,883452765,54,1033,756,2.6885245901639343
84,3,5,2,883452765,883452874,109,756,12,4.358974358974359
84,5,5,0,883452874,883452906,32,12,70,3.5833333333333335
84,5,4,-1,883452906,883453148,242,70,466,3.5
84,4,3,-1,883453148,883453587,439,466,203,3.826923076923077
84,3,4,1,883453587,883453642,55,203,523,4.159090909090909
84,4,5,1,883453642,883453664,22,523,486,3.9565217391304346
84,5,5,0,883453664,883453713,49,486,543,4.166666666666667
84,5,4,-1,883453713,883453797,84,543,385,3.6129032258064515
269,3,5,2,891446133,891446165,32,886,124,4.052631578947368
269,5,5,0,891446165,891446193,28,124,276,3.6036036036036037
269,5,4,-1,891446193,891446246,53,276,1011,3.1
269,4,4,0,891446246,891446265,19,1011,508,3.6923076923076925
269,4,3,-1,891446265,891446308,43,508,293,3.630434782608696
269,3,2,-1,891446308,891446348,40,293,15,3.725663716814159
269,2,2,0,891446348,891446368,20,15,237,3.7315436241610738
269,2,3,1,891446368,891446443,75,237,985,2.9
269,3,3,0,891446443,891446514,71,985,823,2.75
269,3,3,0,891446514,891446580,66,823,93,3.5641025641025643
269,3,4,1,891446580,891446662,82,93,410,3.0434782608695654
269,4,1,-3,891446662,891446703,41,410,255,3.2027027027027026
269,1,4,3,891446703,891446756,53,255,1361,4.0
269,4,3,-1,891446756,891446838,82,1361,1014,3.1
269,3,1,-2,891446838,891446873,35,1014,122,2.282608695652174
269,1,1,0,891446873,891446904,31,122,1165,1.8
269,1,4,3,891446904,891447002,98,1165,212,3.230769230769231
269,4,4,0,891447002,891447062,60,212,198,4.04
269,4,4,0,891447062,891447141,79,198,59,4.0
269,4,5,1,891447141,891447169,28,59,171,4.090909090909091
269,5,4,-1,891447169,891447234,65,171,582,3.7457627118644066
269,4,5,1,891447234,891447255,21,582,213,3.943396226415094
269,5,3,-2,891447255,891447409,154,213,1006,2.7777777777777777
269,3,4,1,891447409,891447427,18,1006,1005,4.166666666666667
269,4,5,1,891447427,891447593,166,1005,644,3.7
269,5,4,-1,891447593,891447791,198,644,318,4.5046728971962615
269,4,4,0,891447791,891447815,24,318,518,3.5833333333333335
269,4,5,1,891447815,891447841,26,518,527,3.823529411764706
269,5,2,-3,891447841,891447842,1,527,58,3.543859649122807
269,2,4,2,891447842,891447960,118,58,64,4.373737373737374
269,4,5,1,891447960,891447961,1,64,197,4.112676056338028
269,5,4,-1,891447961,891447979,18,197,192,4.090909090909091
269,4,4,0,891447979,891448019,40,192,655,3.7857142857142856
269,4,1,-3,891448019,891448048,29,655,69,3.8015873015873014
269,1,4,3,891448048,891448072,24,69,65,3.511111111111111
269,4,2,-2,891448072,891448120,48,65,735,3.58
269,2,3,1,891448120,891448141,21,735,162,3.4651162790697674
269,3,2,-1,891448141,891448177,36,162,939,3.6333333333333333
269,2,3,1,891448177,891448283,106,939,387,3.5357142857142856
269,3,4,1,891448283,891448322,39,387,673,3.393939393939394
269,4,5,1,891448322,891448345,23,673,425,3.7027027027027026
269,5,3,-2,891448345,891448365,20,425,11,3.8904109589041096
269,3,2,-1,891448365,891448386,21,11,1168,3.4166666666666665
269,2,4,2,891448386,891448436,50,1168,792,3.793103448275862
269,4,2,-2,891448436,891448456,20,792,1135,3.0526315789473686
269,2,3,1,891448456,891448475,19,1135,956,3.5714285714285716
269,3,2,-1,891448475,891448497,22,956,658,3.393939393939394
269,2,1,-1,891448497,891448522,25,658,403,3.298507462686567
269,1,3,2,891448522,891448547,25,403,214,3.272727272727273
269,3,2,-1,891448547,891448569,22,214,729,3.3793103448275863
269,2,1,-1,891448569,891448643,74,729,1478,2.7
269,1,2,1,891448643,891448738,95,1478,365,2.95
269,2,4,2,891448738,891448800,62,365,483,4.475609756097561
269,4,4,0,891448800,891448823,23,483,474,4.172413793103448
269,4,4,0,891448823,891448849,26,474,134,4.174603174603175
269,4,5,1,891448849,891448850,1,134,238,3.888888888888889
269,5,5,0,891448850,891448871,21,238,603,4.315789473684211
269,5,3,-2,891448871,891448895,24,603,604,3.8181818181818183
269,3,4,1,891448895,891448926,31,604,488,4.277777777777778
269,4,4,0,891448926,891448951,25,488,98,4.240875912408759
269,4,4,0,891448951,891448980,29,98,654,4.119047619047619
269,4,3,-1,891448980,891449011,31,654,435,3.8933333333333335
269,3,3,0,891449011,891449031,20,435,172,4.225225225225225
269,3,3,0,891449031,891449055,24,172,7,3.76056338028169
269,3,4,1,891449055,891449075,20,7,136,3.764705882352941
269,4,4,0,891449075,891449123,48,136,514,4.033333333333333
269,4,1,-3,891449123,891449124,1,514,174,4.253521126760563
269,1,5,4,891449124,891449145,21,174,132,3.929411764705882
269,5,3,-2,891449145,891449189,44,132,154,3.6031746031746033
269,3,3,0,891449189,891449280,91,154,133,3.7777777777777777
269,3,2,-1,891449280,891449304,24,133,707,3.909090909090909
269,2,4,2,891449304,891449346,42,707,602,3.533333333333333
269,4,5,1,891449346,891449364,18,602,156,4.017857142857143
269,5,4,-1,891449364,891449406,42,156,659,4.027777777777778
269,4,1,-3,891449406,891449429,23,659,173,4.1441441441441444
269,1,3,2,891449429,891449464,35,173,642,3.4285714285714284
269,3,4,1,891449464,891449526,62,642,608,4.285714285714286
269,4,4,0,891449526,891449550,24,608,492,4.117647058823529
269,4,3,-1,891449550,891449551,1,492,505,4.0625
269,3,4,1,891449551,891449571,20,505,1020,3.727272727272727
269,4,5,1,891449571,891449572,1,1020,506,3.566666666666667
269,5,3,-2,891449572,891449608,36,506,1154,3.6
269,3,3,0,891449608,891449624,16,1154,414,3.3076923076923075
269,3,5,2,891449624,891449646,22,414,42,3.893617021276596
269,5,5,0,891449646,891449728,82,42,131,3.731707317073171
269,5,2,-3,891449728,891449751,23,131,163,3.53125
269,2,2,0,891449751,891449801,50,163,1071,3.0
269,2,2,0,891449801,891449842,41,1071,204,3.6744186046511627
269,2,1,-1,891449842,891449843,1,204,710,3.41025641025641
269,1,4,3,891449843,891449880,37,710,663,3.948717948717949
269,4,3,-1,891449880,891449900,20,663,433,3.8035714285714284
269,3,4,1,891449900,891449922,22,433,504,4.085714285714285
269,4,1,-3,891449922,891449962,40,504,679,3.2432432432432434
269,1,4,3,891449962,891449984,22,679,200,3.8157894736842106
269,4,2,-2,891449984,891449985,1,200,8,3.903225806451613
269,2,4,2,891449985,891450005,20,8,432,3.719298245614035
269,4,3,-1,891450005,891450023,18,432,367,3.4242424242424243
269,3,2,-1,891450023,891450405,382,367,202,3.730337078651685
269,2,3,1,891450405,891450453,48,202,636,3.4146341463414633
269,3,3,0,891450453,891450471,18,636,614,3.727272727272727
269,3,5,2,891450471,891450489,18,614,151,3.6544117647058822
269,5,2,-3,891450489,891450509,20,151,218,3.5555555555555554
269,2,1,-1,891450509,891450555,46,218,763,3.347826086956522
269,1,4,3,891450555,891450575,20,763,1397,3.6666666666666665
269,4,4,0,891450575,891450623,48,1397,152,3.6785714285714284
269,4,3,-1,891450623,891450675,52,152,436,3.5
269,3,2,-1,891450675,891450719,44,436,568,3.5853658536585367
269,2,1,-1,891450719,891450755,36,568,96,3.9130434782608696
269,1,2,1,891450755,891450780,25,96,82,3.6741573033707864
269,2,1,-1,891450780,891450857,77,82,63,3.125
269,1,1,0,891450857,891450880,23,63,451,3.207792207792208
269,1,1,0,891450880,891450978,98,451,597,3.2771084337349397
269,1,1,0,891450978,891451013,35,597,411,2.911764705882353
269,1,1,0,891451013,891451036,23,411,161,3.5844155844155843
269,1,1,0,891451036,891451063,27,161,627,3.3823529411764706
269,1,4,3,891451063,891451111,48,627,716,3.1904761904761907
269,4,3,-1,891451111,891451303,192,716,447,3.46875
269,3,1,-2,891451303,891451374,71,447,1133,3.076923076923077
269,1,1,0,891451374,891451431,57,1133,739,3.391304347826087
269,1,1,0,891451431,891451451,20,739,809,2.7058823529411766
269,1,2,1,891451451,891451470,19,809,72,3.175438596491228
269,2,1,-1,891451470,891451492,22,72,139,2.7222222222222223
269,1,5,4,891451492,891451548,56,139,998,2.7777777777777777
269,5,1,-4,891451548,891451570,22,998,142,3.1481481481481484
269,1,2,1,891451570,891451610,40,142,217,3.1538461538461537
269,2,2,0,891451610,891451611,1,217,831,2.6097560975609757
269,2,1,-1,891451611,891451648,37,831,167,2.8181818181818183
269,1,2,1,891451648,891451705,57,167,1091,2.5384615384615383
269,2,1,-1,891451705,891451754,49,1091,771,2.5714285714285716
269,1,3,2,891451754,891451829,75,771,1411,2.4615384615384617
269,3,4,1,891451829,891451856,27,1411,396,2.84
269,4,1,-3,891451856,891451857,1,396,1188,2.45
269,1,1,0,891451857,891451889,32,1188,783,2.388888888888889
269,1,1,0,891451889,891451947,58,783,756,2.6885245901639343
269,1,3,2,891451947,891451971,24,756,444,2.6842105263157894
269,3,5,2,891451971,891455816,3845,444,48,4.055555555555555
269,5,1,-4,891455816,891456350,534,48,252,2.911392405063291
269,1,1,0,891456350,891456425,75,252,1040,2.2666666666666666
269,1,1,0,891456425,891456493,68,1040,717,2.9696969696969697
269,1,1,0,891456493,891456565,72,717,254,2.7419354838709675
259,4,4,0,874724727,874724781,54,286,185,3.9726027397260273
259,4,4,0,874724781,874724843,62,185,173,4.1441441441441444
259,4,4,0,874724843,874724882,39,173,772,3.3333333333333335
259,4,3,-1,874724882,874724905,23,772,288,3.5214285714285714
259,3,4,1,874724905,874724988,83,288,117,3.689189189189189
259,4,4,0,874724988,874725081,93,117,200,3.8157894736842106
259,4,3,-1,874725081,874725120,39,200,405,3.25
259,3,3,0,874725120,874725264,144,405,1074,2.857142857142857
259,3,4,1,874725264,874725386,122,1074,176,3.967032967032967
259,4,5,1,874725386,874725485,99,176,357,4.063291139240507
259,5,4,-1,874725485,874809091,83606,357,98,4.240875912408759
259,4,5,1,874809091,874809192,101,98,12,4.358974358974359
259,5,4,-1,874809192,874809292,100,12,97,3.7282608695652173
259,4,4,0,874809292,877924028,3114736,97,179,3.8823529411764706
259,4,5,1,877924028,877925049,1021,179,475,3.956043956043956
259,5,3,-2,877925049,883371001,5445952,475,65,3.511111111111111
259,3,4,1,883371001,883371861,860,65,293,3.630434782608696
259,4,4,0,883371861,883371882,21,293,172,4.225225225225225
259,4,4,0,883371882,888720593,5348711,172,959,3.4583333333333335
259,4,4,0,888720593,888720644,51,959,39,3.107142857142857
85,3,2,-1,879452334,879452386,52,289,325,2.625
85,2,4,2,879452386,879452638,252,325,14,4.101694915254237
85,4,2,-2,879452638,879452693,55,14,221,3.6923076923076925
85,2,2,0,879452693,879452831,138,221,222,3.578125
85,2,3,1,879452831,879452866,35,222,13,3.5454545454545454
85,3,3,0,879452866,879452867,1,13,458,3.0588235294117645
85,3,4,1,879452867,879452898,31,458,10,3.85
85,4,3,-1,879452898,879453018,120,10,476,3.1216216216216215
85,3,2,-1,879453018,879453040,22,476,508,3.6923076923076925
85,2,2,0,879453040,879453093,53,508,1009,3.2962962962962963
85,2,3,1,879453093,879453288,195,1009,412,2.272727272727273
85,3,3,0,879453288,879453623,335,412,630,3.25
85,3,4,1,879453623,879453658,35,630,480,4.283018867924528
85,4,4,0,879453658,879453716,58,480,98,4.240875912408759
85,4,4,0,879453716,879453748,32,98,170,4.242424242424242
85,4,4,0,879453748,879453781,33,170,1172,3.4
85,4,4,0,879453781,879453844,63,1172,647,4.142857142857143
85,4,5,1,879453844,879453845,1,647,135,3.7974683544303796
85,5,3,-2,879453845,879453876,31,135,42,3.893617021276596
85,3,5,2,879453876,879453933,57,42,483,4.475609756097561
85,5,2,-3,879453933,879453965,32,483,238,3.888888888888889
85,2,4,2,879453965,879454004,39,238,205,3.717391304347826
85,4,4,0,879454004,879454005,1,205,661,4.133333333333334
85,4,4,0,879454005,879454046,41,661,1101,3.793103448275862
85,4,3,-1,879454046,879454075,29,1101,160,3.4
85,3,4,1,879454075,879454111,36,160,1131,3.6666666666666665
85,4,4,0,879454111,879454189,78,1131,509,3.7058823529411766
85,4,5,1,879454189,879454235,46,509,187,4.215189873417722
85,5,3,-2,879454235,879454273,38,187,186,3.905263157894737
85,3,3,0,879454273,879454304,31,186,632,3.9523809523809526
85,3,4,1,879454304,879454350,46,632,707,3.909090909090909
85,4,4,0,879454350,879454400,50,707,498,4.290909090909091
85,4,3,-1,879454400,879454467,67,498,283,3.901639344262295
85,3,3,0,879454467,879454500,33,283,216,3.8454545454545452
85,3,3,0,879454500,879454581,81,216,275,4.087912087912088
85,3,3,0,879454581,879454582,1,275,610,3.1818181818181817
85,3,3,0,879454582,879454633,51,610,1174,2.0
85,3,3,0,879454633,879454685,52,1174,629,3.3333333333333335
85,3,5,2,879454685,879454751,66,629,152,3.6785714285714284
85,5,2,-3,879454751,879454782,31,152,188,3.625
85,2,4,2,879454782,879454820,38,188,180,3.9473684210526314
85,4,2,-2,879454820,879454859,39,180,212,3.230769230769231
85,2,3,1,879454859,879454905,46,212,735,3.58
85,3,4,1,879454905,879454951,46,735,479,4.25
85,4,4,0,879454951,879454952,1,479,641,4.5
85,4,2,-2,879454952,879454981,29,641,1113,3.0
85,2,4,2,879454981,879455021,40,1113,1166,3.8
85,4,4,0,879455021,879455114,93,1166,527,3.823529411764706
85,4,4,0,879455114,879455197,83,527,488,4.277777777777778
85,4,4,0,879455197,879455403,206,488,923,4.142857142857143
85,4,3,-1,879455403,879456350,947,923,530,4.125
85,3,3,0,879456350,879827989,371639,530,921,3.611111111111111
85,3,4,1,879827989,879828014,25,921,582,3.7457627118644066
85,4,5,1,879828014,879828107,93,582,57,4.133333333333334
85,5,3,-2,879828107,879828156,49,57,971,4.0
85,3,3,0,879828156,879828490,334,971,692,3.56
85,3,4,1,879828490,879828911,421,692,435,3.8933333333333335
85,4,4,0,879828911,879828912,1,435,175,3.8354430379746836
85,4,4,0,879828912,879828967,55,175,393,3.5125
85,4,3,-1,879828967,879829021,54,393,745,4.0
85,3,3,0,879829021,879829042,21,745,141,3.4827586206896552
85,3,3,0,879829042,879829209,167,141,1167,3.6666666666666665
85,3,4,1,879829209,879829265,56,1167,519,4.291666666666667
85,4,4,0,879829265,879829327,62,519,87,3.9
85,4,5,1,879829327,879829438,111,87,199,4.191489361702128
85,5,3,-2,879829438,879829471,33,199,521,3.787878787878788
85,3,4,1,879829471,879829562,91,521,664,3.15
85,4,3,-1,879829562,879829618,56,664,282,3.610526315789474
85,3,4,1,879829618,879829642,24,282,378,3.6904761904761907
85,4,2,-2,879829642,879829667,25,378,97,3.7282608695652173
85,2,4,2,879829667,879829689,22,97,58,3.543859649122807
85,4,2,-2,879829689,879829757,68,58,782,2.8
85,2,4,2,879829757,880838305,1008548,782,432,3.719298245614035
85,4,5,1,880838305,880838306,1,432,99,3.8392857142857144
85,5,3,-2,880838306,880838337,31,99,596,3.180327868852459
85,3,3,0,880838337,881705026,866689,596,52,3.727272727272727
85,3,4,1,881705026,882813285,1108259,52,172,4.225225225225225
85,4,3,-1,882813285,882813312,27,172,163,3.53125
85,3,4,1,882813312,882819528,6216,163,161,3.5844155844155843
85,4,3,-1,882819528,882994767,175239,161,447,3.46875
85,3,3,0,882994767,882994860,93,447,495,3.65
85,3,3,0,882994860,882994947,87,495,404,3.6578947368421053
85,3,4,1,882994947,882995015,68,404,234,3.7674418604651163
85,4,4,0,882995015,882995132,117,234,604,3.8181818181818183
85,4,3,-1,882995132,882995340,208,604,241,3.5625
85,3,3,0,882995340,882995489,149,241,1103,3.5555555555555554
85,3,3,0,882995489,882995577,88,1103,317,3.774193548387097
85,3,4,1,882995577,882995668,91,317,1018,3.0714285714285716
85,4,4,0,882995668,882995704,36,1018,380,3.4878048780487805
85,4,3,-1,882995704,882995832,128,380,389,3.272727272727273
85,3,3,0,882995832,882995833,1,389,1006,2.7777777777777777
85,3,4,1,882995833,882995934,101,1006,451,3.207792207792208
85,4,3,-1,882995934,882995966,32,451,232,3.0789473684210527
85,3,4,1,882995966,882995967,1,232,715,3.257142857142857
85,4,3,-1,882995967,882996039,72,715,1074,2.857142857142857
85,3,5,2,882996039,882996119,80,1074,464,3.8
85,5,3,-2,882996119,882996257,138,464,520,4.136363636363637
85,3,3,0,882996257,884820110,1823853,520,327,3.5076923076923077
85,3,4,1,884820110,884820133,23,327,313,4.323076923076923
85,4,3,-1,884820133,884820157,24,313,751,3.3896103896103895
85,3,4,1,884820157,884820209,52,751,1173,3.0
85,4,4,0,884820209,886282959,1462750,1173,606,4.294117647058823
85,4,4,0,886282959,886283002,43,606,301,3.2465753424657535
213,3,5,2,878870275,878870456,181,690,50,4.306532663316583
213,5,4,-1,878870456,878870552,96,50,181,3.98974358974359
213,4,5,1,878870552,878870648,96,181,628,3.573529411764706
213,5,4,-1,878870648,878870679,31,628,458,3.0588235294117645
213,4,2,-2,878870679,878870719,40,458,1,3.902439024390244
213,2,5,3,878870719,878870749,30,1,100,4.0162162162162165
213,5,4,-1,878870749,878870750,1,100,25,3.3185840707964602
213,4,3,-1,878870750,878870816,66,25,471,3.5714285714285716
213,3,4,1,878870816,878870903,87,471,546,2.9789473684210526
213,4,4,0,878870903,878870904,1,546,106,2.8125
213,4,5,1,878870904,878870940,36,106,121,3.521212121212121
213,5,5,0,878870940,878870987,47,121,273,3.5238095238095237
213,5,4,-1,878870987,878871010,23,273,841,2.772727272727273
213,4,4,0,878871010,878871038,28,841,281,3.2
213,4,4,0,878871038,878871062,24,281,831,2.6097560975609757
213,4,1,-3,878871062,878871089,27,831,1215,2.0714285714285716
213,1,5,4,878871089,878955164,84075,1215,284,3.1547619047619047
213,5,5,0,878955164,878955188,24,284,274,3.5609756097560976
213,5,2,-3,878955188,878955319,131,274,756,2.6885245901639343
213,2,4,2,878955319,878955372,53,756,509,3.7058823529411766
213,4,4,0,878955372,878955373,1,509,234,3.7674418604651163
213,4,5,1,878955373,878955409,36,234,12,4.358974358974359
213,5,4,-1,878955409,878955442,33,12,193,3.883720930232558
213,4,5,1,878955442,878955501,59,193,185,3.9726027397260273
213,5,5,0,878955501,878955533,32,185,318,4.5046728971962615
213,5,3,-2,878955533,878955534,1,318,69,3.8015873015873014
213,3,4,1,878955534,878955599,65,69,175,3.8354430379746836
213,4,2,-2,878955599,878955635,36,175,474,4.172413793103448
213,2,5,3,878955635,878955680,45,474,778,3.5925925925925926
213,5,4,-1,878955680,878955766,86,778,194,4.029411764705882
213,4,5,1,878955766,878955816,50,194,214,3.272727272727273
213,5,5,0,878955816,878955848,32,214,357,4.063291139240507
213,5,5,0,878955848,878955885,37,357,504,4.085714285714285
213,5,5,0,878955885,878955886,1,504,151,3.6544117647058822
213,5,4,-1,878955886,878955914,28,151,2,3.0851063829787235
213,4,5,1,878955914,878955915,1,2,715,3.257142857142857
213,5,4,-1,878955915,878955941,26,715,568,3.5853658536585367
213,4,4,0,878955941,878955973,32,568,229,3.185185185185185
213,4,4,0,878955973,878956000,27,229,684,3.847826086956522
213,4,5,1,878956000,878956047,47,684,180,3.9473684210526314
213,5,4,-1,878956047,878956074,27,180,448,3.466666666666667
213,4,5,1,878956074,878956100,26,448,200,3.8157894736842106
213,5,5,0,878956100,878956101,1,200,135,3.7974683544303796
213,5,5,0,878956101,878956129,28,135,478,4.161290322580645
213,5,5,0,878956129,878956130,1,478,204,3.6744186046511627
213,5,4,-1,878956130,878956156,26,204,11,3.8904109589041096
213,4,5,1,878956156,878956263,107,11,79,3.956989247311828
213,5,5,0,878956263,878956299,36,79,97,3.7282608695652173
213,5,5,0,878956299,878956300,1,97,164,3.6140350877192984
213,5,4,-1,878956300,878956338,38,164,176,3.967032967032967
121,3,4,1,891387947,891387992,45,514,631,3.581818181818182
121,4,4,0,891387992,891388035,43,631,100,4.0162162162162165
121,4,5,1,891388035,891388090,55,100,135,3.7974683544303796
121,5,5,0,891388090,891388113,23,135,479,4.25
121,5,4,-1,891388113,891388210,97,479,1194,4.181818181818182
121,4,3,-1,891388210,891388250,40,1194,792,3.793103448275862
121,3,4,1,891388250,891388333,83,792,508,3.6923076923076925
121,4,4,0,891388333,891388391,58,508,515,4.202898550724638
121,4,3,-1,891388391,891388453,62,515,276,3.6036036036036037
121,3,4,1,891388453,891388475,22,276,1,3.902439024390244
121,4,2,-2,891388475,891388600,125,1,125,3.5555555555555554
121,2,2,0,891388600,891388676,76,125,250,3.4698795180722892
121,2,5,3,891388676,891388708,32,250,237,3.7315436241610738
121,5,1,-4,891388708,891388847,139,237,458,3.0588235294117645
121,1,3,2,891388847,891388936,89,458,126,3.8620689655172415
121,3,4,1,891388936,891388960,24,126,292,3.6666666666666665
121,4,1,-3,891388960,891389037,77,292,282,3.610526315789474
121,1,3,2,891389037,891389304,267,282,347,3.59375
121,3,5,2,891389304,891390013,709,347,318,4.5046728971962615
121,5,5,0,891390013,891390014,1,318,14,4.101694915254237
121,5,4,-1,891390014,891390233,219,14,275,4.087912087912088
121,4,5,1,891390233,891390316,83,275,25,3.3185840707964602
121,5,3,-2,891390316,891390477,161,25,291,3.2
121,3,2,-1,891390477,891390501,24,291,122,2.282608695652174
121,2,2,0,891390501,891390521,20,122,595,2.9166666666666665
121,2,1,-1,891390521,891390544,23,595,411,2.911764705882353
121,1,3,2,891390544,891390599,55,411,472,2.984375
121,3,5,2,891390599,891390688,89,472,717,2.9696969696969697
49,3,3,0,888065487,888065527,40,347,313,4.323076923076923
49,3,1,-2,888065527,888065577,50,313,300,3.6861313868613137
49,1,5,4,888065577,888065620,43,300,262,3.5217391304347827
49,5,3,-2,888065620,888065640,20,262,301,3.2465753424657535
49,3,4,1,888065640,888065702,62,301,324,3.2291666666666665
49,4,3,-1,888065702,888065786,84,324,312,3.0
49,3,1,-2,888065786,888065805,19,312,358,2.6551724137931036
49,1,2,1,888065805,888065825,20,358,878,2.0
49,2,3,1,888065825,888066086,261,878,283,3.901639344262295
49,3,4,1,888066086,888066109,23,283,116,3.6666666666666665
49,4,5,1,888066109,888066133,24,116,919,4.0
49,5,3,-2,888066133,888066187,54,919,1068,3.2
49,3,3,0,888066187,888066214,27,1068,1082,2.6666666666666665
49,3,2,-1,888066214,888066424,210,1082,1075,2.5
49,2,5,3,888066424,888066446,22,1075,652,3.9642857142857144
49,5,2,-3,888066446,888066486,40,652,462,3.7954545454545454
49,2,3,1,888066486,888066511,25,462,531,3.7435897435897436
49,3,4,1,888066511,888066551,40,531,171,4.090909090909091
49,4,4,0,888066551,888066571,20,171,57,4.133333333333334
49,4,2,-2,888066571,888066614,43,57,70,3.5833333333333335
49,2,5,3,888066614,888066647,33,70,1021,3.8666666666666667
49,5,4,-1,888066647,888066734,87,1021,1080,4.0
49,4,2,-2,888066734,888066755,21,1080,1018,3.0714285714285716
49,2,2,0,888066755,888066776,21,1018,698,3.3333333333333335
49,2,1,-1,888066776,888066828,52,698,737,3.12
49,1,5,4,888066828,888066979,151,737,91,3.6
49,5,4,-1,888066979,888067031,52,91,588,3.8358208955223883
49,4,2,-2,888067031,888067096,65,588,946,3.1153846153846154
49,2,3,1,888067096,888067164,68,946,101,3.4827586206896552
49,3,4,1,888067164,888067307,143,101,7,3.76056338028169
49,4,5,1,888067307,888067334,27,7,320,4.75
49,5,3,-2,888067334,888067358,24,320,200,3.8157894736842106
49,3,1,-2,888067358,888067405,47,200,219,2.735294117647059
49,1,2,1,888067405,888067428,23,219,406,2.5294117647058822
49,2,1,-1,888067428,888067460,32,406,413,2.5652173913043477
49,1,3,2,888067460,888067482,22,413,569,2.4285714285714284
49,3,2,-1,888067482,888067528,46,569,774,3.0
49,2,1,-1,888067528,888067579,51,774,590,1.8888888888888888
49,1,1,0,888067579,888067691,112,590,50,4.306532663316583
49,1,3,2,888067691,888067726,35,50,143,3.56
49,3,2,-1,888067726,888067727,1,143,423,3.7016129032258065
49,2,1,-1,888067727,888067765,38,423,181,3.98974358974359
49,1,3,2,888067765,888067798,33,181,465,3.75
49,3,2,-1,888067798,888067975,177,465,401,2.6774193548387095
49,2,5,3,888067975,888068032,57,401,657,4.341463414634147
49,5,4,-1,888068032,888068079,47,657,741,3.3043478260869565
49,4,1,-3,888068079,888068100,21,741,121,3.521212121212121
49,1,4,3,888068100,888068143,43,121,583,3.4285714285714284
49,4,4,0,888068143,888068167,24,583,628,3.573529411764706
49,4,1,-3,888068167,888068195,28,628,123,3.297872340425532
49,1,2,1,888068195,888068245,50,123,159,3.3902439024390243
49,2,2,0,888068245,888068265,20,159,54,3.3714285714285714
49,2,1,-1,888068265,888068289,24,54,38,2.784313725490196
49,1,2,1,888068289,888068336,47,38,931,2.2758620689655173
49,2,1,-1,888068336,888068686,350,931,204,3.6744186046511627
49,1,5,4,888068686,888068715,29,204,47,3.5869565217391304
49,5,5,0,888068715,888068739,24,47,433,3.8035714285714284
49,5,1,-4,888068739,888068791,52,433,455,3.1702127659574466
49,1,3,2,888068791,888068816,25,455,13,3.5454545454545454
49,3,3,0,888068816,888068841,25,13,508,3.6923076923076925
49,3,3,0,888068841,888068842,1,508,1067,3.533333333333333
49,3,3,0,888068842,888068877,35,1067,3,3.0625
49,3,5,2,888068877,888068912,35,3,93,3.5641025641025643
49,5,3,-2,888068912,888068934,22,93,85,3.3157894736842106
49,3,2,-1,888068934,888068957,23,85,108,3.107142857142857
49,2,2,0,888068957,888068990,33,108,235,3.106382978723404
49,2,4,2,888068990,888069040,50,235,372,3.6666666666666665
49,4,2,-2,888069040,888069062,22,372,290,3.108108108108108
49,2,1,-1,888069062,888069117,55,290,926,2.7857142857142856
49,1,2,1,888069117,888069194,77,926,998,2.7777777777777777
49,2,1,-1,888069194,888069222,28,998,40,2.7037037037037037
49,1,1,0,888069222,888069246,24,40,821,3.076923076923077
49,1,2,1,888069246,888069304,58,821,1028,2.857142857142857
49,2,1,-1,888069304,888069329,25,1028,577,1.7058823529411764
49,1,3,2,888069329,888069416,87,577,182,3.842857142857143
49,3,4,1,888069416,888069437,21,182,518,3.5833333333333335
49,4,3,-1,888069437,888069458,21,518,11,3.8904109589041096
49,3,1,-2,888069458,888069459,1,11,117,3.689189189189189
49,1,1,0,888069459,888069512,53,117,96,3.9130434782608696
49,1,1,0,888069512,888069513,1,96,68,3.5714285714285716
49,1,1,0,888069513,888069536,23,68,385,3.6129032258064515
49,1,3,2,888069536,888069579,43,385,231,2.938775510204082
49,3,1,-2,888069579,888069606,27,231,2,3.0851063829787235
49,1,2,1,888069606,888069660,54,2,62,3.048780487804878
155,3,2,-1,879371194,879371261,67,294,325,2.625
68,4,5,1,876973726,876973884,158,288,276,3.6036036036036037
68,5,1,-4,876973884,876973917,33,276,763,3.347826086956522
68,1,4,3,876973917,876973969,52,763,127,4.162790697674419
68,4,2,-2,876973969,876974023,54,127,596,3.180327868852459
68,2,1,-1,876974023,876974048,25,596,458,3.0588235294117645
68,1,2,1,876974048,876974073,25,458,713,3.5
68,2,1,-1,876974073,876974096,23,713,125,3.5555555555555554
68,1,5,4,876974096,876974133,37,125,237,3.7315436241610738
68,5,4,-1,876974133,876974176,43,237,25,3.3185840707964602
68,4,1,-3,876974176,876974198,22,25,742,3.5555555555555554
68,1,2,1,876974198,876974248,50,742,118,3.2764227642276422
68,2,3,1,876974248,876974276,28,118,111,3.5106382978723403
68,3,1,-2,876974276,876974379,103,111,1047,2.6923076923076925
68,1,1,0,876974379,876974484,105,1047,1089,2.1363636363636362
68,1,3,2,876974484,876974677,193,1089,409,2.9615384615384617
68,3,5,2,876974677,876974755,78,409,178,4.378378378378378
172,2,4,2,875536721,875537151,430,1134,124,4.052631578947368
172,4,4,0,875537151,875537502,351,124,463,3.6818181818181817
172,4,4,0,875537502,875537965,463,463,177,3.875
172,4,3,-1,875537965,875538027,62,177,603,4.315789473684211
172,3,3,0,875538027,875538028,1,603,485,3.717948717948718
19,3,4,1,885411840,885412251,411,288,325,2.625
19,4,4,0,885412251,885412840,589,325,211,3.958904109589041
268,4,3,-1,875306644,875306691,47,475,16,3.411764705882353
268,3,4,1,875306691,875306805,114,16,718,3.8
268,4,4,0,875306805,875309258,2453,718,179,3.8823529411764706
268,4,5,1,875309258,875309282,24,179,59,4.0
268,5,3,-2,875309282,875309304,22,59,558,3.75
268,3,3,0,875309304,875309319,15,558,52,3.727272727272727
268,3,4,1,875309319,875309430,111,52,404,3.6578947368421053
268,4,3,-1,875309430,875309486,56,404,71,3.6575342465753424
268,3,4,1,875309486,875309507,21,71,11,3.8904109589041096
268,4,4,0,875309507,875309583,76,11,183,3.951219512195122
268,4,5,1,875309583,875309718,135,183,654,4.119047619047619
268,5,5,0,875309718,875309719,1,654,50,4.306532663316583
268,5,3,-2,875309719,875309801,82,50,185,3.9726027397260273
268,3,4,1,875309801,875309829,28,185,4,3.5538461538461537
268,4,4,0,875309829,875309859,30,4,435,3.8933333333333335
268,4,4,0,875309859,875309913,54,435,525,4.0
268,4,4,0,875309913,875309945,32,525,228,3.7246376811594204
268,4,4,0,875309945,875310031,86,228,173,4.1441441441441444
268,4,5,1,875310031,875310083,52,173,134,4.174603174603175
268,5,4,-1,875310083,875310116,33,134,12,4.358974358974359
268,4,3,-1,875310116,875310145,29,12,622,3.3333333333333335
268,3,3,0,875310145,875310311,166,622,204,3.6744186046511627
268,3,3,0,875310311,875310352,41,204,238,3.888888888888889
268,3,3,0,875310352,875310412,60,238,233,3.323529411764706
268,3,3,0,875310412,875310442,30,233,946,3.1153846153846154
268,3,3,0,875310442,875310491,49,946,239,3.423076923076923
268,3,2,-1,875310491,875310524,33,239,550,3.272727272727273
268,2,4,2,875310524,875310549,25,550,425,3.7027027027027026
268,4,1,-3,875310549,875310603,54,425,715,3.257142857142857
268,1,2,1,875310603,875310704,101,715,380,3.4878048780487805
268,2,3,1,875310704,875310745,41,380,470,3.72
268,3,3,0,875310745,875310784,39,470,82,3.6741573033707864
268,3,4,1,875310784,875742275,431491,82,222,3.578125
268,4,4,0,875742275,875742316,41,222,244,2.9411764705882355
268,4,3,-1,875742316,875742341,25,244,1,3.902439024390244
268,3,4,1,875742341,875742365,24,1,713,3.5
268,4,3,-1,875742365,875742499,134,713,455,3.1702127659574466
268,3,3,0,875742499,875742556,57,455,25,3.3185840707964602
268,3,3,0,875742556,875742647,91,25,13,3.5454545454545454
268,3,2,-1,875742647,875742680,33,13,1477,2.0
268,2,3,1,875742680,875742794,114,1477,123,3.297872340425532
268,3,2,-1,875742794,875742822,28,123,405,3.25
268,2,4,2,875742822,875742866,44,405,257,3.7154471544715446
268,4,3,-1,875742866,875742893,27,257,825,2.914285714285714
268,3,3,0,875742893,875742916,23,825,1079,2.1923076923076925
268,3,2,-1,875742916,875742942,26,1079,823,2.75
268,2,3,1,875742942,875742992,50,823,108,3.107142857142857
268,3,1,-2,875742992,875743065,73,108,826,2.5555555555555554
268,1,3,2,875743065,875743090,25,826,544,3.185185185185185
268,3,4,1,875743090,875743110,20,544,546,2.9789473684210526
268,4,2,-2,875743110,875743141,31,546,121,3.521212121212121
268,2,1,-1,875743141,875743161,20,121,3,3.0625
268,1,2,1,875743161,875743216,55,3,762,3.3962264150943398
268,2,2,0,875743216,875743282,66,762,120,2.3421052631578947
268,2,1,-1,875743282,875743283,1,120,981,2.0
268,1,3,2,875743283,875743310,27,981,1059,2.764705882352941
268,3,5,2,875743310,875743503,193,1059,153,3.7865168539325844
268,5,3,-2,875743503,875743534,31,153,1098,3.533333333333333
268,3,3,0,875743534,875743587,53,1098,721,3.4583333333333335
268,3,3,0,875743587,875743588,1,721,67,3.106382978723404
268,3,3,0,875743588,875743656,68,67,399,3.317073170731707
268,3,2,-1,875743656,875743678,22,399,158,2.7027027027027026
268,2,3,1,875743678,875743708,30,158,40,2.7037037037037037
268,3,1,-2,875743708,875743735,27,40,1041,3.3333333333333335
268,1,2,1,875743735,875743760,25,1041,88,3.433734939759036
268,2,2,0,875743760,875743793,33,88,1249,3.2
268,2,3,1,875743793,875743831,38,1249,72,3.175438596491228
268,3,3,0,875743831,875743868,37,72,384,2.7941176470588234
268,3,2,-1,875743868,875743888,20,384,940,2.4
268,2,2,0,875743888,875743909,21,940,949,3.392857142857143
268,2,3,1,875743909,875743929,20,949,780,3.08
268,3,3,0,875743929,875743951,22,780,781,3.4166666666666665
268,3,2,-1,875743951,875743978,27,781,386,2.769230769230769
268,2,2,0,875743978,875744021,43,386,395,2.5714285714285716
268,2,2,0,875744021,875744051,30,395,728,3.05
268,2,4,2,875744051,875744136,85,728,27,3.235294117647059
268,4,2,-2,875744136,875744174,38,27,1222,2.6363636363636362
268,2,3,1,875744174,875744199,25,1222,128,3.45
268,3,1,-2,875744199,875744228,29,128,363,3.0
268,1,2,1,875744228,875744289,61,363,1314,2.0
268,2,3,1,875744289,875744321,32,1314,684,3.847826086956522
268,3,1,-2,875744321,875744356,35,684,29,2.5714285714285716
268,1,4,3,875744356,875744357,1,29,562,3.2941176470588234
268,4,2,-2,875744357,875744388,31,562,578,3.066666666666667
268,2,2,0,875744388,875744469,81,578,218,3.5555555555555554
268,2,2,0,875744469,875744501,32,218,217,3.1538461538461537
268,2,3,1,875744501,875744533,32,217,219,2.735294117647059
268,3,2,-1,875744533,875744556,23,219,559,3.477272727272727
268,2,1,-1,875744556,875744582,26,559,379,3.35
268,1,3,2,875744582,875744712,130,379,699,3.736842105263158
268,3,3,0,875744712,875744832,120,699,141,3.4827586206896552
268,3,2,-1,875744832,875744895,63,141,1091,2.5384615384615383
268,2,4,2,875744895,875744966,71,1091,189,3.88
268,4,3,-1,875744966,875745160,194,189,955,3.2666666666666666
268,3,3,0,875745160,875745202,42,955,51,3.5277777777777777
268,3,1,-2,875745202,875745231,29,51,402,3.3076923076923075
268,1,3,2,875745231,875745398,167,402,156,4.017857142857143
268,3,1,-2,875745398,875745428,30,156,1157,3.142857142857143
268,1,2,1,875745428,875745453,25,1157,77,3.3857142857142857
268,2,2,0,875745453,875745476,23,77,1273,2.5714285714285716
268,2,3,1,875745476,875745501,25,1273,1046,3.3529411764705883
268,3,2,-1,875745501,875745536,35,1046,1090,2.3529411764705883
268,2,2,0,875745536,875745579,43,1090,370,2.8125
268,2,3,1,875745579,875745728,149,370,223,4.108695652173913
268,3,5,2,875745728,876513584,767856,223,302,4.133333333333334
268,5,3,-2,876513584,876513675,91,302,325,2.625
268,3,4,1,876513675,876513708,33,325,324,3.2291666666666665
268,4,2,-2,876513708,876513785,77,324,790,2.8518518518518516
268,2,4,2,876513785,876513830,45,790,583,3.4285714285714284
268,4,4,0,876513830,876513831,1,583,484,4.116279069767442
268,4,5,1,876513831,876513855,24,484,203,3.826923076923077
268,5,3,-2,876513855,876513897,42,203,561,3.1515151515151514
268,3,2,-1,876513897,876513927,30,561,105,2.6176470588235294
268,2,4,2,876513927,876513953,26,105,7,3.76056338028169
268,4,1,-3,876513953,876514002,49,7,452,2.6129032258064515
268,1,3,2,876514002,876514077,75,452,1110,2.85
268,3,4,1,876514077,876514107,30,1110,433,3.8035714285714284
268,4,2,-2,876514107,876514108,1,433,552,2.8095238095238093
5,4,4,0,875635174,875635189,15,222,121,3.521212121212121
5,4,3,-1,875635189,875635225,36,121,405,3.25
5,3,3,0,875635225,875635265,40,405,250,3.4698795180722892
5,3,3,0,875635265,875635318,53,250,25,3.3185840707964602
5,3,3,0,875635318,875635327,9,25,21,2.9210526315789473
5,3,5,2,875635327,875635349,22,21,100,4.0162162162162165
5,5,1,-4,875635349,875635372,23,100,369,2.5714285714285716
5,1,4,3,875635372,875635384,12,369,235,3.106382978723404
5,4,3,-1,875635384,875635416,32,235,412,2.272727272727273
5,3,1,-2,875635416,875635431,15,412,411,2.911764705882353
5,1,3,2,875635431,875635443,12,411,105,2.6176470588235294
5,3,1,-2,875635443,875635457,14,105,368,1.8823529411764706
5,1,4,3,875635457,875635748,291,368,1,3.902439024390244
5,4,5,1,875635748,875635757,9,1,181,3.98974358974359
5,5,3,-2,875635757,875635807,50,181,413,2.5652173913043477
5,3,3,0,875635807,875635895,88,413,79,3.956989247311828
5,3,2,-1,875635895,875635907,12,79,397,1.5
5,2,2,0,875635907,875635947,40,397,231,2.938775510204082
5,2,1,-1,875635947,875635962,15,231,450,2.2758620689655173
5,1,4,3,875635962,875636014,52,450,183,3.951219512195122
5,4,4,0,875636014,875636033,19,183,435,3.8933333333333335
5,4,3,-1,875636033,875636070,37,435,230,3.3518518518518516
5,3,2,-1,875636070,875636099,29,230,449,2.9069767441860463
5,2,5,3,875636099,875636130,31,449,172,4.225225225225225
5,5,3,-2,875636130,875636141,11,172,144,3.9545454545454546
5,3,3,0,875636141,875636152,11,144,403,3.298507462686567
5,3,2,-1,875636152,875636167,15,403,398,2.1
5,2,4,2,875636167,875636185,18,398,385,3.6129032258064515
5,4,4,0,875636185,875636198,13,385,17,3.032258064516129
5,4,2,-2,875636198,875636230,32,17,386,2.769230769230769
5,2,5,3,875636230,875636265,35,386,396,2.84
5,5,3,-2,875636265,875636297,32,396,90,3.0
5,3,5,2,875636297,875636308,11,90,401,2.6774193548387095
5,5,5,0,875636308,875636340,32,401,390,4.0
5,5,5,0,875636340,875636360,20,390,42,3.893617021276596
5,5,5,0,875636360,875636375,15,42,153,3.7865168539325844
5,5,4,-1,875636375,875636389,14,153,70,3.5833333333333335
5,4,1,-3,875636389,875636493,104,70,110,2.25
5,1,1,0,875636493,875636540,47,110,381,3.2758620689655173
5,1,1,0,875636540,875636571,31,381,451,3.207792207792208
5,1,5,4,875636571,875636587,16,451,382,3.764705882352941
5,5,5,0,875636587,875636588,1,382,428,3.744186046511628
5,5,4,-1,875636588,875636631,43,428,211,3.958904109589041
5,4,4,0,875636631,875636655,24,211,239,3.423076923076923
5,4,4,0,875636655,875636675,20,239,173,4.1441441441441444
5,4,4,0,875636675,875636767,92,173,422,3.25
5,4,4,0,875636767,875636793,26,422,432,3.719298245614035
5,4,3,-1,875636793,875636815,22,432,143,3.56
5,3,3,0,875636815,875636830,15,143,417,3.0588235294117645
5,3,1,-2,875636830,875636842,12,417,415,2.6666666666666665
5,1,3,2,875636842,875636905,63,415,374,2.111111111111111
5,3,4,1,875636905,875637023,118,374,29,2.5714285714285716
5,4,5,1,875637023,875637033,10,29,434,3.588235294117647
5,5,1,-4,875637033,875637144,111,434,365,2.95
5,1,3,2,875637144,875637145,1,365,366,3.4285714285714284
5,3,3,0,875637145,875637191,46,366,380,3.4878048780487805
5,3,3,0,875637191,875637419,228,380,387,3.5357142857142856
5,3,3,0,875637419,875637429,10,387,429,3.742857142857143
5,3,2,-1,875637429,875637440,11,429,425,3.7027027027027026
5,2,3,1,875637440,875637485,45,425,214,3.272727272727273
5,3,4,1,875637485,875637536,51,214,135,3.7974683544303796
5,4,3,-1,875637536,875637587,51,135,375,2.076923076923077
5,3,3,0,875637587,875720692,83105,375,185,3.9726027397260273
5,3,5,2,875720692,875720717,25,185,436,3.5
5,5,3,-2,875720717,875720744,27,436,445,3.727272727272727
5,3,2,-1,875720744,875720762,18,445,444,2.6842105263157894
5,2,3,1,875720762,875720814,52,444,379,3.35
5,3,1,-2,875720814,875720830,16,379,145,2.3636363636363638
5,1,4,3,875720830,875720845,15,145,446,2.0
5,4,1,-3,875720845,875720947,102,446,402,3.3076923076923075
5,1,1,0,875720947,875720948,1,402,241,3.5625
5,1,1,0,875720948,875720967,19,241,371,3.0
5,1,1,0,875720967,875721019,52,371,421,3.462962962962963
5,1,3,2,875721019,875721167,148,421,427,4.2025316455696204
5,3,4,1,875721167,875721168,1,427,95,3.8194444444444446
5,4,3,-1,875721168,875721196,28,95,102,3.3684210526315788
5,3,3,0,875721196,875721216,20,102,418,3.825
5,3,1,-2,875721216,875721315,99,418,389,3.272727272727273
5,1,1,0,875721315,875721432,117,389,454,3.0
5,1,1,0,875721432,875721555,123,454,69,3.8015873015873014
5,1,1,0,875721555,875721572,17,69,162,3.4651162790697674
5,1,1,0,875721572,878844208,3122636,162,259,2.492063492063492
5,1,1,0,878844208,878844397,189,259,452,2.6129032258064515
5,1,1,0,878844397,878844423,26,452,437,1.0
5,1,5,4,878844423,878844495,72,437,189,3.88
5,5,5,0,878844495,878844510,15,189,101,3.4827586206896552
5,5,1,-4,878844510,878844615,105,101,377,1.75
5,1,1,0,878844615,878844629,14,377,63,3.125
5,1,1,0,878844629,878844630,1,63,400,2.375
5,1,2,1,878844630,878844651,21,400,409,2.9615384615384617
5,2,2,0,878844651,879198031,353380,409,394,3.5714285714285716
5,2,2,0,879198031,879198045,14,394,376,2.9166666666666665
5,2,4,2,879198045,879198109,64,376,40,2.7037037037037037
5,4,1,-3,879198109,879198183,74,40,410,3.0434782608695654
5,1,4,3,879198183,879198229,46,410,24,3.3728813559322033
80,4,1,-3,883605055,883605215,160,303,260,2.4716981132075473
80,1,4,3,883605215,883605238,23,260,886,2.857142857142857
80,4,4,0,883605238,887401307,3796069,886,87,3.9
80,4,5,1,887401307,887401328,21,87,483,4.475609756097561
80,5,5,0,887401328,887401353,25,483,215,3.662921348314607
80,5,5,0,887401353,887401453,100,215,100,4.0162162162162165
80,5,5,0,887401453,887401475,22,100,64,4.373737373737374
80,5,5,0,887401475,887401496,21,64,86,3.869565217391304
80,5,5,0,887401496,887401533,37,86,205,3.717391304347826
80,5,4,-1,887401533,887401585,52,205,45,4.130434782608695
80,4,3,-1,887401585,887401643,58,45,423,3.7016129032258065
80,3,4,1,887401643,887401677,34,423,58,3.543859649122807
80,4,3,-1,887401677,887401701,24,58,582,3.7457627118644066
80,3,4,1,887401701,887401732,31,582,237,3.7315436241610738
80,4,3,-1,887401732,887401763,31,237,194,4.029411764705882
66,4,5,1,883601156,883601236,80,127,50,4.306532663316583
66,5,4,-1,883601236,883601265,29,50,9,3.8878504672897196
66,4,3,-1,883601265,883601266,1,9,282,3.610526315789474
66,3,5,2,883601266,883601296,30,282,471,3.5714285714285716
66,5,4,-1,883601296,883601324,28,471,298,3.779220779220779
66,4,4,0,883601324,883601387,63,298,508,3.6923076923076925
66,4,4,0,883601387,883601426,39,508,248,3.746268656716418
66,4,3,-1,883601426,883601456,30,248,597,3.2771084337349397
66,3,4,1,883601456,883601607,151,597,288,3.5214285714285714
66,4,3,-1,883601607,883601787,180,288,117,3.689189189189189
66,3,3,0,883601787,883601812,25,117,284,3.1547619047619047
66,3,3,0,883601812,883601834,22,284,121,3.521212121212121
66,3,3,0,883601834,883601859,25,121,1016,3.559322033898305
66,3,1,-2,883601859,883601939,80,1016,21,2.9210526315789473
66,1,3,2,883601939,883601990,51,21,405,3.25
66,3,4,1,883601990,883602044,54,405,281,3.2
66,4,4,0,883602044,883602158,114,281,249,3.3275862068965516
66,4,3,-1,883602158,883602268,110,249,825,2.914285714285714
18,3,4,1,880129388,880129454,66,188,663,3.948717948717949
18,4,4,0,880129454,880129489,35,663,528,4.241379310344827
18,4,4,0,880129489,880129527,38,528,165,3.9130434782608696
18,4,3,-1,880129527,880129628,101,165,178,4.378378378378378
18,3,5,2,880129628,880129668,40,178,127,4.162790697674419
18,5,4,-1,880129668,880129731,63,127,26,3.36
18,4,5,1,880129731,880129816,85,26,189,3.88
18,5,5,0,880129816,880129877,61,189,134,4.174603174603175
18,5,3,-2,880129877,880129991,114,134,237,3.7315436241610738
18,3,3,0,880129991,880130065,74,237,89,3.9615384615384617
18,3,4,1,880130065,880130109,44,89,527,3.823529411764706
18,4,4,0,880130109,880130110,1,527,654,4.119047619047619
18,4,4,0,880130110,880130155,45,654,387,3.5357142857142856
18,4,3,-1,880130155,880130193,38,387,443,3.8421052631578947
18,3,5,2,880130193,880130393,200,443,187,4.215189873417722
18,5,4,-1,880130393,880130431,38,187,175,3.8354430379746836
18,4,5,1,880130431,880130470,39,175,496,4.094594594594595
18,5,3,-2,880130470,880130515,45,496,202,3.730337078651685
18,3,5,2,880130515,880130550,35,202,9,3.8878504672897196
18,5,5,0,880130550,880130551,1,9,283,3.901639344262295
18,5,3,-2,880130551,880130582,31,283,19,3.9615384615384617
18,3,3,0,880130582,880130613,31,19,198,4.04
18,3,3,0,880130613,880130640,27,198,705,3.7857142857142856
18,3,3,0,880130640,880130713,73,705,42,3.893617021276596
18,3,5,2,880130713,880130739,26,42,45,4.130434782608695
18,5,5,0,880130739,880130764,25,45,6,4.333333333333333
18,5,5,0,880130764,880130802,38,6,699,3.736842105263158
18,5,4,-1,880130802,880130803,1,699,61,4.190476190476191
18,4,5,1,880130803,880130829,26,61,99,3.8392857142857144
18,5,4,-1,880130829,880130861,32,99,614,3.727272727272727
18,4,3,-1,880130861,880130890,29,614,88,3.433734939759036
18,3,3,0,880130890,880130930,40,88,215,3.662921348314607
18,3,4,1,880130930,880131004,74,215,131,3.731707317073171
18,4,4,0,880131004,880131028,24,131,736,4.083333333333333
18,4,5,1,880131028,880131054,26,736,210,3.921259842519685
18,5,2,-3,880131054,880131077,23,210,778,3.5925925925925926
18,2,3,1,880131077,880131106,29,778,234,3.7674418604651163
18,3,4,1,880131106,880131143,37,234,463,3.6818181818181817
18,4,4,0,880131143,880131173,30,463,142,3.1481481481481484
18,4,4,0,880131173,880131201,28,142,588,3.8358208955223883
18,4,3,-1,880131201,880131262,61,588,47,3.5869565217391304
18,3,3,0,880131262,880131325,63,47,428,3.744186046511628
18,3,4,1,880131325,880131326,1,428,162,3.4651162790697674
18,4,5,1,880131326,880131358,32,162,211,3.958904109589041
18,5,5,0,880131358,880131450,92,211,582,3.7457627118644066
18,5,4,-1,880131450,880131474,24,582,143,3.56
18,4,5,1,880131474,880131497,23,143,13,3.5454545454545454
18,5,3,-2,880131497,880131525,28,13,241,3.5625
18,3,3,0,880131525,880131559,34,241,486,3.9565217391304346
18,3,4,1,880131559,880131591,32,486,612,4.0
18,4,3,-1,880131591,880131631,40,612,181,3.98974358974359
18,3,5,2,880131631,880131676,45,181,856,4.142857142857143
18,5,3,-2,880131676,880131698,22,856,732,3.6266666666666665
18,3,3,0,880131698,880131728,30,732,66,3.4705882352941178
18,3,3,0,880131728,880131775,47,66,200,3.8157894736842106
18,3,3,0,880131775,880131776,1,200,739,3.391304347826087
18,3,3,0,880131776,880131804,28,739,378,3.6904761904761907
18,3,3,0,880131804,880131830,26,378,961,3.4545454545454546
18,3,3,0,880131830,880131849,19,961,157,3.5714285714285716
18,3,3,0,880131849,880131878,29,157,794,3.6
18,3,4,1,880131878,880132012,134,794,965,3.7142857142857144
18,4,3,-1,880132012,880132055,43,965,737,3.12
18,3,4,1,880132055,880132078,23,737,214,3.272727272727273
18,4,2,-2,880132078,880132129,51,214,32,3.7222222222222223
18,2,3,1,880132129,880132188,59,32,957,3.0
18,3,3,0,880132188,880132225,37,957,747,3.5526315789473686
18,3,3,0,880132225,880132252,27,747,964,3.0
18,3,5,2,880132252,880132437,185,964,132,3.929411764705882
18,5,5,0,880132437,880132501,64,132,64,4.373737373737374
26,4,4,0,891347478,891347537,59,269,300,3.6861313868613137
26,4,4,0,891347537,891348011,474,300,304,3.5306122448979593
26,4,3,-1,891348011,891348070,59,304,271,3.3134328358208953
26,3,2,-1,891348070,891349184,1114,271,323,3.0
26,2,4,2,891349184,891350566,1382,323,129,3.744186046511628
26,4,3,-1,891350566,891350625,59,129,1,3.902439024390244
26,3,3,0,891350625,891350750,125,1,150,3.803921568627451
26,3,3,0,891350750,891350826,76,150,475,3.956043956043956
26,3,2,-1,891350826,891352941,2115,475,116,3.6666666666666665
26,2,3,1,891352941,891371437,18496,116,111,3.5106382978723403
26,3,3,0,891371437,891371506,69,111,455,3.1702127659574466
26,3,3,0,891371506,891371596,90,455,257,3.7154471544715446
26,3,2,-1,891371596,891371597,1,257,815,3.135135135135135
26,2,3,1,891371597,891371676,79,815,685,3.2666666666666666
26,3,3,0,891371676,891376987,5311,685,109,3.282608695652174
26,3,3,0,891376987,891377540,553,109,148,3.2131147540983607
26,3,3,0,891377540,891377609,69,148,255,3.2027027027027026
26,3,2,-1,891377609,891379753,2144,255,831,2.6097560975609757
26,2,1,-1,891379753,891383899,4146,831,760,2.35
26,1,2,1,891383899,891384478,579,760,1009,3.2962962962962963
26,2,3,1,891384478,891385691,1213,1009,118,3.2764227642276422
26,3,2,-1,891385691,891385692,1,118,926,2.7857142857142856
26,2,2,0,891385692,891386049,357,926,413,2.5652173913043477
26,2,1,-1,891386049,891386174,125,413,456,2.2
26,1,4,3,891386174,891386369,195,456,9,3.8878504672897196
130,4,4,0,874953291,874953424,133,876,330,2.625
130,4,4,0,874953424,874953525,101,330,261,2.7333333333333334
130,4,4,0,874953525,874953526,1,261,678,2.8181818181818183
130,4,4,0,874953526,874953557,31,678,508,3.6923076923076925
130,4,5,1,874953557,874953558,1,508,150,3.803921568627451
130,5,2,-3,874953558,874953595,37,150,864,3.2142857142857144
130,2,5,3,874953595,874953621,26,864,181,3.98974358974359
130,5,5,0,874953621,874953665,44,181,993,3.4838709677419355
130,5,4,-1,874953665,874953698,33,993,246,4.0
130,4,4,0,874953698,874953728,30,246,235,3.106382978723404
130,4,3,-1,874953728,874953794,66,235,109,3.282608695652174
130,3,5,2,874953794,874953825,31,109,111,3.5106382978723403
130,5,4,-1,874953825,874953866,41,111,756,2.6885245901639343
130,4,3,-1,874953866,874953895,29,756,685,3.2666666666666666
130,3,2,-1,874953895,874953928,33,685,471,3.5714285714285716
130,2,4,2,874953928,875216340,262412,471,12,4.358974358974359
130,4,4,0,875216340,875216458,118,12,89,3.9615384615384617
130,4,5,1,875216458,875216507,49,89,202,3.730337078651685
130,5,4,-1,875216507,875216545,38,202,216,3.8454545454545452
130,4,5,1,875216545,875216593,48,216,496,4.094594594594595
130,5,5,0,875216593,875216628,35,496,531,3.7435897435897436
130,5,5,0,875216628,875216717,89,531,144,3.9545454545454546
130,5,3,-2,875216717,875216718,1,144,433,3.8035714285714284
130,3,5,2,875216718,875216786,68,433,99,3.8392857142857144
130,5,4,-1,875216786,875216867,81,99,588,3.8358208955223883
130,4,5,1,875216867,875216932,65,588,234,3.7674418604651163
130,5,5,0,875216932,875216933,1,234,357,4.063291139240507
130,5,5,0,875216933,875216978,45,357,423,3.7016129032258065
130,5,5,0,875216978,875217096,118,423,17,3.032258064516129
130,5,4,-1,875217096,875217172,76,17,28,3.923076923076923
130,4,2,-2,875217172,875217265,93,28,88,3.433734939759036
130,2,4,2,875217265,875217392,127,88,374,2.111111111111111
130,4,3,-1,875217392,875801254,583862,374,335,2.5
130,3,3,0,875801254,875801315,61,335,681,2.25
130,3,3,0,875801315,875801345,30,681,331,3.5517241379310347
130,3,5,2,875801345,875801369,24,331,183,3.951219512195122
130,5,5,0,875801369,875801388,19,183,218,3.5555555555555554
130,5,5,0,875801388,875801470,82,218,195,3.9072164948453607
130,5,5,0,875801470,875801496,26,195,627,3.3823529411764706
130,5,5,0,875801496,875801530,34,627,172,4.225225225225225
130,5,5,0,875801530,875801549,19,172,64,4.373737373737374
130,5,3,-2,875801549,875801573,24,64,436,3.5
130,3,5,2,875801573,875801596,23,436,465,3.75
130,5,5,0,875801596,875801631,35,465,418,3.825
130,5,4,-1,875801631,875801662,31,418,379,3.35
130,4,4,0,875801662,875801716,54,379,203,3.826923076923077
130,4,5,1,875801716,875801750,34,203,282,3.610526315789474
130,5,3,-2,875801750,875801778,28,282,542,2.888888888888889
130,3,4,1,875801778,875801801,23,542,31,3.642857142857143
130,4,5,1,875801801,875801920,119,31,672,2.7222222222222223
130,5,3,-2,875801920,875801940,20,672,217,3.1538461538461537
130,3,5,2,875801940,875801963,23,217,125,3.5555555555555554
130,5,4,-1,875801963,875801984,21,125,405,3.25
130,4,5,1,875801984,875802006,22,405,132,3.929411764705882
130,5,4,-1,875802006,875802058,52,132,161,3.5844155844155843
130,4,5,1,875802058,875802105,47,161,410,3.0434782608695654
130,5,5,0,875802105,875802137,32,410,404,3.6578947368421053
130,5,3,-2,875802137,875802173,36,404,622,3.3333333333333335
130,3,4,1,875802173,875802211,38,622,159,3.3902439024390243
130,4,5,1,875802211,875802236,25,159,684,3.847826086956522
130,5,3,-2,875802236,876250718,448482,684,1014,3.1
130,3,5,2,876250718,876250746,28,1014,249,3.3275862068965516
130,5,3,-2,876250746,876250781,35,249,363,3.0
130,3,2,-1,876250781,876250805,24,363,1088,2.4
130,2,2,0,876250805,876250833,28,1088,1034,2.6
130,2,4,2,876250833,876250850,17,1034,281,3.2
130,4,5,1,876250850,876250897,47,281,3,3.0625
130,5,4,-1,876250897,876250932,35,3,974,3.125
130,4,5,1,876250932,876250955,23,974,532,2.7777777777777777
130,5,4,-1,876250955,876251037,82,532,833,2.9444444444444446
130,4,5,1,876251037,876251053,16,833,742,3.5555555555555554
130,5,3,-2,876251053,876251090,37,742,122,2.282608695652174
130,3,3,0,876251090,876251127,37,122,413,2.5652173913043477
130,3,4,1,876251127,876251160,33,413,929,2.8421052631578947
130,4,4,0,876251160,876251192,32,929,1244,2.7777777777777777
130,4,4,0,876251192,876251287,95,1244,928,3.142857142857143
130,4,5,1,876251287,876251312,25,928,820,3.0444444444444443
130,5,3,-2,876251312,876251341,29,820,1049,2.5714285714285716
130,3,5,2,876251341,876251357,16,1049,975,3.411764705882353
130,5,2,-3,876251357,876251388,31,975,407,2.611111111111111
130,2,2,0,876251388,876251389,1,407,1215,2.0714285714285716
130,2,4,2,876251389,876251409,20,1215,619,3.4782608695652173
130,4,5,1,876251409,876251446,37,619,443,3.8421052631578947
130,5,5,0,876251446,876251515,69,443,419,3.8208955223880596
130,5,3,-2,876251515,876251650,135,419,761,3.0588235294117645
130,3,5,2,876251650,876251693,43,761,469,3.6842105263157894
130,5,4,-1,876251693,876251728,35,469,128,3.45
130,4,4,0,876251728,876251804,76,128,772,3.3333333333333335
130,4,4,0,876251804,876251865,61,772,959,3.4583333333333335
130,4,5,1,876251865,876251895,30,959,54,3.3714285714285714
130,5,3,-2,876251895,876251944,49,54,949,3.392857142857143
130,3,3,0,876251944,876251972,28,949,53,2.9523809523809526
130,3,5,2,876251972,876252012,40,53,746,3.7560975609756095
130,5,4,-1,876252012,876252041,29,746,939,3.6333333333333333
130,4,4,0,876252041,876252042,1,939,944,2.75
130,4,5,1,876252042,876252064,22,944,1058,3.6
130,5,5,0,876252064,876252136,72,1058,802,3.076923076923077
130,5,3,-2,876252136,876252175,39,802,665,2.72972972972973
130,3,5,2,876252175,876252225,50,665,552,2.8095238095238093
130,5,4,-1,876252225,876252263,38,552,38,2.784313725490196
130,4,5,1,876252263,876252288,25,38,1275,3.0
130,5,3,-2,876252288,876252307,19,1275,541,2.9473684210526314
130,3,4,1,876252307,876252327,20,541,2,3.0851063829787235
130,4,4,0,876252327,876252373,46,2,1136,3.3076923076923075
130,4,5,1,876252373,876252420,47,1136,739,3.391304347826087
130,5,5,0,876252420,876252472,52,739,393,3.5125
130,5,4,-1,876252472,876252497,25,393,84,3.0
130,4,4,0,876252497,876252521,24,84,63,3.125
130,4,5,1,876252521,877984734,1732213,63,270,3.7804878048780486
130,5,3,-2,877984734,878537516,552782,270,398,2.1
130,3,3,0,878537516,878537558,42,398,29,2.5714285714285716
130,3,2,-1,878537558,878537602,44,29,450,2.2758620689655173
130,2,2,0,878537602,878537631,29,450,771,2.5714285714285716
130,2,3,1,878537631,878537681,50,771,1228,2.5
130,3,4,1,878537681,878537778,97,1228,1231,2.7
130,4,3,-1,878537778,878537853,75,1231,572,2.857142857142857
130,3,3,0,878537853,880396278,1858425,572,721,3.4583333333333335
130,3,4,1,880396278,880396495,217,721,444,2.6842105263157894
130,4,3,-1,880396495,880396541,46,444,565,2.4285714285714284
130,3,3,0,880396541,880396602,61,565,453,2.0
130,3,3,0,880396602,880396702,100,453,1248,3.0
130,3,2,-1,880396702,880396792,90,1248,1273,2.5714285714285716
130,2,4,2,880396792,880396831,39,1273,1046,3.3529411764705883
130,4,2,-2,880396831,880396881,50,1046,931,2.2758620689655173
130,2,4,2,880396881,881076059,679178,931,682,3.0476190476190474
130,4,3,-1,881076059,881076146,87,682,888,3.0
130,3,3,0,881076146,881076199,53,888,342,2.64
130,3,5,2,881076199,884623799,3547600,342,895,3.142857142857143
130,5,3,-2,884623799,884623832,33,895,892,2.9615384615384617
130,3,4,1,884623832,884623887,55,892,315,4.15
130,4,5,1,884623887,884623983,96,315,538,3.25
130,5,1,-4,884623983,884624044,61,538,901,2.0
130,1,4,3,884624044,884624087,43,901,894,2.0
130,4,4,0,884624087,886023989,1399902,894,350,3.2
130,4,4,0,886023989,888211731,2187742,350,355,2.75
130,4,1,-3,888211731,888211764,33,355,353,2.4285714285714284
130,1,4,3,888211764,888211794,30,353,316,4.285714285714286
130,4,5,1,888211794,888211864,70,316,752,3.6666666666666665
130,5,4,-1,888211864,888211930,66,752,555,2.0
130,4,4,0,888211930,888962754,750824,555,669,2.0
256,5,2,-3,882150122,882150508,386,538,123,3.297872340425532
256,2,5,3,882150508,882150644,136,123,15,3.725663716814159
256,5,5,0,882150644,882150943,299,15,1086,3.857142857142857
256,5,5,0,882150943,882150980,37,1086,1,3.902439024390244
256,5,5,0,882150980,882151017,37,1,591,3.7169811320754715
256,5,4,-1,882151017,882151052,35,591,819,2.6666666666666665
256,4,4,0,882151052,882151088,36,819,405,3.25
256,4,5,1,882151088,882151123,35,405,121,3.521212121212121
256,5,4,-1,882151123,882151198,75,121,866,3.3962264150943398
256,4,4,0,882151198,882151576,378,866,284,3.1547619047619047
256,4,4,0,882151576,882151623,47,284,864,3.2142857142857144
256,4,3,-1,882151623,882151743,120,864,620,3.0
256,3,4,1,882151743,882152509,766,620,597,3.2771084337349397
256,4,5,1,882152509,882152570,61,597,1150,3.0
256,5,3,-2,882152570,882152605,35,1150,406,2.5294117647058822
256,3,3,0,882152605,882152630,25,406,982,3.2
256,3,4,1,882152630,882152943,313,982,831,2.6097560975609757
256,4,4,0,882152943,882153321,378,831,1061,2.9166666666666665
256,4,4,0,882153321,882153699,378,1061,1114,3.2
256,4,4,0,882153699,882153724,25,1114,106,2.8125
256,4,4,0,882153724,882153751,27,106,829,2.4615384615384617
256,4,4,0,882153751,882154058,307,829,977,2.473684210526316
256,4,4,0,882154058,882163677,9619,977,21,2.9210526315789473
256,4,3,-1,882163677,882163730,53,21,934,3.0294117647058822
256,3,1,-2,882163730,882163754,24,934,120,2.3421052631578947
256,1,1,0,882163754,882163778,24,120,368,1.8823529411764706
256,1,2,1,882163778,882163805,27,368,1057,2.7142857142857144
256,2,3,1,882163805,882163834,29,1057,363,3.0
256,3,2,-1,882163834,882163857,23,363,841,2.772727272727273
256,2,3,1,882163857,882163956,99,841,834,2.0
256,3,4,1,882163956,882164037,81,834,595,2.9166666666666665
256,4,3,-1,882164037,882164059,22,595,974,3.125
256,3,5,2,882164059,882164231,172,974,487,4.043478260869565
256,5,5,0,882164231,882164259,28,487,22,4.215909090909091
256,5,3,-2,882164259,882164406,147,22,56,4.051724137931035
256,3,4,1,882164406,882164443,37,56,50,4.306532663316583
256,4,4,0,882164443,882164479,36,50,233,3.323529411764706
256,4,4,0,882164479,882164480,1,233,230,3.3518518518518516
256,4,5,1,882164480,882164525,45,230,89,3.9615384615384617
256,5,3,-2,882164525,882164559,34,89,228,3.7246376811594204
256,3,5,2,882164559,882164603,44,228,583,3.4285714285714284
256,5,1,-4,882164603,882164643,40,583,1228,2.5
256,1,4,3,882164643,882164644,1,1228,761,3.0588235294117645
256,4,5,1,882164644,882164696,52,761,98,4.240875912408759
256,5,5,0,882164696,882164727,31,98,5,3.1481481481481484
256,5,4,-1,882164727,882164867,140,5,1109,3.4545454545454546
256,4,4,0,882164867,882164893,26,1109,44,3.1333333333333333
256,4,4,0,882164893,882164927,34,44,1046,3.3529411764705883
256,4,3,-1,882164927,882164955,28,1046,77,3.3857142857142857
256,3,3,0,882164955,882165032,77,77,1119,3.5185185185185186
256,3,5,2,882165032,882165067,35,1119,732,3.6266666666666665
256,5,4,-1,882165067,882165103,36,732,97,3.7282608695652173
256,4,4,0,882165103,882165135,32,97,51,3.5277777777777777
256,4,4,0,882165135,882165238,103,51,49,3.3
256,4,3,-1,882165238,882165269,31,49,36,2.4
256,3,4,1,882165269,882165296,27,36,785,3.4375
256,4,4,0,882165296,882165328,32,785,765,3.0
1,5,4,-1,874965518,874965556,38,165,156,4.017857142857143
1,4,5,1,874965556,874965677,121,156,166,4.0
1,5,4,-1,874965677,874965678,1,166,187,4.215189873417722
1,4,5,1,874965678,874965706,28,187,14,4.101694915254237
1,5,5,0,874965706,874965739,33,14,181,3.98974358974359
1,5,5,0,874965739,874965758,19,181,1,3.902439024390244
1,5,5,0,874965758,874965905,147,1,246,4.0
1,5,5,0,874965905,874965970,65,246,253,3.5
1,5,5,0,874965970,875071484,105514,253,93,3.5641025641025643
1,5,5,0,875071484,875071515,31,93,19,3.9615384615384617
1,5,5,0,875071515,875071541,26,19,137,3.9545454545454546
1,5,4,-1,875071541,875071561,20,137,146,2.3333333333333335
1,4,5,1,875071561,875071589,28,146,235,3.106382978723404
1,5,2,-3,875071589,875071713,124,235,264,2.65
1,2,2,0,875071713,875071749,36,264,237,3.7315436241610738
1,2,4,2,875071749,875071805,56,237,25,3.3185840707964602
1,4,4,0,875071805,875071823,18,25,121,3.521212121212121
1,4,4,0,875071823,875071843,20,121,251,3.8333333333333335
1,4,3,-1,875071843,875071927,84,251,118,3.2764227642276422
1,3,3,0,875071927,875072002,75,118,130,1.8461538461538463
1,3,4,1,875072002,875072125,123,130,65,3.511111111111111
1,4,3,-1,875072125,875072144,19,65,31,3.642857142857143
1,3,5,2,875072144,875072173,29,31,114,4.3478260869565215
1,5,4,-1,875072173,875072205,32,114,52,3.727272727272727
1,4,4,0,875072205,875072235,30,52,238,3.888888888888889
1,4,4,0,875072235,875072303,68,238,95,3.8194444444444446
1,4,4,0,875072303,875072404,101,95,22,4.215909090909091
1,4,5,1,875072404,875072442,38,22,202,3.730337078651685
1,5,5,0,875072442,875072484,42,202,89,3.9615384615384617
1,5,4,-1,875072484,875072520,36,89,214,3.272727272727273
1,4,4,0,875072520,875072573,53,214,128,3.45
1,4,4,0,875072573,875072631,58,128,185,3.9726027397260273
1,4,4,0,875072631,875072688,57,185,68,3.5714285714285716
1,4,4,0,875072688,875072716,28,68,56,4.051724137931035
1,4,4,0,875072716,875072865,149,56,151,3.6544117647058822
1,4,4,0,875072865,875072895,30,151,23,3.9047619047619047
1,4,5,1,875072895,875072956,61,23,197,4.112676056338028
1,5,4,-1,875072956,875073067,111,197,134,4.174603174603175
1,4,3,-1,875073067,875073128,61,134,97,3.7282608695652173
1,3,3,0,875073128,875073180,52,97,159,3.3902439024390243
1,3,3,0,875073180,875073198,18,159,17,3.032258064516129
1,3,2,-1,875073198,875240739,167541,17,105,2.6176470588235294
1,2,2,0,875240739,875240799,60,105,148,3.2131147540983607
1,2,3,1,875240799,875240993,194,148,147,3.3142857142857145
1,3,3,0,875240993,875241498,505,147,122,2.282608695652174
1,3,1,-2,875241498,875241619,121,122,247,3.0
1,1,4,3,875241619,875692955,451336,247,267,3.3333333333333335
1,4,1,-3,875692955,875692979,24,267,259,2.492063492063492
1,1,1,0,875692979,875693007,28,259,263,2.2
1,1,3,2,875693007,875693118,111,263,10,3.85
1,3,4,1,875693118,876892355,1199237,10,234,3.7674418604651163
1,4,5,1,876892355,876892425,70,234,42,3.893617021276596
1,5,5,0,876892425,876892468,43,42,176,3.967032967032967
1,5,5,0,876892468,876892636,168,176,91,3.6
1,5,4,-1,876892636,876892654,18,91,193,3.883720930232558
1,4,3,-1,876892654,876892676,22,193,217,3.1538461538461537
1,3,5,2,876892676,876892701,25,217,216,3.8454545454545452
1,5,4,-1,876892701,876892743,42,216,194,4.029411764705882
1,4,3,-1,876892743,876892774,31,194,73,3.588235294117647
1,3,5,2,876892774,876892817,43,73,59,4.0
1,5,4,-1,876892817,876892818,1,59,133,3.7777777777777777
1,4,5,1,876892818,876892855,37,133,195,3.9072164948453607
1,5,3,-2,876892855,876892856,1,195,218,3.5555555555555554
1,3,2,-1,876892856,876892896,40,218,213,3.943396226415094
1,2,5,3,876892896,876892918,22,213,223,4.108695652173913
1,5,2,-3,876892918,876892946,28,223,27,3.235294117647059
1,2,4,2,876892946,876893008,62,27,80,2.967741935483871
1,4,3,-1,876893008,876893054,46,80,67,3.106382978723404
1,3,3,0,876893054,876893098,44,67,200,3.8157894736842106
1,3,3,0,876893098,876893145,47,200,215,3.662921348314607
1,3,3,0,876893145,876893171,26,215,2,3.0851063829787235
1,3,4,1,876893171,876893205,34,2,77,3.3857142857142857
1,4,3,-1,876893205,876893206,1,77,136,3.764705882352941
1,3,3,0,876893206,876893230,24,136,153,3.7865168539325844
1,3,5,2,876893230,878541803,1648573,153,173,4.1441441441441444
1,5,4,-1,878541803,878542075,272,173,229,3.185185185185185
1,4,2,-2,878542075,878542201,126,229,155,3.0588235294117645
1,2,4,2,878542201,878542231,30,155,203,3.826923076923077
1,4,3,-1,878542231,878542282,51,203,62,3.048780487804878
1,3,1,-2,878542282,878542327,45,62,219,2.735294117647059
1,1,2,1,878542327,878542383,56,219,167,2.8181818181818183
1,2,4,2,878542383,878542420,37,167,230,3.3518518518518516
1,4,1,-3,878542420,878542441,21,230,112,2.7
1,1,5,4,878542441,878542459,18,112,57,4.133333333333334
1,5,3,-2,878542459,878542478,19,57,49,3.3
1,3,2,-1,878542478,878542552,74,49,233,3.323529411764706
1,2,3,1,878542552,878542608,56,233,141,3.4827586206896552
1,3,4,1,878542608,878542678,70,141,72,3.175438596491228
1,4,4,0,878542678,878542699,21,72,33,3.2941176470588234
1,4,2,-2,878542699,878542738,39,33,225,3.0714285714285716
1,2,2,0,878542738,878542791,53,225,149,2.4
1,2,1,-1,878542791,878542845,54,149,110,2.25
1,1,2,1,878542845,878542869,24,110,34,3.2
1,2,4,2,878542869,878542909,40,34,210,3.921259842519685
1,4,3,-1,878542909,878542960,51,210,201,3.75
1,3,4,1,878542960,878543030,70,201,66,3.4705882352941178
1,4,1,-3,878543030,878543133,103,66,140,3.238095238095238
1,1,2,1,878543133,878543196,63,140,63,3.125
1,2,4,2,878543196,878543238,42,63,75,3.3333333333333335
1,4,4,0,878543238,878543275,37,75,51,3.5277777777777777
1,4,3,-1,878543275,878543308,33,51,54,3.3714285714285714
1,3,2,-1,878543308,885345822,6802514,54,255,3.2027027027027026
1,2,5,3,885345822,887431908,2086086,255,129,3.744186046511628
1,5,5,0,887431908,887431921,13,129,221,3.6923076923076925
1,5,5,0,887431921,887431973,52,221,6,4.333333333333333
1,5,4,-1,887431973,887432020,47,6,18,3.0
1,4,4,0,887432020,888732908,1300888,18,209,3.8275862068965516
1,4,5,1,888732908,888732909,1,209,32,3.7222222222222223
1,5,3,-2,888732909,888732928,19,32,189,3.88
1,3,5,2,888732928,889751711,1018783,189,171,4.090909090909091
1,5,1,-4,889751711,889751736,25,171,74,2.4
56,4,3,-1,892675999,892676028,29,258,323,3.0
56,3,4,1,892676028,892676314,286,323,89,3.9615384615384617
56,4,3,-1,892676314,892676340,26,89,229,3.185185185185185
56,3,5,2,892676340,892676429,89,229,96,3.9130434782608696
56,5,3,-2,892676429,892676430,1,96,227,3.169811320754717
56,3,5,2,892676430,892676908,478,227,204,3.6744186046511627
56,5,4,-1,892676908,892676933,25,204,42,3.893617021276596
56,4,3,-1,892676933,892676970,37,42,451,3.207792207792208
56,3,4,1,892676970,892677047,77,451,393,3.5125
56,4,4,0,892677047,892677094,47,393,73,3.588235294117647
56,4,2,-2,892677094,892677114,20,73,67,3.106382978723404
56,2,4,2,892677114,892677162,48,67,747,3.5526315789473686
56,4,4,0,892677162,892678526,1364,747,191,4.168674698795181
56,4,5,1,892678526,892678547,21,191,215,3.662921348314607
56,5,2,-3,892678547,892678913,366,215,735,3.58
56,2,4,2,892678913,892678942,29,735,403,3.298507462686567
56,4,4,0,892678942,892679088,146,403,184,3.393939393939394
56,4,5,1,892679088,892679144,56,184,219,2.735294117647059
56,5,2,-3,892679144,892679209,65,219,168,4.0476190476190474
56,2,4,2,892679209,892679259,50,168,31,3.642857142857143
56,4,4,0,892679259,892679277,18,31,226,3.378787878787879
56,4,3,-1,892679277,892679333,56,226,761,3.0588235294117645
56,3,3,0,892679333,892679374,41,761,450,2.2758620689655173
56,3,3,0,892679374,892679439,65,450,597,3.2771084337349397
56,3,4,1,892679439,892679460,21,597,118,3.2764227642276422
56,4,5,1,892679460,892679480,20,118,121,3.521212121212121
56,5,3,-2,892679480,892679481,1,121,930,2.793103448275862
56,3,5,2,892679481,892679540,59,930,237,3.7315436241610738
56,5,4,-1,892679540,892683274,3734,237,95,3.8194444444444446
56,4,3,-1,892683274,892683303,29,95,820,3.0444444444444443
56,3,2,-1,892683303,892683323,20,820,473,2.9166666666666665
56,2,3,1,892683323,892683353,30,473,993,3.4838709677419355
56,3,4,1,892683353,892683533,180,993,636,3.4146341463414633
56,4,2,-2,892683533,892683611,78,636,281,3.2
56,2,3,1,892683611,892683641,30,281,1090,2.3529411764705883
56,3,4,1,892683641,892683695,54,1090,298,3.779220779220779
56,4,2,-2,892683695,892683877,182,298,111,3.5106382978723403
56,2,1,-1,892683877,892683895,18,111,88,3.433734939759036
56,1,4,3,892683895,892683913,18,88,280,3.103448275862069
56,4,3,-1,892683913,892683941,28,280,1074,2.857142857142857
56,3,4,1,892683941,892737191,53250,1074,173,4.1441441441441444
56,4,4,0,892737191,892737210,19,173,946,3.1153846153846154
56,4,3,-1,892737210,892910207,172997,946,755,3.085714285714286
56,3,4,1,892910207,892910247,40,755,399,3.317073170731707
56,4,3,-1,892910247,892910268,21,399,623,3.0454545454545454
56,3,4,1,892910268,892910292,24,623,94,2.8823529411764706
56,4,4,0,892910292,892910604,312,94,201,3.75
56,4,4,0,892910604,892910646,42,201,559,3.477272727272727
56,4,5,1,892910646,892910796,150,559,144,3.9545454545454546
56,5,4,-1,892910796,892910797,1,144,568,3.5853658536585367
56,4,4,0,892910797,892910890,93,568,161,3.5844155844155843
56,4,2,-2,892910890,892910913,23,161,849,2.5625
56,2,3,1,892910913,892910931,18,849,231,2.938775510204082
56,3,3,0,892910931,892910950,19,231,391,2.4285714285714284
56,3,3,0,892910950,892911110,160,391,66,3.4705882352941178
56,3,2,-1,892911110,892911144,34,66,154,3.6031746031746033
56,2,4,2,892911144,892911166,22,154,25,3.3185840707964602
56,4,4,0,892911166,892911227,61,25,1028,2.857142857142857
56,4,1,-3,892911227,892911247,20,1028,715,3.257142857142857
56,1,3,2,892911247,892911290,43,715,372,3.6666666666666665
56,3,4,1,892911290,892911348,58,372,410,3.0434782608695654
56,4,3,-1,892911348,892911366,18,410,585,2.5384615384615383
56,3,3,0,892911366,892911420,54,585,728,3.05
56,3,3,0,892911420,892911469,49,728,575,2.619047619047619
56,3,3,0,892911469,892911494,25,575,167,2.8181818181818183
56,3,3,0,892911494,892911539,45,167,158,2.7027027027027026
56,3,3,0,892911539,892911573,34,158,1092,2.5714285714285716
56,3,3,0,892911573,892911589,16,1092,368,1.8823529411764706
15,5,5,0,879455080,879455128,48,754,292,3.6666666666666665
15,5,3,-2,879455128,879455192,64,292,328,3.4895833333333335
15,3,3,0,879455192,879455262,70,328,748,3.1043478260869564
15,3,3,0,879455262,879455311,49,748,879,3.2291666666666665
15,3,5,2,879455311,879455334,23,879,308,3.6153846153846154
15,5,1,-4,879455334,879455362,28,308,243,2.357142857142857
15,1,4,3,879455362,879455505,143,243,283,3.901639344262295
15,4,2,-2,879455505,879455541,36,283,251,3.8333333333333335
15,2,4,2,879455541,879455562,21,251,275,4.087912087912088
15,4,4,0,879455562,879455659,97,275,14,4.101694915254237
15,4,5,1,879455659,879455710,51,14,181,3.98974358974359
15,5,3,-2,879455710,879455730,20,181,222,3.578125
15,3,2,-1,879455730,879455764,34,222,925,3.0
15,2,4,2,879455764,879455789,25,925,744,3.5714285714285716
15,4,2,-2,879455789,879455821,32,744,591,3.7169811320754715
15,2,1,-1,879455821,879455843,22,591,278,3.0357142857142856
15,1,1,0,879455843,879455871,28,278,248,3.746268656716418
15,1,4,3,879455871,879455939,68,248,137,3.9545454545454546
15,4,2,-2,879455939,879455957,18,137,405,3.25
15,2,3,1,879455957,879456049,92,405,148,3.2131147540983607
15,3,4,1,879456049,879456084,35,148,471,3.5714285714285716
15,4,3,-1,879456084,879456167,83,471,280,3.103448275862069
15,3,3,0,879456167,879456168,1,280,121,3.521212121212121
15,3,1,-2,879456168,879456204,36,121,473,2.9166666666666665
15,1,4,3,879456204,879456231,27,473,864,3.2142857142857144
15,4,4,0,879456231,879456288,57,864,866,3.3962264150943398
15,4,3,-1,879456288,879456324,36,866,409,2.9615384615384617
15,3,2,-1,879456324,879456351,27,409,411,2.911764705882353
15,2,2,0,879456351,879456381,30,411,930,2.793103448275862
15,2,4,2,879456381,879456404,23,930,476,3.1216216216216215
15,4,1,-3,879456404,879456447,43,476,933,2.5
15,1,1,0,879456447,879456465,18,933,932,2.5
207,2,4,2,875503932,875503973,41,475,56,4.051724137931035
207,4,2,-2,875503973,875504835,862,56,276,3.6036036036036037
207,2,4,2,875504835,875504876,41,276,14,4.101694915254237
207,4,3,-1,875504876,875506737,1861,14,70,3.5833333333333335
207,3,3,0,875506737,875506771,34,70,202,3.730337078651685
207,3,3,0,875506771,875506839,68,202,13,3.5454545454545454
207,3,3,0,875506839,875508783,1944,13,716,3.1904761904761907
207,3,3,0,875508783,875508873,90,716,367,3.4242424242424243
207,3,3,0,875508873,875509262,389,367,22,4.215909090909091
207,3,3,0,875509262,875509307,45,22,195,3.9072164948453607
207,3,3,0,875509307,875509346,39,195,385,3.6129032258064515
207,3,4,1,875509346,875509395,49,385,568,3.5853658536585367
207,4,3,-1,875509395,875509507,112,568,38,2.784313725490196
207,3,4,1,875509507,875509787,280,38,1046,3.3529411764705883
207,4,4,0,875509787,875509832,45,1046,185,3.9726027397260273
207,4,4,0,875509832,875509888,56,185,23,3.9047619047619047
207,4,5,1,875509888,875774491,264603,23,483,4.475609756097561
207,5,3,-2,875774491,875991116,216625,483,642,3.4285714285714284
207,3,4,1,875991116,875991160,44,642,134,4.174603174603175
207,4,3,-1,875991160,876018501,27341,134,841,2.772727272727273
207,3,3,0,876018501,876018608,107,841,291,3.2
207,3,3,0,876018608,876079016,60408,291,239,3.423076923076923
207,3,4,1,876079016,876079113,97,239,25,3.3185840707964602
207,4,4,0,876079113,876198392,119279,25,15,3.725663716814159
207,4,4,0,876198392,876198457,65,15,4,3.5538461538461537
207,4,4,0,876198457,877124663,926206,4,191,4.168674698795181
207,4,4,0,877124663,877124806,143,191,468,3.380952380952381
207,4,3,-1,877124806,877124847,41,468,233,3.323529411764706
207,3,5,2,877124847,877124871,24,233,318,4.5046728971962615
207,5,3,-2,877124871,877125249,378,318,82,3.6741573033707864
207,3,2,-1,877125249,877125350,101,82,68,3.5714285714285716
207,2,2,0,877125350,877125390,40,68,226,3.378787878787879
207,2,2,0,877125390,877125422,32,226,33,3.2941176470588234
207,2,5,3,877125422,877750617,625195,33,153,3.7865168539325844
207,5,3,-2,877750617,877750701,84,153,411,2.911764705882353
207,3,3,0,877750701,877750738,37,411,864,3.2142857142857144
207,3,3,0,877750738,877751037,299,864,129,3.744186046511628
207,3,2,-1,877751037,877751143,106,129,826,2.5555555555555554
207,2,4,2,877751143,877822224,71081,826,179,3.8823529411764706
207,4,2,-2,877822224,877822350,126,179,135,3.7974683544303796
207,2,2,0,877822350,877822854,504,135,554,2.9555555555555557
207,2,3,1,877822854,877838946,16092,554,410,3.0434782608695654
207,3,4,1,877838946,877838977,31,410,393,3.5125
207,4,3,-1,877838977,877845656,6679,393,462,3.7954545454545454
207,3,3,0,877845656,877845763,107,462,255,3.2027027027027026
207,3,3,0,877845763,877845845,82,255,60,4.105263157894737
207,3,1,-2,877845845,877845982,137,60,175,3.8354430379746836
207,1,4,3,877845982,877847100,1118,175,660,3.71875
207,4,3,-1,877847100,877847150,50,660,150,3.803921568627451
207,3,2,-1,877847150,877847187,37,150,631,3.581818181818182
207,2,4,2,877847187,877878343,31156,631,514,4.033333333333333
207,4,3,-1,877878343,877878384,41,514,986,2.5555555555555554
207,3,3,0,877878384,877878409,25,986,248,3.746268656716418
207,3,3,0,877878409,877878424,15,248,832,2.7142857142857144
207,3,3,0,877878424,877878714,290,832,1378,2.5
207,3,2,-1,877878714,877878739,25,1378,18,3.0
207,2,2,0,877878739,877878772,33,18,1350,2.0
207,2,3,1,877878772,877878828,56,1350,181,3.98974358974359
207,3,3,0,877878828,877878860,32,181,1049,2.5714285714285716
207,3,3,0,877878860,877878883,23,1049,978,2.357142857142857
207,3,2,-1,877878883,877878923,40,978,756,2.6885245901639343
207,2,4,2,877878923,877879173,250,756,186,3.905263157894737
207,4,3,-1,877879173,877879206,33,186,993,3.4838709677419355
207,3,3,0,877879206,877995673,116467,993,1331,3.5
207,3,3,0,877995673,878104017,108344,1331,1118,3.533333333333333
207,3,3,0,878104017,878104200,183,1118,12,4.358974358974359
207,3,3,0,878104200,878104245,45,12,11,3.8904109589041096
207,3,3,0,878104245,878104377,132,11,131,3.731707317073171
207,3,2,-1,878104377,878104438,61,131,156,4.017857142857143
207,2,3,1,878104438,878104594,156,156,65,3.511111111111111
207,3,2,-1,878104594,878104627,33,65,88,3.433734939759036
207,2,2,0,878104627,878191632,87005,88,160,3.4
207,2,4,2,878191632,878191679,47,160,208,3.8125
207,4,3,-1,878191679,878191750,71,208,722,2.9642857142857144
207,3,3,0,878191750,878191798,48,722,158,2.7027027027027026
207,3,4,1,878191798,879577372,1385574,158,282,3.610526315789474
207,4,2,-2,879577372,879664906,87534,282,1115,3.3846153846153846
207,2,3,1,879664906,879665232,326,1115,580,3.625
207,3,4,1,879665232,879665302,70,580,520,4.136363636363637
207,4,3,-1,879665302,879665352,50,520,180,3.9473684210526314
207,3,3,0,879665352,879665381,29,180,470,3.72
207,3,3,0,879665381,880839891,1174510,470,1102,2.6
207,3,1,-2,880839891,881681725,841834,1102,53,2.9523809523809526
207,1,3,2,881681725,884386473,2704748,53,224,3.4545454545454546
207,3,4,1,884386473,891759118,7372645,224,302,4.133333333333334
232,4,4,0,880062302,880062330,28,50,181,3.98974358974359
232,4,2,-2,880062330,880062413,83,181,515,4.202898550724638
232,2,3,1,880062413,880062414,1,515,471,3.5714285714285716
232,3,4,1,880062414,880062574,160,471,14,4.101694915254237
232,4,4,0,880062574,880062618,44,14,250,3.4698795180722892
232,4,3,-1,880062618,880062645,27,250,744,3.5714285714285716
232,3,4,1,880062645,885939511,5876866,744,272,4.2
232,4,4,0,885939511,888549412,2609901,272,44,3.1333333333333333
232,4,4,0,888549412,888549441,29,44,64,4.373737373737374
232,4,4,0,888549441,888549467,26,64,32,3.7222222222222223
232,4,4,0,888549467,888549515,48,32,202,3.730337078651685
232,4,4,0,888549515,888549595,80,202,423,3.7016129032258065
232,4,5,1,888549595,888549622,27,423,483,4.475609756097561
232,5,4,-1,888549622,888549647,25,483,531,3.7435897435897436
232,4,5,1,888549647,888549674,27,531,1149,3.857142857142857
232,5,5,0,888549674,888549757,83,1149,318,4.5046728971962615
232,5,5,0,888549757,888549815,58,318,175,3.8354430379746836
232,5,5,0,888549815,888549838,23,175,705,3.7857142857142856
232,5,4,-1,888549838,888549879,41,705,462,3.7954545454545454
232,4,5,1,888549879,888549929,50,462,170,4.242424242424242
232,5,5,0,888549929,888549988,59,170,178,4.378378378378378
232,5,4,-1,888549988,888550013,25,178,419,3.8208955223880596
232,4,3,-1,888550013,888550036,23,419,919,4.0
232,3,5,2,888550036,888550130,94,919,52,3.727272727272727
232,5,3,-2,888550130,891565128,3014998,52,117,3.689189189189189
52,5,5,0,882922065,882922140,75,258,919,4.0
52,5,5,0,882922140,882922204,64,919,15,3.725663716814159
52,5,5,0,882922204,882922227,23,15,285,4.181818181818182
52,5,5,0,882922227,882922249,22,285,151,3.6544117647058822
52,5,4,-1,882922249,882922302,53,151,741,3.3043478260869565
52,4,4,0,882922302,882922328,26,741,116,3.6666666666666665
52,4,4,0,882922328,882922357,29,116,111,3.5106382978723403
52,4,5,1,882922357,882922407,50,111,19,3.9615384615384617
52,5,4,-1,882922407,882922454,47,19,1085,4.0
52,4,5,1,882922454,882922485,31,1085,13,3.5454545454545454
52,5,4,-1,882922485,882922540,55,13,107,3.45
52,4,4,0,882922540,882922562,22,107,471,3.5714285714285716
52,4,4,0,882922562,882922588,26,471,1011,3.1
52,4,5,1,882922588,882922589,1,1011,126,3.8620689655172415
52,5,4,-1,882922589,882922610,21,126,405,3.25
52,4,4,0,882922610,882922629,19,405,748,3.1043478260869564
52,4,3,-1,882922629,882922806,177,748,762,3.3962264150943398
52,3,5,2,882922806,882922833,27,762,427,4.2025316455696204
52,5,5,0,882922833,882922927,94,427,463,3.6818181818181817
52,5,5,0,882922927,882922948,21,463,498,4.290909090909091
52,5,5,0,882922948,882922974,26,498,318,4.5046728971962615
52,5,4,-1,882922974,882923012,38,318,204,3.6744186046511627
161,2,2,0,891169991,891170018,27,286,309,2.3333333333333335
161,2,3,1,891170018,891170191,173,309,898,3.0869565217391304
161,3,2,-1,891170191,891170656,465,898,135,3.7974683544303796
161,2,3,1,891170656,891170686,30,135,523,4.159090909090909
161,3,1,-2,891170686,891170745,59,523,48,4.055555555555555
161,1,5,4,891170745,891170769,24,48,202,3.730337078651685
161,5,3,-2,891170769,891170824,55,202,318,4.5046728971962615
161,3,5,2,891170824,891170881,57,318,276,3.6036036036036037
161,5,2,-3,891170881,891170972,91,276,50,4.306532663316583
161,2,2,0,891170972,891171023,51,50,133,3.7777777777777777
161,2,2,0,891171023,891171104,81,133,435,3.8933333333333335
161,2,4,2,891171104,891171127,23,435,100,4.0162162162162165
161,4,1,-3,891171127,891171174,47,100,168,4.0476190476190474
161,1,3,2,891171174,891171214,40,168,483,4.475609756097561
161,3,3,0,891171214,891171257,43,483,56,4.051724137931035
161,3,2,-1,891171257,891171282,25,56,22,4.215909090909091
161,2,3,1,891171282,891171357,75,22,654,4.119047619047619
161,3,2,-1,891171357,891171413,56,654,162,3.4651162790697674
161,2,1,-1,891171413,891171458,45,162,132,3.929411764705882
161,1,1,0,891171458,891171503,45,132,194,4.029411764705882
161,1,2,1,891171503,891171558,55,194,640,2.75
161,2,2,0,891171558,891171597,39,640,265,3.710144927536232
161,2,4,2,891171597,891171657,60,265,69,3.8015873015873014
161,4,2,-2,891171657,891171698,41,69,210,3.921259842519685
161,2,2,0,891171698,891171734,36,210,191,4.168674698795181
161,2,2,0,891171734,891171848,114,191,177,3.875
161,2,2,0,891171848,891171887,39,177,213,3.943396226415094
161,2,2,0,891171887,891172070,183,213,274,3.5609756097560976
161,2,3,1,891172070,891172174,104,274,257,3.7154471544715446
161,3,3,0,891172174,891172246,72,257,284,3.1547619047619047
161,3,2,-1,891172246,891172284,38,284,15,3.725663716814159
161,2,1,-1,891172284,891172358,74,15,473,2.9166666666666665
161,1,3,2,891172358,891172402,44,473,1117,3.0
161,3,2,-1,891172402,891172421,19,1117,118,3.2764227642276422
148,4,5,1,877016514,877016605,91,228,509,3.7058823529411766
148,5,5,0,877016605,877016735,130,509,357,4.063291139240507
148,5,3,-2,877016735,877016912,177,357,204,3.6744186046511627
148,3,5,2,877016912,877017054,142,204,7,3.76056338028169
148,5,4,-1,877017054,877019411,2357,7,1,3.902439024390244
148,4,5,1,877019411,877019882,471,1,474,4.172413793103448
148,5,4,-1,877019882,877021402,1520,474,163,3.53125
148,4,3,-1,877021402,877021535,133,163,713,3.5
148,3,4,1,877021535,877398444,376909,713,164,3.6140350877192984
148,4,4,0,877398444,877398586,142,164,238,3.888888888888889
148,4,5,1,877398586,877398648,62,238,209,3.8275862068965516
148,5,1,-4,877398648,877398836,188,209,521,3.787878787878788
148,1,5,4,877398836,877398901,65,521,529,4.142857142857143
148,5,5,0,877398901,877399018,117,529,408,4.4772727272727275
148,5,5,0,877399018,877399135,117,408,181,3.98974358974359
148,5,5,0,877399135,877399322,187,181,473,2.9166666666666665
148,5,1,-4,877399322,877399351,29,473,127,4.162790697674419
148,1,4,3,877399351,877400154,803,127,1012,3.2916666666666665
125,5,5,0,879454100,879454197,97,79,144,3.9545454545454546
125,5,5,0,879454197,879454243,46,144,210,3.921259842519685
125,5,3,-2,879454243,879454244,1,210,208,3.8125
125,3,3,0,879454244,879454385,141,208,97,3.7282608695652173
125,3,5,2,879454385,879454386,1,97,82,3.6741573033707864
125,5,2,-3,879454386,879454419,33,82,153,3.7865168539325844
125,2,3,1,879454419,879454448,29,153,186,3.905263157894737
125,3,5,2,879454448,879454532,84,186,275,4.087912087912088
125,5,4,-1,879454532,879454628,96,275,483,4.475609756097561
125,4,4,0,879454628,879454699,71,483,1060,3.235294117647059
125,4,4,0,879454699,879454793,94,1060,648,3.9545454545454546
125,4,1,-3,879454793,879454891,98,648,236,3.2666666666666666
125,1,1,0,879454891,879454892,1,236,372,3.6666666666666665
125,1,3,2,879454892,879454956,64,372,663,3.948717948717949
125,3,5,2,879454956,879454986,30,663,194,4.029411764705882
125,5,4,-1,879454986,879455019,33,194,732,3.6266666666666665
125,4,5,1,879455019,892835624,13380605,732,258,3.7547169811320753
125,5,4,-1,892835624,892835778,154,258,294,3.1052631578947367
125,4,1,-3,892835778,892835800,22,294,346,3.5128205128205128
125,1,5,4,892835800,892835836,36,346,300,3.6861313868613137
125,5,5,0,892835836,892835854,18,300,289,2.988888888888889
125,5,3,-2,892835854,892836124,270,289,323,3.0
125,3,3,0,892836124,892836268,144,323,687,2.1481481481481484
125,3,5,2,892836268,892836309,41,687,520,4.136363636363637
125,5,5,0,892836309,892836395,86,520,498,4.290909090909091
125,5,3,-2,892836395,892836422,27,498,474,4.172413793103448
125,3,5,2,892836422,892836464,42,474,87,3.9
125,5,5,0,892836464,892836465,1,87,222,3.578125
125,5,3,-2,892836465,892836523,58,222,692,3.56
125,3,4,1,892836523,892836550,27,692,435,3.8933333333333335
125,4,3,-1,892836550,892836574,24,435,763,3.347826086956522
125,3,1,-2,892836574,892836623,49,763,382,3.764705882352941
125,1,1,0,892836623,892838351,1728,382,508,3.6923076923076925
125,1,4,3,892838351,892838375,24,508,290,3.108108108108108
125,4,3,-1,892838375,892838424,49,290,996,2.1666666666666665
125,3,3,0,892838424,892838425,1,996,728,3.05
125,3,4,1,892838425,892838462,37,728,790,2.8518518518518516
125,4,3,-1,892838462,892838509,47,790,1185,2.111111111111111
125,3,3,0,892838509,892838558,49,1185,63,3.125
125,3,2,-1,892838558,892838559,1,63,235,3.106382978723404
125,2,1,-1,892838559,892838591,32,235,1170,3.1666666666666665
125,1,5,4,892838591,892838623,32,1170,90,3.0
125,5,4,-1,892838623,892838656,33,90,401,2.6774193548387095
125,4,3,-1,892838656,892838687,31,401,722,2.9642857142857144
125,3,3,0,892838687,892838777,90,722,369,2.5714285714285716
125,3,4,1,892838777,892838865,88,369,80,2.967741935483871
125,4,3,-1,892838865,892838977,112,80,734,3.0
125,3,2,-1,892838977,892839021,44,734,1271,2.0
125,2,4,2,892839021,892839066,45,1271,158,2.7027027027027026
125,4,3,-1,892839066,892839091,25,158,411,2.911764705882353
125,3,2,-1,892839091,892839143,52,411,1037,2.0
125,2,3,1,892839143,892839191,48,1037,364,2.8095238095238093
125,3,2,-1,892839191,892839270,79,364,780,3.08
125,2,2,0,892839270,892839312,42,780,577,1.7058823529411764
125,2,2,0,892839312,892839412,100,577,383,2.5
83,3,4,1,880306745,880306786,41,151,181,3.98974358974359
83,4,5,1,880306786,880306811,25,181,125,3.5555555555555554
83,5,3,-2,880306811,880306926,115,125,1060,3.235294117647059
83,3,3,0,880306926,880307071,145,1060,118,3.2764227642276422
83,3,5,2,880307071,880307072,1,118,281,3.2
83,5,3,-2,880307072,880307140,68,281,929,2.8421052631578947
83,3,4,1,880307140,880307207,67,929,1028,2.857142857142857
83,4,3,-1,880307207,880307208,1,1028,225,3.0714285714285716
83,3,4,1,880307208,880307339,131,225,717,2.9696969696969697
83,4,3,-1,880307339,880307359,20,717,476,3.1216216216216215
83,3,3,0,880307359,880307382,23,476,977,2.473684210526316
83,3,4,1,880307382,880307417,35,977,409,2.9615384615384617
83,4,3,-1,880307417,880307588,171,409,1049,2.5714285714285716
83,3,5,2,880307588,880307699,111,1049,174,4.253521126760563
83,5,5,0,880307699,880307724,25,174,22,4.215909090909091
83,5,5,0,880307724,880307751,27,22,31,3.642857142857143
83,5,4,-1,880307751,880307807,56,31,527,3.823529411764706
83,4,4,0,880307807,880307846,39,527,216,3.8454545454545452
83,4,4,0,880307846,880307898,52,216,66,3.4705882352941178
83,4,5,1,880307898,880307922,24,66,204,3.6744186046511627
83,5,4,-1,880307922,880307940,18,204,215,3.662921348314607
83,4,4,0,880307940,880307979,39,215,692,3.56
83,4,5,1,880307979,880307996,17,692,196,3.9404761904761907
83,5,4,-1,880307996,880308038,42,196,191,4.168674698795181
83,4,4,0,880308038,880308099,61,191,566,3.543859649122807
83,4,5,1,880308099,880308141,42,566,739,3.391304347826087
83,5,5,0,880308141,880308186,45,739,265,3.710144927536232
83,5,4,-1,880308186,880308256,70,265,660,3.71875
83,4,4,0,880308256,880308329,73,660,423,3.7016129032258065
83,4,3,-1,880308329,880308408,79,423,371,3.0
83,3,4,1,880308408,880308453,45,371,783,2.388888888888889
83,4,2,-2,880308453,880308550,97,783,640,2.75
83,2,4,2,880308550,880308578,28,640,623,3.0454545454545454
83,4,4,0,880308578,880308601,23,623,186,3.905263157894737
83,4,4,0,880308601,880308690,89,186,43,3.1
83,4,4,0,880308690,880308755,65,43,576,3.125
83,4,2,-2,880308755,880308783,28,576,391,2.4285714285714284
83,2,3,1,880308783,880308807,24,391,1043,3.2
83,3,4,1,880308807,880308831,24,1043,94,2.8823529411764706
83,4,3,-1,880308831,880308871,40,94,944,2.75
83,3,3,0,880308871,880308959,88,944,139,2.7222222222222223
83,3,4,1,880308959,880309185,226,139,110,2.25
83,4,3,-1,880309185,880309214,29,110,452,2.6129032258064515
83,3,4,1,880309214,880327970,18756,452,63,3.125
83,4,4,0,880327970,883867791,3539821,63,756,2.6885245901639343
83,4,1,-3,883867791,883867920,129,756,235,3.106382978723404
83,1,3,2,883867920,883867947,27,235,866,3.3962264150943398
83,3,3,0,883867947,883868300,353,866,832,2.7142857142857144
83,3,4,1,883868300,883868345,45,832,1016,3.559322033898305
83,4,4,0,883868345,883868420,75,1016,323,3.0
83,4,4,0,883868420,883868598,178,323,252,2.911392405063291
83,4,4,0,883868598,883868647,49,252,338,2.75
83,4,3,-1,883868647,883868788,141,338,248,3.746268656716418
83,3,4,1,883868788,883868805,17,248,862,1.6666666666666667
83,4,4,0,883868805,883868890,85,862,781,3.4166666666666665
83,4,2,-2,883868890,883868978,88,781,993,3.4838709677419355
83,2,4,2,883868978,883869630,652,993,580,3.625
83,4,2,-2,883869630,887664680,3795050,580,249,3.3275862068965516
83,2,5,3,887664680,887665423,743,249,393,3.5125
83,5,4,-1,887665423,887665548,125,393,234,3.7674418604651163
83,4,4,0,887665548,887665549,1,234,161,3.5844155844155843
83,4,3,-1,887665549,887665569,20,161,294,3.1052631578947367
83,3,2,-1,887665569,887665655,86,294,508,3.6923076923076925
83,2,2,0,887665655,887665798,143,508,477,3.1666666666666665
83,2,2,0,887665798,891181444,3515646,477,892,2.9615384615384617
83,2,3,1,891181444,891181639,195,892,846,3.1052631578947367
83,3,2,-1,891181639,891181703,64,846,245,3.056179775280899
83,2,2,0,891181703,891182288,585,245,105,2.6176470588235294
83,2,2,0,891182288,891182319,31,105,1047,2.6923076923076925
83,2,1,-1,891182319,891182379,60,1047,413,2.5652173913043477
83,1,2,1,891182379,891182431,52,413,406,2.5294117647058822
83,2,1,-1,891182431,891182532,101,406,407,2.611111111111111
272,5,4,-1,879454725,879454726,1,127,183,3.951219512195122
272,4,5,1,879454726,879454753,27,183,22,4.215909090909091
272,5,3,-2,879454753,879454797,44,22,746,3.7560975609756095
272,3,5,2,879454797,879454845,48,746,211,3.958904109589041
272,5,5,0,879454845,879454875,30,211,483,4.475609756097561
272,5,4,-1,879454875,879454939,64,483,204,3.6744186046511627
272,4,4,0,879454939,879455015,76,204,8,3.903225806451613
272,4,4,0,879455015,879455043,28,8,172,4.225225225225225
272,4,5,1,879455043,879455113,70,172,178,4.378378378378378
272,5,5,0,879455113,879455143,30,178,238,3.888888888888889
272,5,5,0,879455143,879455176,33,238,134,4.174603174603175
272,5,5,0,879455176,879455220,44,134,210,3.921259842519685
272,5,5,0,879455220,879455254,34,210,514,4.033333333333333
151,3,4,1,879523860,879523900,40,302,321,3.0172413793103448
151,4,4,0,879523900,879523925,25,321,301,3.2465753424657535
151,4,4,0,879523925,879523942,17,301,300,3.6861313868613137
151,4,1,-3,879523942,879523998,56,300,260,2.4716981132075473
151,1,5,4,879523998,879524088,90,260,223,4.108695652173913
151,5,4,-1,879524088,879524089,1,223,464,3.8
151,4,5,1,879524089,879524108,19,464,427,4.2025316455696204
151,5,5,0,879524108,879524130,22,427,173,4.1441441441441444
151,5,4,-1,879524130,879524131,1,173,134,4.174603174603175
151,4,5,1,879524131,879524150,19,134,498,4.290909090909091
151,5,5,0,879524150,879524151,1,498,1,3.902439024390244
151,5,4,-1,879524151,879524174,23,1,1070,4.0
151,4,4,0,879524174,879524199,25,1070,660,3.71875
151,4,5,1,879524199,879524268,69,660,114,4.3478260869565215
151,5,5,0,879524268,879524293,25,114,224,3.4545454545454546
151,5,5,0,879524293,879524325,32,224,172,4.225225225225225
151,5,3,-2,879524325,879524326,1,172,191,4.168674698795181
151,3,5,2,879524326,879524368,42,191,919,4.0
151,5,2,-3,879524368,879524394,26,919,741,3.3043478260869565
151,2,4,2,879524394,879524419,25,741,210,3.921259842519685
151,4,4,0,879524419,879524420,1,210,87,3.9
151,4,3,-1,879524420,879524471,51,87,203,3.826923076923077
151,3,4,1,879524471,879524472,1,203,198,4.04
151,4,5,1,879524472,879524491,19,198,89,3.9615384615384617
151,5,4,-1,879524491,879524514,23,89,939,3.6333333333333333
151,4,5,1,879524514,879524563,49,939,582,3.7457627118644066
151,5,3,-2,879524563,879524564,1,582,747,3.5526315789473686
151,3,5,2,879524564,879524585,21,747,357,4.063291139240507
151,5,5,0,879524585,879524586,1,357,178,4.378378378378378
151,5,5,0,879524586,879524610,24,178,317,3.774193548387097
151,5,5,0,879524610,879524611,1,317,83,4.204081632653061
151,5,3,-2,879524611,879524642,31,83,183,3.951219512195122
151,3,5,2,879524642,879524669,27,183,487,4.043478260869565
151,5,5,0,879524669,879524712,43,487,512,3.888888888888889
151,5,3,-2,879524712,879524713,1,512,31,3.642857142857143
151,3,5,2,879524713,879524760,47,31,657,4.341463414634147
151,5,4,-1,879524760,879524797,37,657,514,4.033333333333333
151,4,5,1,879524797,879524819,22,514,372,3.6666666666666665
151,5,3,-2,879524819,879524849,30,372,631,3.581818181818182
151,3,3,0,879524849,879524878,29,631,419,3.8208955223880596
151,3,4,1,879524878,879524879,1,419,56,4.051724137931035
151,4,4,0,879524879,879524900,21,56,488,4.277777777777778
151,4,5,1,879524900,879524921,21,488,10,3.85
151,5,5,0,879524921,879524922,1,10,4,3.5538461538461537
151,5,5,0,879524922,879524948,26,4,953,3.076923076923077
151,5,4,-1,879524948,879524974,26,953,66,3.4705882352941178
151,4,5,1,879524974,879525002,28,66,463,3.6818181818181817
151,5,3,-2,879525002,879525035,33,463,686,3.9
151,3,5,2,879525035,879525054,19,686,121,3.521212121212121
151,5,5,0,879525054,879528438,3384,121,1269,4.25
151,5,4,-1,879528438,879528496,58,1269,25,3.3185840707964602
151,4,4,0,879528496,879528520,24,25,378,3.6904761904761907
151,4,4,0,879528520,879528537,17,378,707,3.909090909090909
151,4,4,0,879528537,879528570,33,707,423,3.7016129032258065
151,4,5,1,879528570,879528588,18,423,211,3.958904109589041
151,5,5,0,879528588,879528623,35,211,489,4.076923076923077
151,5,4,-1,879528623,879528647,24,489,425,3.7027027027027026
151,4,5,1,879528647,879528673,26,425,429,3.742857142857143
151,5,5,0,879528673,879528674,1,429,628,3.573529411764706
151,5,2,-3,879528674,879528692,18,628,393,3.5125
151,2,5,3,879528692,879528710,18,393,197,4.112676056338028
151,5,4,-1,879528710,879528729,19,197,614,3.727272727272727
151,4,5,1,879528729,879528754,25,614,137,3.9545454545454546
151,5,2,-3,879528754,879528778,24,137,716,3.1904761904761907
151,2,2,0,879528778,879528779,1,716,448,3.466666666666667
151,2,5,3,879528779,879528801,22,448,633,3.9
151,5,5,0,879528801,879528819,18,633,638,3.923076923076923
151,5,2,-3,879528819,879528852,33,638,356,3.2
151,2,3,1,879528852,879528890,38,356,566,3.543859649122807
151,3,4,1,879528890,879542270,13380,566,724,3.64
151,4,5,1,879542270,879542286,16,724,238,3.888888888888889
151,5,5,0,879542286,879542353,67,238,387,3.5357142857142856
151,5,5,0,879542353,879542369,16,387,274,3.5609756097560976
151,5,4,-1,879542369,879542389,20,274,1264,3.5
151,4,4,0,879542389,879542413,24,1264,44,3.1333333333333333
151,4,4,0,879542413,879542414,1,44,1109,3.4545454545454546
151,4,5,1,879542414,879542474,60,1109,414,3.3076923076923075
151,5,4,-1,879542474,879542527,53,414,770,3.25
151,4,4,0,879542527,879542566,39,770,782,2.8
151,4,4,0,879542566,879542567,1,782,805,3.909090909090909
151,4,2,-2,879542567,879542588,21,805,517,3.625
151,2,5,3,879542588,879542610,22,517,529,4.142857142857143
151,5,4,-1,879542610,879542645,35,529,655,3.7857142857142856
151,4,3,-1,879542645,879542688,43,655,13,3.5454545454545454
151,3,5,2,879542688,879542707,19,13,451,3.207792207792208
151,5,4,-1,879542707,879542723,16,451,163,3.53125
151,4,5,1,879542723,879542753,30,163,202,3.730337078651685
151,5,4,-1,879542753,879542775,22,202,732,3.6266666666666665
151,4,2,-2,879542775,879542796,21,732,627,3.3823529411764706
151,2,3,1,879542796,879542813,17,627,761,3.0588235294117645
151,3,4,1,879542813,879542847,34,761,922,4.0
151,4,4,0,879542847,879542891,44,922,371,3.0
151,4,4,0,879542891,879542939,48,371,125,3.5555555555555554
151,4,5,1,879542939,879542984,45,125,164,3.6140350877192984
151,5,2,-3,879542984,879543036,52,164,1047,2.6923076923076925
151,2,4,2,879543036,879543055,19,1047,51,3.5277777777777777
151,4,5,1,879543055,879543146,91,51,380,3.4878048780487805
151,5,3,-2,879543146,879543181,35,380,781,3.4166666666666665
151,3,1,-2,879543181,879543212,31,781,826,2.5555555555555554
151,1,4,3,879543212,879543228,16,826,411,2.911764705882353
151,4,3,-1,879543228,879543306,78,411,1041,3.3333333333333335
151,3,4,1,879543306,879543324,18,1041,549,3.4871794871794872
151,4,2,-2,879543324,879543366,42,549,775,2.4285714285714284
151,2,3,1,879543366,879543423,57,775,402,3.3076923076923075
151,3,3,0,879543423,879543457,34,402,929,2.8421052631578947
54,5,4,-1,880928893,880928957,64,327,288,3.5214285714285714
54,4,5,1,880928957,880931687,2730,288,741,3.3043478260869565
54,5,3,-2,880931687,880935504,3817,741,685,3.2666666666666666
54,3,2,-1,880935504,880936669,1165,685,1012,3.2916666666666665
54,2,2,0,880936669,880936670,1,1012,151,3.6544117647058822
54,2,4,2,880936670,880937399,729,151,471,3.5714285714285716
54,4,3,-1,880937399,880937490,91,471,148,3.2131147540983607
54,3,3,0,880937490,880937630,140,148,252,2.911392405063291
54,3,3,0,880937630,880937813,183,252,827,2.4375
54,3,3,0,880937813,880937882,69,827,106,2.8125
54,3,3,0,880937882,880937992,110,106,820,3.0444444444444443
54,3,2,-1,880937992,880938088,96,820,823,2.75
54,2,5,3,880938088,880938547,459,823,871,2.3823529411764706
54,5,4,-1,880938547,890608225,9669678,871,340,3.7419354838709675
54,4,4,0,890608225,890608303,78,340,346,3.5128205128205128
16,5,4,-1,877717078,877717116,38,300,294,3.1052631578947367
16,4,5,1,877717116,877717956,840,294,31,3.642857142857143
16,5,5,0,877717956,877718107,151,31,318,4.5046728971962615
16,5,5,0,877718107,877718168,61,318,504,4.085714285714285
16,5,5,0,877718168,877718872,704,504,482,3.9444444444444446
16,5,5,0,877718872,877719206,334,482,127,4.162790697674419
16,5,5,0,877719206,877719333,127,127,498,4.290909090909091
16,5,5,0,877719333,877719504,171,498,237,3.7315436241610738
16,5,5,0,877719504,877720185,681,237,234,3.7674418604651163
16,5,3,-2,877720185,877720186,1,234,735,3.58
16,3,5,2,877720186,877720297,111,735,480,4.283018867924528
16,5,5,0,877720297,877720437,140,480,100,4.0162162162162165
16,5,5,0,877720437,877720813,376,100,230,3.3518518518518516
16,5,4,-1,877720813,877720916,103,230,87,3.9
16,4,5,1,877720916,877721071,155,87,22,4.215909090909091
16,5,5,0,877721071,877721142,71,22,144,3.9545454545454546
16,5,2,-3,877721142,877721236,94,144,940,2.4
16,2,5,3,877721236,877724066,2830,940,447,3.46875
16,5,4,-1,877724066,877724603,537,447,240,3.0350877192982457
16,4,5,1,877724603,877724726,123,240,172,4.225225225225225
16,5,5,0,877724726,877724727,1,172,418,3.825
16,5,3,-2,877724727,877724845,118,418,471,3.5714285714285716
16,3,5,2,877724845,877724846,1,471,69,3.8015873015873014
16,5,3,-2,877724846,877724979,133,69,770,3.25
16,3,4,1,877724979,877726944,1965,770,591,3.7169811320754715
16,4,5,1,877726944,877727054,110,591,208,3.8125
16,5,5,0,877727054,877727055,1,208,443,3.8421052631578947
16,5,5,0,877727055,877727122,67,443,28,3.923076923076923
16,5,5,0,877727122,877727192,70,28,143,3.56
16,5,4,-1,877727192,877727280,88,143,158,2.7027027027027026
91,5,2,-3,891438106,891438184,78,333,682,3.0476190476190474
91,2,3,1,891438184,891438288,104,682,294,3.1052631578947367
91,3,2,-1,891438288,891438314,26,294,748,3.1043478260869564
91,2,4,2,891438314,891438351,37,748,327,3.5076923076923077
91,4,4,0,891438351,891438397,46,327,322,3.0476190476190474
91,4,4,0,891438397,891438529,132,322,338,2.75
91,4,4,0,891438529,891438583,54,338,264,2.65
91,4,5,1,891438583,891438908,325,264,187,4.215189873417722
91,5,4,-1,891438908,891438909,1,187,204,3.6744186046511627
91,4,3,-1,891438909,891438947,38,204,474,4.172413793103448
91,3,4,1,891438947,891438977,30,474,484,4.116279069767442
91,4,2,-2,891438977,891439018,41,484,568,3.5853658536585367
91,2,4,2,891439018,891439057,39,568,427,4.2025316455696204
91,4,5,1,891439057,891439090,33,427,423,3.7016129032258065
91,5,2,-3,891439090,891439130,40,423,389,3.272727272727273
91,2,4,2,891439130,891439171,41,389,495,3.65
91,4,3,-1,891439171,891439208,37,495,482,3.9444444444444446
91,3,5,2,891439208,891439243,35,482,181,3.98974358974359
91,5,4,-1,891439243,891439302,59,181,192,4.090909090909091
91,4,4,0,891439302,891439324,22,192,429,3.742857142857143
91,4,4,0,891439324,891439353,29,429,435,3.8933333333333335
91,4,5,1,891439353,891439386,33,435,50,4.306532663316583
91,5,4,-1,891439386,891439439,53,50,616,3.1052631578947367
91,4,2,-2,891439439,891439503,64,616,418,3.825
91,2,4,2,891439503,891439560,57,418,230,3.3518518518518516
294,4,3,-1,877818580,877818729,149,879,323,3.0
294,3,4,1,877818729,877818860,131,323,294,3.1052631578947367
294,4,2,-2,877818860,877818861,1,294,678,2.8181818181818183
294,2,3,1,877818861,877818915,54,678,749,3.2777777777777777
294,3,2,-1,877818915,877819090,175,749,264,2.65
294,2,4,2,877819090,877819126,36,264,260,2.4716981132075473
294,4,3,-1,877819126,877819265,139,260,1245,2.3333333333333335
294,3,5,2,877819265,877819310,45,1245,475,3.956043956043956
294,5,5,0,877819310,877819353,43,475,50,4.306532663316583
294,5,5,0,877819353,877819459,106,50,250,3.4698795180722892
294,5,3,-2,877819459,877819490,31,250,455,3.1702127659574466
294,3,5,2,877819490,877819532,42,455,181,3.98974358974359
294,5,4,-1,877819532,877819599,67,181,109,3.282608695652174
294,4,4,0,877819599,877819634,35,109,742,3.5555555555555554
294,4,4,0,877819634,877819673,39,742,544,3.185185185185185
294,4,5,1,877819673,877819714,41,544,121,3.521212121212121
294,5,3,-2,877819714,877819792,78,121,476,3.1216216216216215
294,3,3,0,877819792,877819897,105,476,1028,2.857142857142857
294,3,5,2,877819897,877819941,44,1028,249,3.3275862068965516
294,5,3,-2,877819941,877819972,31,249,547,3.6666666666666665
294,3,4,1,877819972,877819999,27,547,111,3.5106382978723403
294,4,2,-2,877819999,877820132,133,111,1089,2.1363636363636362
294,2,3,1,877820132,877820155,23,1089,148,3.2131147540983607
294,3,4,1,877820155,877820189,34,148,471,3.5714285714285716
294,4,3,-1,877820189,877820190,1,471,823,2.75
294,3,3,0,877820190,877820240,50,823,1047,2.6923076923076925
294,3,3,0,877820240,877820272,32,1047,125,3.5555555555555554
294,3,3,0,877820272,877820328,56,125,619,3.4782608695652173
294,3,4,1,877820328,889241309,11420981,619,751,3.3896103896103895
294,4,5,1,889241309,889241339,30,751,313,4.323076923076923
294,5,3,-2,889241339,889241377,38,313,346,3.5128205128205128
294,3,4,1,889241377,889241426,49,346,355,2.75
294,4,3,-1,889241426,889241466,40,355,342,2.64
294,3,3,0,889241466,889241486,20,342,682,3.0476190476190474
294,3,4,1,889241486,889241511,25,682,343,3.0
294,4,3,-1,889241511,889241633,122,343,876,3.0
294,3,3,0,889241633,889241707,74,876,881,2.769230769230769
294,3,4,1,889241707,889241864,157,881,246,4.0
294,4,3,-1,889241864,889241958,94,246,255,3.2027027027027026
294,3,3,0,889241958,889242035,77,255,281,3.2
294,3,5,2,889242035,889242081,46,281,515,4.202898550724638
294,5,2,-3,889242081,889242142,61,515,1199,2.6666666666666665
294,2,3,1,889242142,889242166,24,1199,413,2.5652173913043477
294,3,3,0,889242166,889242306,140,413,597,3.2771084337349397
294,3,3,0,889242306,889242328,22,597,1081,2.6666666666666665
294,3,2,-1,889242328,889242370,42,1081,1011,3.1
294,2,3,1,889242370,889242468,98,1011,928,3.142857142857143
294,3,2,-1,889242468,889242469,1,928,291,3.2
294,2,3,1,889242469,889242542,73,291,831,2.6097560975609757
294,3,2,-1,889242542,889242624,82,831,1079,2.1923076923076925
294,2,3,1,889242624,889242661,37,1079,1254,2.4
294,3,3,0,889242661,889242704,43,1254,930,2.793103448275862
294,3,2,-1,889242704,889242788,84,930,1013,2.388888888888889
294,2,3,1,889242788,889242810,22,1013,986,2.5555555555555554
294,3,3,0,889242810,889242857,47,986,931,2.2758620689655173
294,3,2,-1,889242857,889242905,48,931,743,1.9545454545454546
294,2,3,1,889242905,889242937,32,743,254,2.7419354838709675
229,2,1,-1,891632040,891632073,33,258,347,3.59375
229,1,2,1,891632073,891632142,69,347,300,3.6861313868613137
229,2,3,1,891632142,891632164,22,300,751,3.3896103896103895
229,3,1,-2,891632164,891632347,183,751,316,4.285714285714286
229,1,3,2,891632347,891632385,38,316,245,3.056179775280899
229,3,3,0,891632385,891632402,17,245,748,3.1043478260869564
229,3,1,-2,891632402,891632437,35,748,358,2.6551724137931036
229,1,3,2,891632437,891632551,114,358,312,3.0
229,3,4,1,891632551,891633028,477,312,288,3.5214285714285714
229,4,4,0,891633028,891633029,1,288,896,3.6666666666666665
36,3,4,1,882157258,882157285,27,269,748,3.1043478260869564
36,4,4,0,882157285,882157327,42,748,310,3.6666666666666665
36,4,2,-2,882157327,882157356,29,310,319,3.0408163265306123
36,2,3,1,882157356,882157470,114,319,875,2.736842105263158
70,4,3,-1,884063569,884063627,58,300,678,2.8181818181818183
70,3,4,1,884063627,884063668,41,678,264,2.65
70,4,5,1,884063668,884064134,466,264,298,3.779220779220779
70,5,4,-1,884064134,884064188,54,298,50,4.306532663316583
70,4,4,0,884064188,884064269,81,50,230,3.3518518518518516
70,4,4,0,884064269,884064416,147,230,181,3.98974358974359
70,4,5,1,884064416,884064444,28,181,483,4.475609756097561
70,5,4,-1,884064444,884064545,101,483,496,4.094594594594595
70,4,4,0,884064545,884064574,29,496,48,4.055555555555555
70,4,4,0,884064574,884064743,169,48,24,3.3728813559322033
70,4,4,0,884064743,884064986,243,24,8,3.903225806451613
70,4,5,1,884064986,884065035,49,8,419,3.8208955223880596
70,5,2,-3,884065035,884065248,213,419,338,2.75
70,2,4,2,884065248,884065387,139,338,135,3.7974683544303796
70,4,4,0,884065387,884065423,36,135,168,4.0476190476190474
70,4,5,1,884065423,884065528,105,168,588,3.8358208955223883
70,5,4,-1,884065528,884065703,175,588,186,3.905263157894737
70,4,4,0,884065703,884065733,30,186,69,3.8015873015873014
70,4,4,0,884065733,884065757,24,69,28,3.923076923076923
70,4,5,1,884065757,884065782,25,28,174,4.253521126760563
70,5,4,-1,884065782,884065854,72,174,210,3.921259842519685
70,4,3,-1,884065854,884066399,545,210,204,3.6744186046511627
70,3,3,0,884066399,884066514,115,204,109,3.282608695652174
70,3,4,1,884066514,884066573,59,109,176,3.967032967032967
70,4,4,0,884066573,884066713,140,176,202,3.730337078651685
70,4,3,-1,884066713,884066823,110,202,417,3.0588235294117645
70,3,4,1,884066823,884066886,63,417,507,3.6285714285714286
70,4,3,-1,884066886,884067026,140,507,206,3.0
70,3,3,0,884067026,884067175,149,206,432,3.719298245614035
70,3,4,1,884067175,884067222,47,432,99,3.8392857142857144
70,4,4,0,884067222,884067339,117,99,128,3.45
70,4,3,-1,884067339,884067638,299,128,161,3.5844155844155843
70,3,5,2,884067638,884067855,217,161,511,4.096153846153846
70,5,3,-2,884067855,884068138,283,511,91,3.6
70,3,3,0,884068138,884068277,139,91,554,2.9555555555555557
70,3,4,1,884068277,884068521,244,554,399,3.317073170731707
70,4,4,0,884068521,884068704,183,399,482,3.9444444444444446
70,4,3,-1,884068704,884148728,80024,482,15,3.725663716814159
70,3,3,0,884148728,884148916,188,15,225,3.0714285714285716
70,3,3,0,884148916,884149117,201,225,405,3.25
70,3,4,1,884149117,884149431,314,405,208,3.8125
70,4,4,0,884149431,884149452,21,208,173,4.1441441441441444
70,4,4,0,884149452,884149453,1,173,79,3.956989247311828
70,4,4,0,884149453,884149469,16,79,197,4.112676056338028
70,4,4,0,884149469,884149603,134,197,1065,3.1578947368421053
70,4,4,0,884149603,884149622,19,1065,404,3.6578947368421053
70,4,3,-1,884149622,884149646,24,404,211,3.958904109589041
70,3,3,0,884149646,884149722,76,211,568,3.5853658536585367
70,3,4,1,884149722,884149753,31,568,185,3.9726027397260273
70,4,3,-1,884149753,884149806,53,185,418,3.825
70,3,4,1,884149806,884149852,46,418,527,3.823529411764706
70,4,4,0,884149852,884149877,25,527,152,3.6785714285714284
70,4,4,0,884149877,884149894,17,152,183,3.951219512195122
70,4,4,0,884149894,884150202,308,183,189,3.88
70,4,3,-1,884150202,884150236,34,189,584,3.5238095238095237
70,3,3,0,884150236,884150257,21,584,746,3.7560975609756095
70,3,3,0,884150257,884150422,165,746,175,3.8354430379746836
70,3,3,0,884150422,884150691,269,175,946,3.1153846153846154
70,3,3,0,884150691,884150753,62,946,101,3.4827586206896552
70,3,3,0,884150753,884150865,112,101,755,3.085714285714286
70,3,3,0,884150865,884150884,19,755,142,3.1481481481481484
70,3,4,1,884150884,884151119,235,142,217,3.1538461538461537
70,4,3,-1,884151119,884151168,49,217,63,3.125
70,3,3,0,884151168,884151316,148,63,625,3.25
70,3,3,0,884151316,884151344,28,625,1133,3.076923076923077
70,3,3,0,884151344,884151622,278,1133,1145,2.6666666666666665
70,3,2,-1,884151622,884151700,78,1145,383,2.5
14,4,5,1,876964725,876965165,440,275,100,4.0162162162162165
14,5,4,-1,876965165,879119260,2154095,100,9,3.8878504672897196
14,4,4,0,879119260,879119311,51,9,477,3.1666666666666665
14,4,5,1,879119311,879119348,37,477,408,4.4772727272727275
14,5,5,0,879119348,879119497,149,408,175,3.8354430379746836
14,5,4,-1,879119497,879119579,82,175,514,4.033333333333333
14,4,5,1,879119579,879119651,72,514,716,3.1904761904761907
14,5,5,0,879119651,879119692,41,716,430,4.136363636363637
14,5,4,-1,879119692,879119693,1,430,211,3.958904109589041
14,4,5,1,879119693,879119739,46,211,655,3.7857142857142856
14,5,4,-1,879119739,880929651,1809912,655,922,4.0
14,4,5,1,880929651,880929697,46,922,628,3.573529411764706
14,5,4,-1,880929697,880929745,48,628,920,3.0
14,4,4,0,880929745,880929778,33,920,13,3.5454545454545454
14,4,4,0,880929778,882839936,1910158,13,283,3.901639344262295
14,4,5,1,882839936,890881294,8041358,283,923,4.142857142857143
14,5,5,0,890881294,890881335,41,923,519,4.291666666666667
14,5,5,0,890881335,890881336,1,519,195,3.9072164948453607
14,5,5,0,890881336,890881384,48,195,921,3.611111111111111
14,5,4,-1,890881384,890881433,49,921,588,3.8358208955223883
14,4,4,0,890881433,890881484,51,588,603,4.315789473684211
295,5,5,0,879517010,879517033,23,318,191,4.168674698795181
295,5,4,-1,879517033,879517062,29,191,190,4.233333333333333
295,4,5,1,879517062,879517135,73,190,115,3.6666666666666665
295,5,4,-1,879517135,879517136,1,115,238,3.888888888888889
295,4,5,1,879517136,879517157,21,238,208,3.8125
295,5,5,0,879517157,879517193,36,208,98,4.240875912408759
295,5,5,0,879517193,879517247,54,98,215,3.662921348314607
295,5,4,-1,879517247,879517271,24,215,137,3.9545454545454546
295,4,5,1,879517271,879517324,53,137,213,3.943396226415094
295,5,4,-1,879517324,879517348,24,213,56,4.051724137931035
295,4,4,0,879517348,879517372,24,56,423,3.7016129032258065
295,4,4,0,879517372,879517412,40,423,194,4.029411764705882
295,4,3,-1,879517412,879517467,55,194,42,3.893617021276596
295,3,5,2,879517467,879517512,45,42,186,3.905263157894737
295,5,5,0,879517512,879517540,28,186,50,4.306532663316583
295,5,4,-1,879517540,879517558,18,50,485,3.717948717948718
295,4,5,1,879517558,879517580,22,485,216,3.8454545454545452
295,5,5,0,879517580,879517655,75,216,65,3.511111111111111
295,5,5,0,879517655,879517682,27,65,727,3.5517241379310347
295,5,4,-1,879517682,879517705,23,727,217,3.1538461538461537
295,4,5,1,879517705,879517721,16,217,582,3.7457627118644066
295,5,4,-1,879517721,879517741,20,582,99,3.8392857142857144
295,4,4,0,879517741,879517742,1,99,1039,3.9583333333333335
295,4,5,1,879517742,879517761,19,1039,97,3.7282608695652173
295,5,5,0,879517761,879517779,18,97,70,3.5833333333333335
295,5,5,0,879517779,879517801,22,70,154,3.6031746031746033
295,5,5,0,879517801,879517822,21,154,71,3.6575342465753424
295,5,4,-1,879517822,879517860,38,71,181,3.98974358974359
295,4,4,0,879517860,879517911,51,181,109,3.282608695652174
295,4,4,0,879517911,879517943,32,109,235,3.106382978723404
295,4,4,0,879517943,879517964,21,235,88,3.433734939759036
295,4,4,0,879517964,879517994,30,88,237,3.7315436241610738
295,4,4,0,879517994,879518042,48,237,265,3.710144927536232
295,4,5,1,879518042,879518060,18,265,966,4.7
295,5,4,-1,879518060,879518107,47,966,43,3.1
295,4,4,0,879518107,879518126,19,43,82,3.6741573033707864
295,4,4,0,879518126,879518166,40,82,144,3.9545454545454546
295,4,5,1,879518166,879518233,67,144,431,3.422222222222222
295,5,5,0,879518233,879518257,24,431,173,4.1441441441441444
295,5,4,-1,879518257,879518298,41,173,389,3.272727272727273
295,4,4,0,879518298,879518319,21,389,739,3.391304347826087
295,4,4,0,879518319,879518359,40,739,941,3.5
295,4,4,0,879518359,879518378,19,941,210,3.921259842519685
295,4,5,1,879518378,879518395,17,210,164,3.6140350877192984
295,5,4,-1,879518395,879518414,19,164,228,3.7246376811594204
295,4,4,0,879518414,879518430,16,228,161,3.5844155844155843
295,4,5,1,879518430,879518474,44,161,417,3.0588235294117645
295,5,4,-1,879518474,879518546,72,417,738,3.0
295,4,5,1,879518546,879518607,61,738,737,3.12
295,5,4,-1,879518607,879518630,23,737,416,3.3846153846153846
295,4,5,1,879518630,879518654,24,416,624,3.0
295,5,4,-1,879518654,879518674,20,624,743,1.9545454545454546
295,4,4,0,879518674,879518696,22,743,1135,3.0526315789473686
295,4,4,0,879518696,879518714,18,1135,72,3.175438596491228
295,4,4,0,879518714,879518715,1,72,155,3.0588235294117645
295,4,4,0,879518715,879518739,24,155,812,3.375
295,4,5,1,879518739,879518800,61,812,241,3.5625
295,5,4,-1,879518800,879518801,1,241,720,3.2
295,4,5,1,879518801,879518820,19,720,402,3.3076923076923075
295,5,3,-2,879518820,879518821,1,402,997,2.7142857142857144
295,3,3,0,879518821,879518840,19,997,118,3.2764227642276422
295,3,4,1,879518840,879518864,24,118,451,3.207792207792208
295,4,4,0,879518864,879518881,17,451,722,2.9642857142857144
295,4,3,-1,879518881,879518900,19,722,232,3.0789473684210527
295,3,4,1,879518900,879518932,32,232,158,2.7027027027027026
295,4,4,0,879518932,879518960,28,158,68,3.5714285714285716
295,4,4,0,879518960,879518978,18,68,794,3.6
295,4,4,0,879518978,879519009,31,794,73,3.588235294117647
295,4,4,0,879519009,879519010,1,73,229,3.185185185185185
295,4,4,0,879519010,879519042,32,229,67,3.106382978723404
295,4,5,1,879519042,879519237,195,67,1459,3.6
295,5,5,0,879519237,879519266,29,1459,704,3.125
295,5,3,-2,879519266,879519390,124,704,401,2.6774193548387095
295,3,4,1,879519390,879519438,48,401,450,2.2758620689655173
295,4,4,0,879519438,879519501,63,450,395,2.5714285714285716
295,4,4,0,879519501,879519529,28,395,1297,3.0
295,4,5,1,879519529,879519555,26,1297,89,3.9615384615384617
295,5,5,0,879519555,879519556,1,89,961,3.4545454545454546
233,4,3,-1,875508169,875508225,56,828,89,3.9615384615384617
233,3,5,2,875508225,875508372,147,89,958,4.2
233,5,5,0,875508372,875508485,113,958,192,4.090909090909091
233,5,2,-3,875508485,875508639,154,192,640,2.75
233,2,5,3,875508639,876021170,512531,640,483,4.475609756097561
233,5,3,-2,876021170,876021213,43,483,50,4.306532663316583
233,3,4,1,876021213,876021262,49,50,14,4.101694915254237
233,4,3,-1,876021262,876374463,353201,14,129,3.744186046511628
233,3,3,0,876374463,876374602,139,129,623,3.0454545454545454
233,3,5,2,876374602,877661364,1286762,623,133,3.7777777777777777
233,5,4,-1,877661364,877661437,73,133,614,3.727272727272727
233,4,5,1,877661437,877661553,116,614,588,3.8358208955223883
233,5,5,0,877661553,877661634,81,588,660,3.71875
233,5,5,0,877661634,877661776,142,660,56,4.051724137931035
233,5,5,0,877661776,877661881,105,56,47,3.5869565217391304
233,5,5,0,877661881,877661882,1,47,97,3.7282608695652173
233,5,5,0,877661882,877663128,1246,97,504,4.085714285714285
233,5,5,0,877663128,877663184,56,504,48,4.055555555555555
233,5,5,0,877663184,877663302,118,48,168,4.0476190476190474
233,5,5,0,877663302,877663303,1,168,197,4.112676056338028
233,5,4,-1,877663303,877663383,80,197,143,3.56
233,4,4,0,877663383,877663429,46,143,378,3.6904761904761907
233,4,5,1,877663429,877663465,36,378,498,4.290909090909091
233,5,4,-1,877663465,877663548,83,498,584,3.5238095238095237
233,4,4,0,877663548,877663612,64,584,82,3.6741573033707864
233,4,4,0,877663612,877663646,34,82,509,3.7058823529411766
233,4,4,0,877663646,877665191,1545,509,654,4.119047619047619
233,4,4,0,877665191,877665239,48,654,423,3.7016129032258065
233,4,5,1,877665239,877665323,84,423,304,3.5306122448979593
233,5,5,0,877665323,877665324,1,304,212,3.230769230769231
233,5,5,0,877665324,877665357,33,212,216,3.8454545454545452
233,5,5,0,877665357,879147810,1482453,216,70,3.5833333333333335
233,5,5,0,879147810,880190399,1042589,70,371,3.0
233,5,5,0,880190399,880190451,52,371,57,4.133333333333334
233,5,4,-1,880190451,880190627,176,57,845,3.661290322580645
233,4,3,-1,880190627,880610814,420187,845,31,3.642857142857143
233,3,5,2,880610814,880612346,1532,31,568,3.5853658536585367
233,5,3,-2,880612346,880612403,57,568,58,3.543859649122807
233,3,5,2,880612403,883356871,2744468,58,249,3.3275862068965516
233,5,5,0,883356871,883356913,42,249,261,2.7333333333333334
214,3,2,-1,891542464,891542492,28,288,872,3.0
214,2,3,1,891542492,891542520,28,872,294,3.1052631578947367
214,3,3,0,891542520,891542540,20,294,334,3.4210526315789473
214,3,2,-1,891542540,891542578,38,334,752,3.6666666666666665
214,2,3,1,891542578,891542622,44,752,325,2.625
214,3,3,0,891542622,891542735,113,325,269,4.085106382978723
214,3,3,0,891542735,891543036,301,269,181,3.98974358974359
214,3,3,0,891543036,891543114,78,181,50,4.306532663316583
214,3,4,1,891543114,891543157,43,50,508,3.6923076923076925
214,4,3,-1,891543157,891543176,19,508,24,3.3728813559322033
214,3,3,0,891543176,891543191,15,24,298,3.779220779220779
214,3,4,1,891543191,891543227,36,298,137,3.9545454545454546
214,4,4,0,891543227,891543241,14,137,117,3.689189189189189
214,4,3,-1,891543241,891544000,759,117,518,3.5833333333333335
214,3,4,1,891544000,891544089,89,518,527,3.823529411764706
214,4,4,0,891544089,891544114,25,527,608,4.285714285714286
214,4,2,-2,891544114,891544152,38,608,960,3.0
214,2,3,1,891544152,891544175,23,960,135,3.7974683544303796
214,3,3,0,891544175,891544222,47,135,168,4.0476190476190474
214,3,3,0,891544222,891544236,14,168,582,3.7457627118644066
214,3,4,1,891544236,891544290,54,582,114,4.3478260869565215
214,4,4,0,891544290,891544306,16,114,79,3.956989247311828
214,4,4,0,891544306,891544323,17,79,171,4.090909090909091
214,4,3,-1,891544323,891544390,67,171,172,4.225225225225225
214,3,4,1,891544390,891544414,24,172,213,3.943396226415094
214,4,2,-2,891544414,891544445,31,213,69,3.8015873015873014
214,2,4,2,891544445,891544472,27,69,238,3.888888888888889
214,4,4,0,891544472,891544493,21,238,196,3.9404761904761907
214,4,4,0,891544493,891544512,19,196,166,4.0
214,4,4,0,891544512,891544545,33,166,496,4.094594594594595
214,4,5,1,891544545,892668153,1123608,496,11,3.8904109589041096
214,5,5,0,892668153,892668172,19,11,427,4.2025316455696204
214,5,5,0,892668172,892668173,1,427,516,4.055555555555555
214,5,4,-1,892668173,892668196,23,516,8,3.903225806451613
214,4,4,0,892668196,892668197,1,8,55,4.051282051282051
192,5,5,0,881366456,881366489,33,258,302,4.133333333333334
192,5,4,-1,881366489,881366490,1,302,301,3.2465753424657535
192,4,4,0,881366490,881366535,45,301,340,3.7419354838709675
192,4,4,0,881366535,881366615,80,340,289,2.988888888888889
192,4,5,1,881366615,881367527,912,289,9,3.8878504672897196
192,5,4,-1,881367527,881367592,65,9,257,3.7154471544715446
192,4,4,0,881367592,881367618,26,257,25,3.3185840707964602
192,4,4,0,881367618,881367705,87,25,1137,4.25
192,4,5,1,881367705,881367706,1,1137,100,4.0162162162162165
192,5,4,-1,881367706,881367791,85,100,7,3.76056338028169
192,4,4,0,881367791,881367889,98,7,515,4.202898550724638
192,4,3,-1,881367889,881367932,43,515,277,3.6
192,3,5,2,881367932,881367987,55,277,284,3.1547619047619047
192,5,4,-1,881367987,881368016,29,284,287,3.4516129032258065
192,4,3,-1,881368016,881368090,74,287,235,3.106382978723404
192,3,2,-1,881368090,881368127,37,235,121,3.521212121212121
192,2,2,0,881368127,881368222,95,121,111,3.5106382978723403
192,2,3,1,881368222,881368302,80,111,948,2.2962962962962963
192,3,4,1,881368302,881368339,37,948,108,3.107142857142857
192,4,2,-2,881368339,881368358,19,108,1171,2.857142857142857
100,2,4,2,891374603,891374641,38,288,269,4.085106382978723
100,4,4,0,891374641,891374675,34,269,258,3.7547169811320753
100,4,5,1,891374675,891374706,31,258,313,4.323076923076923
100,5,3,-2,891374706,891374707,1,313,340,3.7419354838709675
100,3,4,1,891374707,891374832,125,340,900,4.2
100,4,4,0,891374832,891374868,36,900,344,4.0
100,4,4,0,891374868,891374946,78,344,879,3.2291666666666665
100,4,3,-1,891374946,891374982,36,879,268,3.9838709677419355
100,3,4,1,891374982,891375016,34,268,750,4.027777777777778
100,4,1,-3,891375016,891375068,52,750,1234,1.6666666666666667
100,1,4,3,891375068,891375112,44,1234,300,3.6861313868613137
100,4,2,-2,891375112,891375146,34,300,292,3.6666666666666665
100,2,1,-1,891375146,891375186,40,292,881,2.769230769230769
100,1,4,3,891375186,891375212,26,881,328,3.4895833333333335
100,4,2,-2,891375212,891375260,48,328,354,3.6923076923076925
100,2,5,3,891375260,891375313,53,354,316,4.285714285714286
100,5,3,-2,891375313,891375359,46,316,289,2.988888888888889
100,3,3,0,891375359,891375428,69,289,678,2.8181818181818183
100,3,4,1,891375428,891375454,26,678,898,3.0869565217391304
100,4,3,-1,891375454,891375522,68,898,310,3.6666666666666665
100,3,5,2,891375522,891375557,35,310,315,4.15
100,5,4,-1,891375557,891375629,72,315,272,4.2
100,4,3,-1,891375629,891375630,1,272,346,3.5128205128205128
307,5,5,0,875680937,875681145,208,483,153,3.7865168539325844
307,5,4,-1,875681145,877118284,1437139,153,588,3.8358208955223883
307,4,3,-1,877118284,877121019,2735,588,509,3.7058823529411766
307,3,3,0,877121019,877121921,902,509,183,3.951219512195122
307,3,3,0,877121921,877121988,67,183,427,4.2025316455696204
307,3,3,0,877121988,877122035,47,427,403,3.298507462686567
307,3,4,1,877122035,877122115,80,403,419,3.8208955223880596
307,4,3,-1,877122115,877122138,23,419,239,3.423076923076923
307,3,3,0,877122138,877122721,583,239,72,3.175438596491228
307,3,3,0,877122721,877122816,95,72,265,3.710144927536232
307,3,4,1,877122816,877123333,517,265,431,3.422222222222222
307,4,4,0,877123333,879283008,2159675,431,1022,3.727272727272727
307,4,4,0,879283008,879283036,28,1022,215,3.662921348314607
307,4,5,1,879283036,879283091,55,215,81,3.2857142857142856
307,5,3,-2,879283091,879283203,112,81,143,3.56
307,3,4,1,879283203,879283333,130,143,269,4.085106382978723
307,4,2,-2,879283333,879283362,29,269,402,3.3076923076923075
307,2,4,2,879283362,879283371,9,402,64,4.373737373737374
307,4,3,-1,879283371,879283384,13,64,163,3.53125
307,3,3,0,879283384,879283385,1,163,634,3.6
307,3,4,1,879283385,879283449,64,634,99,3.8392857142857144
307,4,4,0,879283449,879283480,31,99,174,4.253521126760563
307,4,4,0,879283480,879283514,34,174,580,3.625
307,4,3,-1,879283514,879283544,30,580,631,3.581818181818182
307,3,5,2,879283544,879283587,43,631,423,3.7016129032258065
307,5,5,0,879283587,879283625,38,423,186,3.905263157894737
307,5,4,-1,879283625,879283672,47,186,145,2.3636363636363638
307,4,5,1,879283672,879283786,114,145,89,3.9615384615384617
307,5,5,0,879283786,879283798,12,89,168,4.0476190476190474
307,5,4,-1,879283798,879538922,255124,168,449,2.9069767441860463
307,4,3,-1,879538922,881966033,2427111,449,62,3.048780487804878
307,3,3,0,881966033,888095824,6129791,62,101,3.4827586206896552
297,3,3,0,874953948,874954093,145,294,678,2.8181818181818183
297,3,5,2,874954093,874954183,90,678,100,4.0162162162162165
297,5,5,0,874954183,874954260,77,100,275,4.087912087912088
297,5,5,0,874954260,874954353,93,275,515,4.202898550724638
297,5,4,-1,874954353,874954387,34,515,283,3.901639344262295
297,4,5,1,874954387,874954426,39,283,475,3.956043956043956
297,5,4,-1,874954426,874954497,71,475,628,3.573529411764706
297,4,5,1,874954497,874954541,44,628,50,4.306532663316583
297,5,3,-2,874954541,874954611,70,50,471,3.5714285714285716
297,3,3,0,874954611,874954763,152,471,546,2.9789473684210526
297,3,3,0,874954763,874954844,81,546,293,3.630434782608696
297,3,4,1,874954844,874954845,1,293,222,3.578125
297,4,3,-1,874954845,874955183,338,222,147,3.3142857142857145
297,3,4,1,874955183,875238608,283425,147,135,3.7974683544303796
297,4,3,-1,875238608,875238695,87,135,1073,3.6315789473684212
297,3,3,0,875238695,875238726,31,1073,435,3.8933333333333335
297,3,3,0,875238726,875238778,52,435,529,4.142857142857143
297,3,4,1,875238778,875238814,36,529,582,3.7457627118644066
297,4,3,-1,875238814,875238853,39,582,42,3.893617021276596
297,3,4,1,875238853,875238883,30,42,175,3.8354430379746836
297,4,3,-1,875238883,875238923,40,175,198,4.04
297,3,4,1,875238923,875238984,61,198,201,3.75
297,4,3,-1,875238984,875239018,34,201,234,3.7674418604651163
297,3,1,-2,875239018,875239092,74,234,574,2.0
297,1,4,3,875239092,875239267,175,574,32,3.7222222222222223
297,4,3,-1,875239267,875239346,79,32,92,3.7142857142857144
297,3,5,2,875239346,875239383,37,92,57,4.133333333333334
297,5,3,-2,875239383,875239453,70,57,194,4.029411764705882
297,3,3,0,875239453,875239454,1,194,265,3.710144927536232
297,3,3,0,875239454,875239495,41,265,118,3.2764227642276422
297,3,1,-2,875239495,875239535,40,118,27,3.235294117647059
297,1,5,4,875239535,875239569,34,27,114,4.3478260869565215
297,5,5,0,875239569,875239658,89,114,154,3.6031746031746033
297,5,2,-3,875239658,875239691,33,154,73,3.588235294117647
297,2,5,3,875239691,875239795,104,73,8,3.903225806451613
297,5,5,0,875239795,875239870,75,8,185,3.9726027397260273
297,5,5,0,875239870,875239871,1,185,97,3.7282608695652173
297,5,3,-2,875239871,875239913,42,97,231,2.938775510204082
297,3,2,-1,875239913,875239914,1,231,233,3.323529411764706
297,2,5,3,875239914,875239942,28,233,603,4.315789473684211
297,5,3,-2,875239942,875239975,33,603,151,3.6544117647058822
297,3,5,2,875239975,875240015,40,151,479,4.25
297,5,3,-2,875240015,875240053,38,479,1136,3.3076923076923075
297,3,4,1,875240053,875240090,37,1136,133,3.7777777777777777
297,4,2,-2,875240090,875240133,43,133,215,3.662921348314607
297,2,3,1,875240133,875240171,38,215,448,3.466666666666667
297,3,3,0,875240171,875240201,30,448,17,3.032258064516129
297,3,3,0,875240201,875240237,36,17,423,3.7016129032258065
297,3,3,0,875240237,875240266,29,423,625,3.25
297,3,3,0,875240266,875240267,1,625,485,3.717948717948718
297,3,4,1,875240267,875408935,168668,485,1296,3.2222222222222223
297,4,2,-2,875408935,875409099,164,1296,687,2.1481481481481484
297,2,3,1,875409099,875409139,40,687,267,3.3333333333333335
297,3,5,2,875409139,875409525,386,267,238,3.888888888888889
297,5,3,-2,875409525,875410013,488,238,629,3.3333333333333335
297,3,5,2,875410013,875410071,58,629,174,4.253521126760563
297,5,4,-1,875410071,875410100,29,174,210,3.921259842519685
297,4,3,-1,875410100,875410124,24,210,34,3.2
297,3,3,0,875410124,875774155,364031,34,742,3.5555555555555554
297,3,4,1,875774155,875774306,151,742,83,4.204081632653061
297,4,1,-3,875774306,878771163,2996857,83,243,2.357142857142857
297,1,2,1,878771163,881707832,2936669,243,338,2.75
297,2,1,-1,881707832,881707865,33,338,984,2.6666666666666665
297,1,3,2,881707865,881708087,222,984,31,3.642857142857143
297,3,4,1,881708087,885922463,4214376,31,751,3.3896103896103895
297,4,4,0,885922463,888643376,2720913,751,752,3.6666666666666665
193,3,3,0,889122992,889123038,46,362,258,3.7547169811320753
193,3,4,1,889123038,889123039,1,258,300,3.6861313868613137
193,4,4,0,889123039,889123086,47,300,269,4.085106382978723
193,4,4,0,889123086,889123221,135,269,690,3.260869565217391
193,4,4,0,889123221,889123458,237,690,905,3.357142857142857
193,4,3,-1,889123458,889123806,348,905,1258,2.3333333333333335
193,3,4,1,889123806,889123926,120,1258,1406,3.3333333333333335
193,4,4,0,889123926,889124016,90,1406,280,3.103448275862069
193,4,5,1,889124016,889124127,111,280,100,4.0162162162162165
193,5,5,0,889124127,889124287,160,100,487,4.043478260869565
193,5,1,-4,889124287,889124507,220,487,195,3.9072164948453607
193,1,4,3,889124507,889124803,296,195,845,3.661290322580645
193,4,4,0,889124803,889124890,87,845,941,3.5
193,4,5,1,889124890,889124965,75,941,282,3.610526315789474
193,5,4,-1,889124965,889125006,41,282,194,4.029411764705882
193,4,4,0,889125006,889125629,623,194,153,3.7865168539325844
193,4,4,0,889125629,889125720,91,153,174,4.253521126760563
193,4,4,0,889125720,889125755,35,174,210,3.921259842519685
193,4,4,0,889125755,889125788,33,210,684,3.847826086956522
193,4,2,-2,889125788,889125880,92,684,82,3.6741573033707864
193,2,3,1,889125880,889125912,32,82,33,3.2941176470588234
193,3,3,0,889125912,889125945,33,33,403,3.298507462686567
193,3,1,-2,889125945,889125976,31,403,541,2.9473684210526314
193,1,3,2,889125976,889126055,79,541,38,2.784313725490196
193,3,3,0,889126055,889126088,33,38,554,2.9555555555555557
193,3,3,0,889126088,889126272,184,554,274,3.5609756097560976
193,3,3,0,889126272,889126332,60,274,815,3.135135135135135
193,3,3,0,889126332,889126375,43,815,402,3.3076923076923075
193,3,4,1,889126375,889126376,1,402,155,3.0588235294117645
193,4,3,-1,889126376,889126402,26,155,722,2.9642857142857144
193,3,4,1,889126402,889126427,25,722,739,3.391304347826087
193,4,4,0,889126427,889126609,182,739,23,3.9047619047619047
193,4,4,0,889126609,889126610,1,23,443,3.8421052631578947
193,4,4,0,889126610,889126673,63,443,742,3.5555555555555554
193,4,4,0,889126673,889126808,135,742,393,3.5125
193,4,3,-1,889126808,889126867,59,393,465,3.75
193,3,4,1,889126867,889126919,52,465,755,3.085714285714286
193,4,4,0,889126919,889126943,24,755,1078,2.625
193,4,4,0,889126943,889126972,29,1078,627,3.3823529411764706
193,4,4,0,889126972,889127270,298,627,580,3.625
193,4,2,-2,889127270,889127301,31,580,72,3.175438596491228
193,2,3,1,889127301,889127381,80,72,790,2.8518518518518516
193,3,3,0,889127381,889127457,76,790,763,3.347826086956522
193,3,3,0,889127457,889127592,135,763,94,2.8823529411764706
193,3,3,0,889127592,889127633,41,94,410,3.0434782608695654
193,3,3,0,889127633,889127660,27,410,1132,2.588235294117647
193,3,2,-1,889127660,889127698,38,1132,476,3.1216216216216215
193,2,3,1,889127698,889127787,89,476,412,2.272727272727273
193,3,3,0,889127787,889127811,24,412,869,3.0
193,3,1,-2,889127811,889127860,49,869,368,1.8823529411764706
193,1,4,3,889127860,889127921,61,368,407,2.611111111111111
193,4,2,-2,889127921,890834966,1707045,407,689,3.1538461538461537
193,2,4,2,890834966,890859954,24988,689,1,3.902439024390244
193,4,3,-1,890859954,890860076,122,1,715,3.257142857142857
193,3,4,1,890860076,890860234,158,715,1168,3.4166666666666665
193,4,4,0,890860234,890860290,56,1168,177,3.875
193,4,4,0,890860290,890860351,61,177,187,4.215189873417722
193,4,4,0,890860351,890860428,77,187,366,3.4285714285714284
113,2,3,1,875075983,875076044,61,262,322,3.0476190476190474
113,3,3,0,875076044,875076105,61,322,292,3.6666666666666665
113,3,2,-1,875076105,875076180,75,292,324,3.2291666666666665
113,2,3,1,875076180,875076246,66,324,116,3.6666666666666665
113,3,3,0,875076246,875076307,61,116,124,4.052631578947368
113,3,3,0,875076307,875076872,565,124,222,3.578125
113,3,5,2,875076872,875076987,115,222,327,3.5076923076923077
113,5,4,-1,875076987,875935277,858290,327,294,3.1052631578947367
113,4,3,-1,875935277,875935312,35,294,948,2.2962962962962963
113,3,5,2,875935312,875935338,26,948,874,3.230769230769231
113,5,4,-1,875935338,875935610,272,874,325,2.625
275,3,2,-1,875154438,875154655,217,408,625,3.25
275,2,3,1,875154655,875154718,63,625,627,3.3823529411764706
275,3,2,-1,875154718,875154878,160,627,154,3.6031746031746033
275,2,3,1,875154878,875155167,289,154,202,3.730337078651685
275,3,4,1,875155167,875155257,90,202,174,4.253521126760563
275,4,4,0,875155257,876197443,1042186,174,294,3.1052631578947367
275,4,3,-1,876197443,876197552,109,294,515,4.202898550724638
275,3,3,0,876197552,876197615,63,515,117,3.689189189189189
275,3,3,0,876197615,876197645,30,117,257,3.7154471544715446
275,3,3,0,876197645,876197678,33,257,597,3.2771084337349397
275,3,3,0,876197678,876198328,650,597,449,2.9069767441860463
275,3,3,0,876198328,880313680,4115352,449,542,2.888888888888889
275,3,4,1,880313680,880314031,351,542,523,4.159090909090909
275,4,4,0,880314031,880314137,106,523,144,3.9545454545454546
275,4,4,0,880314137,880314218,81,144,520,4.136363636363637
275,4,4,0,880314218,880314320,102,520,210,3.921259842519685
275,4,3,-1,880314320,880314383,63,210,636,3.4146341463414633
275,3,2,-1,880314383,880314412,29,636,969,3.8947368421052633
275,2,4,2,880314412,880314478,66,969,746,3.7560975609756095
275,4,3,-1,880314478,880314500,22,746,183,3.951219512195122
275,3,3,0,880314500,880314528,28,183,22,4.215909090909091
275,3,3,0,880314528,880314824,296,22,135,3.7974683544303796
275,3,3,0,880314824,880314914,90,135,226,3.378787878787879
275,3,3,0,880314914,880314969,55,226,196,3.9404761904761907
275,3,3,0,880314969,880314991,22,196,416,3.3846153846153846
275,3,3,0,880314991,880315080,89,416,679,3.2432432432432434
275,3,3,0,880315080,880315170,90,679,451,3.207792207792208
275,3,2,-1,880315170,880315197,27,451,142,3.1481481481481484
275,2,2,0,880315197,880315243,46,142,188,3.625
275,2,3,1,880315243,880315276,33,188,162,3.4651162790697674
275,3,4,1,880315276,880315322,46,162,423,3.7016129032258065
275,4,3,-1,880315322,880315396,74,423,434,3.588235294117647
219,5,4,-1,889386655,889387284,629,269,936,3.727272727272727
219,4,5,1,889387284,889403559,16275,936,631,3.581818181818182
219,5,5,0,889403559,889403761,202,631,664,3.15
219,5,5,0,889403761,889403843,82,664,215,3.662921348314607
219,5,5,0,889403843,889452619,48776,215,855,3.590909090909091
219,5,4,-1,889452619,892039556,2586937,855,879,3.2291666666666665
219,4,4,0,892039556,892039575,19,879,906,3.8333333333333335
219,4,3,-1,892039575,892039611,36,906,1014,3.1
218,4,5,1,877488366,877488546,180,659,209,3.8275862068965516
218,5,3,-2,877488546,877488634,88,209,517,3.625
218,3,5,2,877488634,877488692,58,517,516,4.055555555555555
218,5,4,-1,877488692,877489091,399,516,762,3.3962264150943398
218,4,4,0,877489091,881288234,3799143,762,603,4.315789473684211
218,4,4,0,881288234,881288298,64,603,23,3.9047619047619047
218,4,4,0,881288298,881288351,53,23,273,3.5238095238095237
218,4,4,0,881288351,881288386,35,273,33,3.2941176470588234
218,4,3,-1,881288386,881288408,22,33,265,3.710144927536232
218,3,3,0,881288408,881288574,166,265,56,4.051724137931035
123,3,4,1,879872192,879872275,83,487,134,4.174603174603175
123,4,3,-1,879872275,879872405,130,134,962,3.142857142857143
123,3,3,0,879872405,879872406,1,962,523,4.159090909090909
123,3,4,1,879872406,879872540,134,523,462,3.7954545454545454
123,4,4,0,879872540,879872671,131,462,182,3.842857142857143
123,4,4,0,879872671,879872672,1,182,98,4.240875912408759
123,4,3,-1,879872672,879872791,119,98,64,4.373737373737374
123,3,2,-1,879872791,879872867,76,64,1269,4.25
123,2,5,3,879872867,879872948,81,1269,504,4.085714285714285
123,5,4,-1,879872948,879873020,72,504,483,4.475609756097561
123,4,5,1,879873020,879873119,99,483,192,4.090909090909091
123,5,5,0,879873119,879873120,1,192,432,3.719298245614035
123,5,4,-1,879873120,879873193,73,432,847,3.7333333333333334
123,4,4,0,879873193,879873830,637,847,276,3.6036036036036037
123,4,1,-3,879873830,879873905,75,276,255,3.2027027027027026
158,4,5,1,880132232,880132313,81,271,275,4.087912087912088
158,5,5,0,880132313,880132356,43,275,127,4.162790697674419
158,5,5,0,880132356,880132383,27,127,285,4.181818181818182
158,5,5,0,880132383,880132401,18,285,100,4.0162162162162165
158,5,4,-1,880132401,880132443,42,100,1,3.902439024390244
158,4,4,0,880132443,880132462,19,1,744,3.5714285714285716
158,4,3,-1,880132462,880132488,26,744,123,3.297872340425532
158,3,3,0,880132488,880132513,25,123,298,3.779220779220779
158,3,4,1,880132513,880132579,66,298,1011,3.1
158,4,4,0,880132579,880132613,34,1011,148,3.2131147540983607
158,4,5,1,880132613,880132638,25,148,118,3.2764227642276422
158,5,3,-2,880132638,880132659,21,118,472,2.984375
158,3,3,0,880132659,880132701,42,472,1016,3.559322033898305
158,3,5,2,880132701,880132744,43,1016,7,3.76056338028169
158,5,3,-2,880132744,880132771,27,7,222,3.578125
158,3,3,0,880132771,880132794,23,222,410,3.0434782608695654
158,3,3,0,880132794,880132893,99,410,252,2.911392405063291
158,3,2,-1,880132893,880132941,48,252,823,2.75
158,2,3,1,880132941,880132960,19,823,107,3.45
158,3,4,1,880132960,880133029,69,107,825,2.914285714285714
158,4,5,1,880133029,880133095,66,825,217,3.1538461538461537
158,5,3,-2,880133095,880133116,21,217,729,3.3793103448275863
158,3,5,2,880133116,880133189,73,729,89,3.9615384615384617
158,5,5,0,880133189,880133209,20,89,694,4.277777777777778
158,5,5,0,880133209,880133288,79,694,525,4.0
158,5,4,-1,880133288,880133306,18,525,50,4.306532663316583
158,4,3,-1,880133306,880133937,631,50,978,2.357142857142857
158,3,1,-2,880133937,880134014,77,978,120,2.3421052631578947
158,1,3,2,880134014,880134296,282,120,510,3.823529411764706
158,3,5,2,880134296,880134332,36,510,190,4.233333333333333
158,5,5,0,880134332,880134398,66,190,82,3.6741573033707864
158,5,4,-1,880134398,880134407,9,82,177,3.875
158,4,3,-1,880134407,880134445,38,177,385,3.6129032258064515
158,3,5,2,880134445,880134499,54,385,686,3.9
158,5,2,-3,880134499,880134532,33,686,231,2.938775510204082
158,2,3,1,880134532,880134595,63,231,399,3.317073170731707
158,3,4,1,880134595,880134607,12,399,38,2.784313725490196
158,4,3,-1,880134607,880134675,68,38,809,2.7058823529411766
158,3,4,1,880134675,880134759,84,809,810,2.9473684210526314
158,4,4,0,880134759,880134815,56,810,798,3.3333333333333335
158,4,3,-1,880134815,880134848,33,798,803,2.75
158,3,3,0,880134848,880134865,17,803,1303,2.857142857142857
158,3,4,1,880134865,880134913,48,1303,367,3.4242424242424243
158,4,5,1,880134913,880134947,34,367,659,4.027777777777778
158,5,5,0,880134947,880134948,1,659,168,4.0476190476190474
158,5,4,-1,880134948,880134966,18,168,652,3.9642857142857144
158,4,5,1,880134966,880135001,35,652,209,3.8275862068965516
158,5,5,0,880135001,880135020,19,209,709,4.171428571428572
158,5,4,-1,880135020,880135044,24,709,175,3.8354430379746836
158,4,4,0,880135044,880135069,25,175,502,3.272727272727273
158,4,5,1,880135069,880135093,24,502,430,4.136363636363637
158,5,4,-1,880135093,880135118,25,430,70,3.5833333333333335
158,4,4,0,880135118,880135160,42,70,290,3.108108108108108
302,3,2,-1,879436785,879436820,35,333,309,2.3333333333333335
302,2,3,1,879436820,879436844,24,309,328,3.4895833333333335
302,3,3,0,879436844,879436874,30,328,289,2.988888888888889
302,3,2,-1,879436874,879436875,1,289,322,3.0476190476190474
302,2,2,0,879436875,879436911,36,322,245,3.056179775280899
302,2,2,0,879436911,879436932,21,245,299,3.0
302,2,2,0,879436932,879436960,28,299,879,3.2291666666666665
302,2,3,1,879436960,879436981,21,879,358,2.6551724137931036
302,3,2,-1,879436981,879437035,54,358,680,2.8333333333333335
23,4,4,0,874784337,874784338,1,181,250,3.4698795180722892
23,4,4,0,874784338,874784385,47,250,7,3.76056338028169
23,4,4,0,874784385,874784440,55,7,14,4.101694915254237
23,4,4,0,874784440,874784466,26,14,19,3.9615384615384617
23,4,4,0,874784466,874784497,31,19,13,3.5454545454545454
23,4,5,1,874784497,874784538,41,13,408,4.4772727272727275
23,5,4,-1,874784538,874784575,37,408,283,3.901639344262295
23,4,3,-1,874784575,874784668,93,283,546,2.9789473684210526
23,3,1,-2,874784668,874784712,44,546,235,3.106382978723404
23,1,3,2,874784712,874785024,312,235,597,3.2771084337349397
23,3,5,2,874785024,874785194,170,597,518,3.5833333333333335
23,5,4,-1,874785194,874785233,39,518,56,4.051724137931035
23,4,4,0,874785233,874785348,115,56,170,4.242424242424242
23,4,4,0,874785348,874785447,99,170,522,3.8461538461538463
23,4,4,0,874785447,874785448,1,522,603,4.315789473684211
23,4,4,0,874785448,874785474,26,603,8,3.903225806451613
23,4,5,1,874785474,874785526,52,8,175,3.8354430379746836
23,5,4,-1,874785526,874785551,25,175,96,3.9130434782608696
23,4,3,-1,874785551,874785552,1,96,154,3.6031746031746033
23,3,2,-1,874785552,874785624,72,154,234,3.7674418604651163
23,2,4,2,874785624,874785652,28,234,174,4.253521126760563
23,4,4,0,874785652,874785756,104,174,185,3.9726027397260273
23,4,4,0,874785756,874785809,53,185,230,3.3518518518518516
23,4,5,1,874785809,874785843,34,230,512,3.888888888888889
23,5,4,-1,874785843,874785889,46,512,710,3.41025641025641
23,4,4,0,874785889,874785926,37,710,527,3.823529411764706
23,4,4,0,874785926,874785957,31,527,79,3.956989247311828
23,4,4,0,874785957,874786016,59,79,194,4.029411764705882
23,4,4,0,874786016,874786037,21,194,418,3.825
23,4,3,-1,874786037,874786066,29,418,143,3.56
23,3,3,0,874786066,874786122,56,143,204,3.6744186046511627
23,3,4,1,874786122,874786220,98,204,95,3.8194444444444446
23,4,3,-1,874786220,874786244,24,95,145,2.3636363636363638
23,3,4,1,874786244,874786438,194,145,153,3.7865168539325844
23,4,4,0,874786438,874786462,24,153,385,3.6129032258064515
23,4,3,-1,874786462,874786488,26,385,423,3.7016129032258065
23,3,4,1,874786488,874786512,24,423,211,3.958904109589041
23,4,2,-2,874786512,874786513,1,211,70,3.5833333333333335
23,2,5,3,874786513,874786770,257,70,511,4.096153846153846
23,5,3,-2,874786770,874786793,23,511,28,3.923076923076923
23,3,3,0,874786793,874786880,87,28,62,3.048780487804878
23,3,3,0,874786880,874786903,23,62,747,3.5526315789473686
23,3,2,-1,874786903,874786926,23,747,196,3.9404761904761907
23,2,4,2,874786926,874786974,48,196,528,4.241379310344827
23,4,2,-2,874786974,874787083,109,528,449,2.9069767441860463
23,2,3,1,874787083,874787116,33,449,526,3.909090909090909
23,3,2,-1,874787116,874787144,28,526,217,3.1538461538461537
23,2,3,1,874787144,874787162,18,217,229,3.185185185185185
23,3,4,1,874787162,874787204,42,229,216,3.8454545454545452
23,4,2,-2,874787204,874787256,52,216,451,3.207792207792208
23,2,4,2,874787256,874787288,32,451,856,4.142857142857143
23,4,4,0,874787288,874787330,42,856,516,4.055555555555555
23,4,4,0,874787330,874787350,20,516,381,3.2758620689655173
23,4,3,-1,874787350,874787449,99,381,82,3.6741573033707864
23,3,5,2,874787449,874787587,138,82,173,4.1441441441441444
23,5,3,-2,874787587,874787647,60,173,1005,4.166666666666667
23,3,3,0,874787647,874787738,91,1005,227,3.169811320754717
23,3,5,2,874787738,874787774,36,227,380,3.4878048780487805
23,5,2,-3,874787774,874787861,87,380,739,3.391304347826087
23,2,1,-1,874787861,874788187,326,739,219,2.735294117647059
23,1,3,2,874788187,874788290,103,219,549,3.4871794871794872
23,3,3,0,874788290,874788318,28,549,1004,2.0
23,3,1,-2,874788318,874788388,70,1004,780,3.08
23,1,3,2,874788388,874788443,55,780,679,3.2432432432432434
23,3,4,1,874788443,876785720,1997277,679,541,2.9473684210526314
23,4,1,-3,876785720,876785901,181,541,294,3.1052631578947367
23,1,3,2,876785901,877817113,1031212,294,191,4.168674698795181
23,3,3,0,877817113,877817151,38,191,188,3.625
23,3,4,1,877817151,884550048,6732897,188,432,3.719298245614035
23,4,4,0,884550048,884550049,1,432,91,3.6
296,1,1,0,884196149,884196209,60,948,309,2.3333333333333335
296,1,4,3,884196209,884196238,29,309,303,3.75
296,4,5,1,884196238,884196284,46,303,301,3.2465753424657535
296,5,1,-4,884196284,884196374,90,301,259,2.492063492063492
296,1,5,4,884196374,884196524,150,259,1142,4.0476190476190474
296,5,5,0,884196524,884196555,31,1142,515,4.202898550724638
296,5,1,-4,884196555,884196556,1,515,150,3.803921568627451
296,1,4,3,884196556,884196584,28,150,246,4.0
296,4,2,-2,884196584,884196605,21,246,10,3.85
296,2,4,2,884196605,884196640,35,10,279,2.75
296,4,4,0,884196640,884196665,25,279,14,4.101694915254237
296,4,5,1,884196665,884196689,24,14,121,3.521212121212121
296,5,3,-2,884196689,884196712,23,121,15,3.725663716814159
296,3,4,1,884196712,884196741,29,15,274,3.5609756097560976
296,4,5,1,884196741,884196765,24,274,248,3.746268656716418
296,5,4,-1,884196765,884196805,40,248,284,3.1547619047619047
296,4,3,-1,884196805,884196806,1,284,815,3.135135135135135
296,3,1,-2,884196806,884196896,90,815,244,2.9411764705882355
296,1,3,2,884196896,884196921,25,244,1009,3.2962962962962963
296,3,4,1,884196921,884196938,17,1009,544,3.185185185185185
296,4,4,0,884196938,884196964,26,544,1160,4.1
296,4,5,1,884196964,884197091,127,1160,98,4.240875912408759
296,5,5,0,884197091,884197108,17,98,435,3.8933333333333335
296,5,4,-1,884197108,884197131,23,435,32,3.7222222222222223
296,4,4,0,884197131,884197235,104,32,523,4.159090909090909
296,4,5,1,884197235,884197264,29,523,469,3.6842105263157894
296,5,5,0,884197264,884197287,23,469,961,3.4545454545454546
296,5,5,0,884197287,884197307,20,961,483,4.475609756097561
296,5,3,-2,884197307,884197308,1,483,210,3.921259842519685
296,3,5,2,884197308,884197330,22,210,482,3.9444444444444446
296,5,5,0,884197330,884197352,22,482,855,3.590909090909091
296,5,5,0,884197352,884197394,42,855,504,4.085714285714285
296,5,4,-1,884197394,884199625,2231,504,209,3.8275862068965516
33,3,4,1,891964111,891964131,20,339,300,3.6861313868613137
33,4,3,-1,891964131,891964148,17,300,307,3.6031746031746033
33,3,4,1,891964148,891964188,40,307,751,3.3896103896103895
33,4,3,-1,891964188,891964230,42,751,880,2.8421052631578947
33,3,4,1,891964230,891964244,14,880,292,3.6666666666666665
33,4,4,0,891964244,891964259,15,292,333,3.546666666666667
33,4,4,0,891964259,891964274,15,333,682,3.0476190476190474
33,4,4,0,891964274,891964306,32,682,260,2.4716981132075473
33,4,3,-1,891964306,891964326,20,260,245,3.056179775280899
33,3,4,1,891964326,891964344,18,245,343,3.0
33,4,4,0,891964344,891964373,29,343,323,3.0
33,4,4,0,891964373,891964404,31,323,348,3.2
154,2,3,1,879138345,879138368,23,289,874,3.230769230769231
154,3,4,1,879138368,879138712,344,874,919,4.0
154,4,4,0,879138712,879138713,1,919,357,4.063291139240507
154,4,5,1,879138713,879138784,71,357,175,3.8354430379746836
154,5,5,0,879138784,879138831,47,175,641,4.5
154,5,4,-1,879138831,879138832,1,641,152,3.6785714285714284
154,4,2,-2,879138832,879138910,78,152,222,3.578125
154,2,4,2,879138910,879139002,92,222,211,3.958904109589041
154,4,5,1,879139002,879139003,1,211,197,4.112676056338028
154,5,5,0,879139003,879139096,93,197,187,4.215189873417722
77,5,5,0,884732606,884732685,79,183,153,3.7865168539325844
77,5,3,-2,884732685,884732716,31,153,100,4.0162162162162165
77,3,5,2,884732716,884732808,92,100,1,3.902439024390244
77,5,3,-2,884732808,884732873,65,1,250,3.4698795180722892
77,3,2,-1,884732873,884732927,54,250,127,4.162790697674419
77,2,2,0,884732927,884732991,64,127,276,3.6036036036036037
77,2,2,0,884732991,884733055,64,276,25,3.3185840707964602
77,2,1,-1,884733055,884733284,229,25,833,2.9444444444444446
77,1,1,0,884733284,884733400,116,833,1028,2.857142857142857
77,1,3,2,884733400,884733422,22,1028,405,3.25
77,3,5,2,884733422,884733587,165,405,174,4.253521126760563
77,5,5,0,884733587,884733621,34,174,641,4.5
77,5,4,-1,884733621,884733655,34,641,175,3.8354430379746836
77,4,5,1,884733655,884733695,40,175,195,3.9072164948453607
77,5,5,0,884733695,884733766,71,195,484,4.116279069767442
77,5,5,0,884733766,884733857,91,484,268,3.9838709677419355
77,5,5,0,884733857,884733922,65,268,154,3.6031746031746033
77,5,5,0,884733922,884733965,43,154,238,3.888888888888889
77,5,5,0,884733965,884733988,23,238,199,4.191489361702128
77,5,5,0,884733988,884734016,28,199,498,4.290909090909091
77,5,5,0,884734016,884752582,18566,498,523,4.159090909090909
77,5,4,-1,884752582,884752665,83,523,483,4.475609756097561
77,4,4,0,884752665,884752721,56,483,168,4.0476190476190474
77,4,2,-2,884752721,884752757,36,168,215,3.662921348314607
77,2,4,2,884752757,884752785,28,215,201,3.75
77,4,5,1,884752785,884752806,21,201,179,3.8823529411764706
77,5,3,-2,884752806,884752853,47,179,144,3.9545454545454546
77,3,3,0,884752853,884752900,47,144,192,4.090909090909091
77,3,4,1,884752900,884752901,1,192,98,4.240875912408759
77,4,3,-1,884752901,884752924,23,98,91,3.6
77,3,3,0,884752924,884752970,46,91,357,4.063291139240507
77,3,3,0,884752970,884752997,27,357,69,3.8015873015873014
77,3,3,0,884752997,884753028,31,69,132,3.929411764705882
77,3,5,2,884753028,884753061,33,132,28,3.923076923076923
77,5,3,-2,884753061,884753105,44,28,228,3.7246376811594204
77,3,2,-1,884753105,884753152,47,228,511,4.096153846153846
77,2,4,2,884753152,884753202,50,511,518,3.5833333333333335
77,4,2,-2,884753202,884753203,1,518,778,3.5925925925925926
77,2,3,1,884753203,884753292,89,778,31,3.642857142857143
270,5,5,0,876953745,876953827,82,268,288,3.5214285714285714
270,5,5,0,876953827,876953900,73,288,327,3.5076923076923077
270,5,5,0,876953900,876953967,67,327,741,3.3043478260869565
270,5,5,0,876953967,876954036,69,741,1007,4.117647058823529
270,5,3,-2,876954036,876954093,57,1007,282,3.610526315789474
270,3,5,2,876954093,876954122,29,282,713,3.5
270,5,5,0,876954122,876954123,1,713,535,3.380952380952381
270,5,5,0,876954123,876954223,100,535,123,3.297872340425532
270,5,2,-3,876954223,876954248,25,123,742,3.5555555555555554
270,2,4,2,876954248,876954484,236,742,546,2.9789473684210526
270,4,5,1,876954484,876954521,37,546,222,3.578125
270,5,5,0,876954521,876954522,1,222,1009,3.2962962962962963
270,5,5,0,876954522,876954927,405,1009,707,3.909090909090909
270,5,4,-1,876954927,876954945,18,707,531,3.7435897435897436
270,4,4,0,876954945,876954965,20,531,714,3.6
270,4,4,0,876954965,876954995,30,714,83,4.204081632653061
270,4,4,0,876954995,876955019,24,83,703,3.75
270,4,5,1,876955019,876955066,47,703,60,4.105263157894737
270,5,5,0,876955066,876955067,1,60,213,3.943396226415094
270,5,5,0,876955067,876955087,20,213,736,4.083333333333333
270,5,5,0,876955087,876955563,476,736,727,3.5517241379310347
270,5,5,0,876955563,876955633,70,727,421,3.462962962962963
270,5,5,0,876955633,876955729,96,421,1119,3.5185185185185186
270,5,5,0,876955729,876955750,21,1119,781,3.4166666666666665
270,5,5,0,876955750,876955770,20,781,155,3.0588235294117645
270,5,5,0,876955770,876955899,129,155,466,3.5
270,5,5,0,876955899,876955938,39,466,183,3.951219512195122
270,5,5,0,876955938,876955939,1,183,566,3.543859649122807
270,5,4,-1,876955939,876955976,37,566,176,3.967032967032967
270,4,4,0,876955976,876956038,62,176,226,3.378787878787879
270,4,2,-2,876956038,876956064,26,226,17,3.032258064516129
270,2,4,2,876956064,876956106,42,17,53,2.9523809523809526
270,4,5,1,876956106,876956137,31,53,164,3.6140350877192984
270,5,5,0,876956137,876956206,69,164,218,3.5555555555555554
270,5,5,0,876956206,876956232,26,218,379,3.35
270,5,4,-1,876956232,876956233,1,379,159,3.3902439024390243
270,4,4,0,876956233,876956264,31,159,452,2.6129032258064515
270,4,4,0,876956264,876956360,96,452,447,3.46875
270,4,5,1,876956360,876956389,29,447,219,2.735294117647059
270,5,5,0,876956389,876956390,1,219,672,2.7222222222222223
270,5,4,-1,876956390,876956419,29,672,569,2.4285714285714284
270,4,5,1,876956419,876956420,1,569,441,2.4
270,5,5,0,876956420,876956442,22,441,559,3.477272727272727
187,5,5,0,879464895,879464978,83,137,116,3.6666666666666665
187,5,3,-2,879464978,879465079,101,116,134,4.174603174603175
187,3,3,0,879465079,879465125,46,134,523,4.159090909090909
187,3,2,-1,879465125,879465241,116,523,175,3.8354430379746836
187,2,4,2,879465241,879465242,1,175,435,3.8933333333333335
187,4,5,1,879465242,879465273,31,435,8,3.903225806451613
187,5,5,0,879465273,879465274,1,8,83,4.204081632653061
187,5,5,0,879465274,879465307,33,83,173,4.1441441441441444
187,5,4,-1,879465307,879465308,1,173,428,3.744186046511628
187,4,5,1,879465308,879465340,32,428,792,3.793103448275862
187,5,4,-1,879465340,879465394,54,792,70,3.5833333333333335
187,4,3,-1,879465394,879465419,25,70,732,3.6266666666666665
187,3,4,1,879465419,879465507,88,732,196,3.9404761904761907
187,4,5,1,879465507,879465532,25,196,694,4.277777777777778
187,5,5,0,879465532,879465566,34,694,191,4.168674698795181
187,5,5,0,879465566,879465597,31,191,427,4.2025316455696204
187,5,5,0,879465597,879465631,34,427,64,4.373737373737374
187,5,4,-1,879465631,879465632,1,64,736,4.083333333333333
187,4,4,0,879465632,879465653,21,736,135,3.7974683544303796
187,4,4,0,879465653,879465745,92,135,423,3.7016129032258065
187,4,5,1,879465745,879465782,37,423,179,3.8823529411764706
187,5,3,-2,879465782,879465805,23,179,215,3.662921348314607
187,3,4,1,879465805,879465858,53,215,213,3.943396226415094
187,4,5,1,879465858,879465937,79,213,275,4.087912087912088
170,5,3,-2,884103801,884103860,59,322,328,3.4895833333333335
170,3,5,2,884103860,884103918,58,328,984,2.6666666666666665
170,5,3,-2,884103918,884104016,98,984,258,3.7547169811320753
170,3,3,0,884104016,886190419,2086403,258,881,2.769230769230769
170,3,3,0,886190419,886190476,57,881,299,3.0
170,3,4,1,886190476,887646133,1455657,299,304,3.5306122448979593
170,4,5,1,887646133,887646170,37,304,749,3.2777777777777777
101,3,4,1,877135914,877135944,30,846,50,4.306532663316583
101,4,3,-1,877135944,877136039,95,50,1,3.902439024390244
101,3,4,1,877136039,877136067,28,1,117,3.689189189189189
101,4,2,-2,877136067,877136186,119,117,123,3.297872340425532
101,2,3,1,877136186,877136243,57,123,222,3.578125
101,3,2,-1,877136243,877136360,117,222,109,3.282608695652174
101,2,4,2,877136360,877136391,31,109,24,3.3728813559322033
101,4,1,-3,877136391,877136424,33,24,819,2.6666666666666665
101,1,3,2,877136424,877136449,25,819,1028,2.857142857142857
101,3,3,0,877136449,877136535,86,1028,471,3.5714285714285716
101,3,4,1,877136535,877136564,29,471,284,3.1547619047619047
101,4,2,-2,877136564,877136598,34,284,1009,3.2962962962962963
101,2,3,1,877136598,877136628,30,1009,252,2.911392405063291
101,3,2,-1,877136628,877136711,83,252,979,3.1
101,2,2,0,877136711,877136763,52,979,841,2.772727272727273
101,2,2,0,877136763,877136789,26,841,1057,2.7142857142857144
101,2,2,0,877136789,877136842,53,1057,281,3.2
101,2,2,0,877136842,877136891,49,281,411,2.911764705882353
101,2,1,-1,877136891,877136928,37,411,122,2.282608695652174
101,1,3,2,877136928,877136954,26,122,1132,2.588235294117647
101,3,4,1,877136954,877137015,61,1132,866,3.3962264150943398
184,5,5,0,889906905,889906946,41,340,262,3.5217391304347827
184,5,3,-2,889906946,889907044,98,262,995,3.0
184,3,5,2,889907044,889907363,319,995,1160,4.1
184,5,4,-1,889907363,889907396,33,1160,50,4.306532663316583
184,4,4,0,889907396,889907426,30,50,181,3.98974358974359
184,4,3,-1,889907426,889907448,22,181,1012,3.2916666666666665
184,3,2,-1,889907448,889907468,20,1012,1014,3.1
184,2,4,2,889907468,889907482,14,1014,250,3.4698795180722892
184,4,2,-2,889907482,889907569,87,250,254,2.7419354838709675
184,2,5,3,889907569,889907652,83,254,100,4.0162162162162165
184,5,5,0,889907652,889907685,33,100,137,3.9545454545454546
184,5,4,-1,889907685,889907711,26,137,1086,3.857142857142857
184,4,4,0,889907711,889907738,27,1086,14,4.101694915254237
184,4,5,1,889907738,889907812,74,14,1137,4.25
184,5,5,0,889907812,889907838,26,1137,221,3.6923076923076925
184,5,3,-2,889907838,889907839,1,221,13,3.5454545454545454
184,3,2,-1,889907839,889907862,23,13,235,3.106382978723404
184,2,4,2,889907862,889907896,34,235,1010,3.611111111111111
184,4,4,0,889907896,889907925,29,1010,676,3.3142857142857145
184,4,4,0,889907925,889907945,20,676,237,3.7315436241610738
184,4,2,-2,889907945,889908050,105,237,405,3.25
184,2,4,2,889908050,889908068,18,405,25,3.3185840707964602
184,4,1,-3,889908068,889908104,36,25,368,1.8823529411764706
184,1,4,3,889908104,889908133,29,368,473,2.9166666666666665
184,4,3,-1,889908133,889908181,48,473,410,3.0434782608695654
184,3,2,-1,889908181,889908207,26,410,476,3.1216216216216215
184,2,3,1,889908207,889908264,57,476,1061,2.9166666666666665
184,3,2,-1,889908264,889908344,80,1061,118,3.2764227642276422
184,2,3,1,889908344,889908462,118,118,651,3.8627450980392157
184,3,4,1,889908462,889908497,35,651,657,4.341463414634147
184,4,5,1,889908497,889908571,74,657,318,4.5046728971962615
184,5,3,-2,889908571,889908657,86,318,92,3.7142857142857144
184,3,3,0,889908657,889908693,36,92,174,4.253521126760563
184,3,4,1,889908693,889908694,1,174,509,3.7058823529411766
184,4,4,0,889908694,889908716,22,509,512,3.888888888888889
184,4,4,0,889908716,889908740,24,512,176,3.967032967032967
184,4,4,0,889908740,889908801,61,176,95,3.8194444444444446
184,4,4,0,889908801,889908843,42,95,192,4.090909090909091
184,4,4,0,889908843,889908902,59,192,478,4.161290322580645
184,4,3,-1,889908902,889908903,1,478,143,3.56
184,3,4,1,889908903,889908947,44,143,492,4.117647058823529
184,4,3,-1,889908947,889908985,38,492,175,3.8354430379746836
184,3,4,1,889908985,889909024,39,175,187,4.215189873417722
184,4,5,1,889909024,889909045,21,187,213,3.943396226415094
184,5,4,-1,889909045,889909069,24,213,238,3.888888888888889
184,4,3,-1,889909069,889909142,73,238,693,3.6285714285714286
184,3,3,0,889909142,889909426,284,693,317,3.774193548387097
184,3,4,1,889909426,889909445,19,317,529,4.142857142857143
184,4,4,0,889909445,889909446,1,529,642,3.4285714285714284
184,4,2,-2,889909446,889909474,28,642,568,3.5853658536585367
184,2,4,2,889909474,889909515,41,568,387,3.5357142857142856
184,4,3,-1,889909515,889909551,36,387,88,3.433734939759036
184,3,4,1,889909551,889909569,18,88,506,3.566666666666667
184,4,4,0,889909569,889909590,21,506,715,3.257142857142857
184,4,3,-1,889909590,889909618,28,715,949,3.392857142857143
184,3,3,0,889909618,889909672,54,949,747,3.5526315789473686
184,3,5,2,889909672,889909691,19,747,382,3.764705882352941
184,5,4,-1,889909691,889909721,30,382,945,3.4
184,4,3,-1,889909721,889909746,25,945,403,3.298507462686567
184,3,4,1,889909746,889909788,42,403,393,3.5125
184,4,4,0,889909788,889909840,52,393,792,3.793103448275862
184,4,3,-1,889909840,889909868,28,792,735,3.58
184,3,3,0,889909868,889909934,66,735,1195,3.5
184,3,3,0,889909934,889909987,53,1195,716,3.1904761904761907
184,3,3,0,889909987,889909988,1,716,91,3.6
184,3,4,1,889909988,889910034,46,91,52,3.727272727272727
184,4,3,-1,889910034,889910053,19,52,372,3.6666666666666665
184,3,3,0,889910053,889910078,25,372,1006,2.7777777777777777
184,3,3,0,889910078,889910123,45,1006,1232,2.6666666666666665
184,3,3,0,889910123,889910159,36,1232,399,3.317073170731707
184,3,3,0,889910159,889910195,36,399,231,2.938775510204082
184,3,3,0,889910195,889910217,22,231,77,3.3857142857142857
184,3,3,0,889910217,889910233,16,77,1397,3.6666666666666665
184,3,2,-1,889910233,889910257,24,1397,1297,3.0
184,2,3,1,889910257,889910326,69,1297,396,2.84
184,3,3,0,889910326,889910372,46,396,738,3.0
184,3,3,0,889910372,889910394,22,738,217,3.1538461538461537
184,3,3,0,889910394,889910418,24,217,401,2.6774193548387095
184,3,4,1,889910418,889910481,63,401,116,3.6666666666666665
184,4,4,0,889910481,889910545,64,116,1121,3.5
184,4,3,-1,889910545,889910653,108,1121,447,3.46875
184,3,3,0,889910653,889911162,509,447,629,3.3333333333333335
184,3,4,1,889911162,889911178,16,629,165,3.9130434782608696
184,4,4,0,889911178,889911195,17,165,223,4.108695652173913
184,4,3,-1,889911195,889911285,90,223,153,3.7865168539325844
184,3,3,0,889911285,889911434,149,153,164,3.6140350877192984
184,3,3,0,889911434,889911459,25,164,160,3.4
184,3,4,1,889911459,889911552,93,160,71,3.6575342465753424
184,4,3,-1,889911552,889911633,81,71,736,4.083333333333333
184,3,3,0,889911633,889911712,79,736,664,3.15
184,3,5,2,889911712,889911749,37,664,1398,4.5
184,5,2,-3,889911749,889912691,942,1398,412,2.272727272727273
184,2,4,2,889912691,889912890,199,412,1136,3.3076923076923075
184,4,5,1,889912890,889913687,797,1136,632,3.9523809523809526
112,4,4,0,884992462,884992484,22,690,286,3.442857142857143
112,4,4,0,884992484,884992566,82,286,333,3.546666666666667
112,4,4,0,884992566,884992603,37,333,331,3.5517241379310347
112,4,3,-1,884992603,884992651,48,331,984,2.6666666666666665
112,3,4,1,884992651,884992668,17,984,689,3.1538461538461537
112,4,4,0,884992668,884992691,23,689,245,3.056179775280899
112,4,3,-1,884992691,884992714,23,245,678,2.8181818181818183
112,3,4,1,884992714,884992754,40,678,751,3.3896103896103895
112,4,5,1,884992754,884992872,118,751,312,3.0
112,5,4,-1,884992872,886398699,1405827,312,888,3.0
112,4,4,0,886398699,892439835,6041136,888,1106,3.0
112,4,1,-3,892439835,892440172,337,1106,903,2.6666666666666665
133,3,3,0,890588547,890588577,30,751,328,3.4895833333333335
133,3,4,1,890588577,890588612,35,328,306,4.033333333333333
133,4,3,-1,890588612,890588672,60,306,902,3.9444444444444446
133,3,1,-2,890588672,890588720,48,902,539,2.6666666666666665
133,1,4,3,890588720,890588766,46,539,269,4.085106382978723
133,4,2,-2,890588766,890588852,86,269,322,3.0476190476190474
133,2,3,1,890588852,890588878,26,322,245,3.056179775280899
133,3,2,-1,890588878,890588928,50,245,355,2.75
133,2,3,1,890588928,890589035,107,355,243,2.357142857142857
133,3,2,-1,890589035,890589188,153,243,343,3.0
215,3,4,1,891434619,891434733,114,272,271,3.3134328358208953
215,4,3,-1,891434733,891435060,327,271,180,3.9473684210526314
215,3,3,0,891435060,891435161,101,180,205,3.717391304347826
215,3,4,1,891435161,891435183,22,205,127,4.162790697674419
215,4,4,0,891435183,891435266,83,127,134,4.174603174603175
215,4,4,0,891435266,891435394,128,134,172,4.225225225225225
215,4,4,0,891435394,891435460,66,172,191,4.168674698795181
215,4,3,-1,891435460,891435501,41,191,433,3.8035714285714284
215,3,2,-1,891435501,891435526,25,433,238,3.888888888888889
215,2,4,2,891435526,891435548,22,238,196,3.9404761904761907
215,4,4,0,891435548,891435573,25,196,357,4.063291139240507
215,4,4,0,891435573,891435597,24,357,181,3.98974358974359
215,4,4,0,891435597,891435655,58,181,234,3.7674418604651163
215,4,2,-2,891435655,891435680,25,234,212,3.230769230769231
215,2,4,2,891435680,891435704,24,212,421,3.462962962962963
215,4,4,0,891435704,891435731,27,421,99,3.8392857142857144
215,4,4,0,891435731,891435782,51,99,216,3.8454545454545452
215,4,4,0,891435782,891435995,213,216,174,4.253521126760563
215,4,5,1,891435995,891436024,29,174,168,4.0476190476190474
215,5,3,-2,891436024,891436048,24,168,23,3.9047619047619047
215,3,3,0,891436048,891436129,81,23,204,3.6744186046511627
215,3,4,1,891436129,891436150,21,204,194,4.029411764705882
215,4,2,-2,891436150,891436177,27,194,8,3.903225806451613
215,2,4,2,891436177,891436202,25,8,208,3.8125
215,4,4,0,891436202,891436232,30,208,210,3.921259842519685
215,4,5,1,891436232,891436469,237,210,227,3.169811320754717
215,5,3,-2,891436469,891436470,1,227,380,3.4878048780487805
215,3,4,1,891436470,891436566,96,380,185,3.9726027397260273
215,4,3,-1,891436566,891436607,41,185,218,3.5555555555555554
215,3,4,1,891436607,891436633,26,218,226,3.378787878787879
215,4,2,-2,891436633,891436690,57,226,636,3.4146341463414633
215,2,3,1,891436690,891436707,17,636,159,3.3902439024390243
69,4,5,1,882027133,882027173,40,321,288,3.5214285714285714
69,5,3,-2,882027173,882027204,31,288,333,3.546666666666667
69,3,2,-1,882027204,882027233,29,333,294,3.1052631578947367
69,2,4,2,882027233,882027284,51,294,886,2.857142857142857
69,4,2,-2,882027284,882027304,20,886,748,3.1043478260869564
69,2,3,1,882027304,882072778,45474,748,129,3.744186046511628
69,3,3,0,882072778,882072803,25,129,591,3.7169811320754715
69,3,4,1,882072803,882072827,24,591,236,3.2666666666666666
69,4,3,-1,882072827,882072956,129,236,1016,3.559322033898305
69,3,5,2,882072956,882072998,42,1016,151,3.6544117647058822
69,5,3,-2,882072998,882126048,53050,151,235,3.106382978723404
69,3,5,2,882126048,882126086,38,235,7,3.76056338028169
69,5,4,-1,882126086,882126125,39,7,123,3.297872340425532
69,4,5,1,882126125,882126156,31,123,256,3.5
69,5,4,-1,882126156,882145400,19244,256,182,3.842857142857143
69,4,5,1,882145400,882145428,28,182,48,4.055555555555555
69,5,3,-2,882145428,882145465,37,48,427,4.2025316455696204
69,3,5,2,882145465,882145505,40,427,234,3.7674418604651163
69,5,4,-1,882145505,882145524,19,234,79,3.956989247311828
69,4,5,1,882145524,882145548,24,79,174,4.253521126760563
69,5,3,-2,882145548,882145586,38,174,175,3.8354430379746836
104,5,3,-2,888442171,888442172,1,750,268,3.9838709677419355
104,3,2,-1,888442172,888442202,30,268,327,3.5076923076923077
104,2,3,1,888442202,888442249,47,327,328,3.4895833333333335
104,3,3,0,888442249,888442275,26,328,300,3.6861313868613137
104,3,1,-2,888442275,888442304,29,300,286,3.442857142857143
104,1,2,1,888442304,888442305,1,286,333,3.546666666666667
104,2,3,1,888442305,888442436,131,333,299,3.0
104,3,3,0,888442436,888442437,1,299,342,2.64
104,3,2,-1,888442437,888442461,24,342,748,3.1043478260869564
104,2,3,1,888442461,888442485,24,748,312,3.0
104,3,2,-1,888442485,888442507,22,312,895,3.142857142857143
104,2,1,-1,888442507,888442530,23,895,330,2.625
104,1,1,0,888442530,888442552,22,330,325,2.625
104,1,1,0,888442552,888442575,23,325,984,2.6666666666666665
104,1,2,1,888442575,888465226,22651,984,124,4.052631578947368
104,2,4,2,888465226,888465290,64,124,276,3.6036036036036037
104,4,3,-1,888465290,888465319,29,276,222,3.578125
104,3,2,-1,888465319,888465347,28,222,287,3.4516129032258065
104,2,1,-1,888465347,888465379,32,287,1241,2.6666666666666665
104,1,3,2,888465379,888465413,34,1241,544,3.185185185185185
104,3,1,-2,888465413,888465491,78,544,546,2.9789473684210526
104,1,4,3,888465491,888465513,22,546,126,3.8620689655172415
104,4,1,-3,888465513,888465554,41,126,823,2.75
104,1,1,0,888465554,888465634,80,823,1017,3.0
104,1,3,2,888465634,888465675,41,1017,249,3.3275862068965516
104,3,3,0,888465675,888465739,64,249,3,3.0625
104,3,2,-1,888465739,888465818,79,3,1028,2.857142857142857
104,2,2,0,888465818,888465853,35,1028,871,2.3823529411764706
104,2,3,1,888465853,888465900,47,871,412,2.272727272727273
104,3,1,-2,888465900,888465936,36,412,926,2.7857142857142856
104,1,5,4,888465936,888465972,36,926,50,4.306532663316583
104,5,3,-2,888465972,888466002,30,50,147,3.3142857142857145
104,3,1,-2,888466002,888466028,26,147,825,2.914285714285714
104,1,1,0,888466028,888466086,58,825,840,3.090909090909091
240,3,5,2,885775563,885775604,41,300,313,4.323076923076923
240,5,5,0,885775604,885775625,21,313,286,3.442857142857143
240,5,4,-1,885775625,885775683,58,286,307,3.6031746031746033
240,4,4,0,885775683,885775710,27,307,340,3.7419354838709675
240,4,5,1,885775710,885775711,1,340,895,3.142857142857143
240,5,3,-2,885775711,885775745,34,895,336,2.4
240,3,5,2,885775745,885775770,25,336,898,3.0869565217391304
240,5,4,-1,885775770,885775831,61,898,245,3.056179775280899
240,4,2,-2,885775831,885775857,26,245,358,2.6551724137931036
240,2,1,-1,885775857,885775878,21,358,349,2.5714285714285716
240,1,1,0,885775878,885775959,81,349,353,2.4285714285714284
144,4,1,-3,888103371,888103407,36,258,307,3.6031746031746033
144,1,3,2,888103407,888103573,166,307,690,3.260869565217391
144,3,5,2,888103573,888103666,93,690,316,4.285714285714286
144,5,4,-1,888103666,888103725,59,316,751,3.3896103896103895
144,4,5,1,888103725,888103968,243,751,1142,4.0476190476190474
144,5,4,-1,888103968,888103969,1,1142,285,4.181818181818182
144,4,3,-1,888103969,888103988,19,285,298,3.779220779220779
144,3,4,1,888103988,888104032,44,298,248,3.746268656716418
144,4,2,-2,888104032,888104087,55,248,7,3.76056338028169
144,2,4,2,888104087,888104122,35,7,742,3.5555555555555554
144,4,4,0,888104122,888104123,1,742,282,3.610526315789474
144,4,3,-1,888104123,888104191,68,282,281,3.2
144,3,4,1,888104191,888104234,43,281,129,3.744186046511628
144,4,4,0,888104234,888104258,24,129,533,3.6
144,4,2,-2,888104258,888104283,25,533,760,2.35
144,2,3,1,888104283,888104382,99,760,455,3.1702127659574466
144,3,3,0,888104382,888104402,20,455,147,3.3142857142857145
144,3,4,1,888104402,888104419,17,147,405,3.25
144,4,3,-1,888104419,888104446,27,405,1284,2.5454545454545454
144,3,3,0,888104446,888104495,49,1284,1028,2.857142857142857
144,3,3,0,888104495,888104521,26,1028,410,3.0434782608695654
144,3,4,1,888104521,888104588,67,410,411,2.911764705882353
144,4,1,-3,888104588,888104625,37,411,280,3.103448275862069
144,1,1,0,888104625,888104659,34,280,815,3.135135135135135
144,1,3,2,888104659,888104684,25,815,106,2.8125
144,3,4,1,888104684,888104737,53,106,1226,3.5454545454545454
144,4,3,-1,888104737,888104805,68,1226,831,2.6097560975609757
144,3,3,0,888104805,888104940,135,831,762,3.3962264150943398
144,3,4,1,888104940,888105081,141,762,191,4.168674698795181
144,4,4,0,888105081,888105115,34,191,234,3.7674418604651163
144,4,5,1,888105115,888105197,82,234,514,4.033333333333333
144,5,4,-1,888105197,888105312,115,514,521,3.787878787878788
144,4,4,0,888105312,888105337,25,521,478,4.161290322580645
144,4,4,0,888105337,888105338,1,478,647,4.142857142857143
144,4,4,0,888105338,888105387,49,647,213,3.943396226415094
144,4,5,1,888105387,888105439,52,213,22,4.215909090909091
144,5,4,-1,888105439,888105472,33,22,632,3.9523809523809526
144,4,5,1,888105472,888105473,1,632,747,3.5526315789473686
144,5,4,-1,888105473,888105510,37,747,855,3.590909090909091
144,4,3,-1,888105510,888105548,38,855,58,3.543859649122807
144,3,4,1,888105548,888105587,39,58,1039,3.9583333333333335
144,4,5,1,888105587,888105612,25,1039,174,4.253521126760563
144,5,4,-1,888105612,888105636,24,174,956,3.5714285714285716
144,4,3,-1,888105636,888105691,55,956,89,3.9615384615384617
144,3,4,1,888105691,888105714,23,89,215,3.662921348314607
144,4,4,0,888105714,888105743,29,215,393,3.5125
144,4,3,-1,888105743,888105765,22,393,727,3.5517241379310347
144,3,2,-1,888105765,888105784,19,727,960,3.0
144,2,4,2,888105784,888105846,62,960,1286,3.5714285714285716
144,4,4,0,888105846,888105873,27,1286,4,3.5538461538461537
144,4,3,-1,888105873,888105922,49,4,1285,3.1
144,3,4,1,888105922,888105940,18,1285,709,4.171428571428572
144,4,3,-1,888105940,888105993,53,709,454,3.0
144,3,4,1,888105993,888106016,23,454,785,3.4375
144,4,4,0,888106016,888106044,28,785,942,3.4545454545454546
144,4,4,0,888106044,888106078,34,942,66,3.4705882352941178
144,4,2,-2,888106078,888106106,28,66,91,3.6
144,2,2,0,888106106,888106181,75,91,160,3.4
144,2,3,1,888106181,888106182,1,160,61,4.190476190476191
144,3,4,1,888106182,888106322,140,61,480,4.283018867924528
191,3,4,1,891560366,891560631,265,754,331,3.5517241379310347
191,4,3,-1,891560631,891560935,304,331,307,3.6031746031746033
191,3,5,2,891560935,891561456,521,307,316,4.285714285714286
61,2,4,2,891206126,891206194,68,331,310,3.6666666666666665
61,4,3,-1,891206194,891206232,38,310,333,3.546666666666667
61,3,4,1,891206232,891206274,42,333,1127,3.0
61,4,2,-2,891206274,891206407,133,1127,690,3.260869565217391
61,2,1,-1,891206407,892302231,1095824,690,271,3.3134328358208953
61,1,2,1,892302231,892302309,78,271,342,2.64
142,3,4,1,888639837,888639882,45,288,350,3.2
142,4,5,1,888639882,888639968,86,350,333,3.546666666666667
142,5,2,-3,888639968,888640178,210,333,358,2.6551724137931036
142,2,2,0,888640178,888640199,21,358,338,2.75
142,2,1,-1,888640199,888640356,157,338,147,3.3142857142857145
142,1,4,3,888640356,888640379,23,147,408,4.4772727272727275
142,4,4,0,888640379,888640404,25,408,28,3.923076923076923
142,4,4,0,888640404,888640430,26,28,186,3.905263157894737
142,4,5,1,888640430,888640455,25,186,176,3.967032967032967
142,5,4,-1,888640455,888640489,34,176,42,3.893617021276596
177,4,4,0,880130397,880130434,37,333,324,3.2291666666666665
177,4,1,-3,880130434,880130452,18,324,270,3.7804878048780486
177,1,3,2,880130452,880130467,15,270,334,3.4210526315789473
177,3,2,-1,880130467,880130481,14,334,321,3.0172413793103448
177,2,2,0,880130481,880130534,53,321,260,2.4716981132075473
177,2,4,2,880130534,880130600,66,260,154,3.6031746031746033
177,4,4,0,880130600,880130618,18,154,318,4.5046728971962615
177,4,4,0,880130618,880130634,16,318,60,4.105263157894737
177,4,4,0,880130634,880130653,19,60,693,3.6285714285714286
177,4,4,0,880130653,880130667,14,693,173,4.1441441441441444
177,4,5,1,880130667,880130684,17,173,182,3.842857142857143
177,5,4,-1,880130684,880130699,15,182,195,3.9072164948453607
177,4,5,1,880130699,880130712,13,195,135,3.7974683544303796
177,5,4,-1,880130712,880130736,24,135,64,4.373737373737374
177,4,4,0,880130736,880130825,89,64,59,4.0
177,4,4,0,880130825,880130847,22,59,22,4.215909090909091
177,4,3,-1,880130847,880130862,15,22,651,3.8627450980392157
177,3,3,0,880130862,880130881,19,651,124,4.052631578947368
177,3,3,0,880130881,880130898,17,124,96,3.9130434782608696
177,3,3,0,880130898,880130915,17,96,161,3.5844155844155843
177,3,4,1,880130915,880130931,16,161,181,3.98974358974359
177,4,4,0,880130931,880130951,20,181,176,3.967032967032967
177,4,4,0,880130951,880130972,21,176,642,3.4285714285714284
177,4,5,1,880130972,880131011,39,642,144,3.9545454545454546
177,5,5,0,880131011,880131026,15,144,98,4.240875912408759
177,5,4,-1,880131026,880131040,14,98,187,4.215189873417722
177,4,5,1,880131040,880131057,17,187,179,3.8823529411764706
177,5,1,-4,880131057,880131088,31,179,69,3.8015873015873014
177,1,4,3,880131088,880131106,18,69,654,4.119047619047619
177,4,3,-1,880131106,880131123,17,654,1110,2.85
177,3,3,0,880131123,880131143,20,1110,55,4.051282051282051
177,3,4,1,880131143,880131161,18,55,198,4.04
177,4,3,-1,880131161,880131187,26,198,47,3.5869565217391304
177,3,4,1,880131187,880131201,14,47,1067,3.533333333333333
177,4,3,-1,880131201,880131230,29,1067,217,3.1538461538461537
177,3,4,1,880131230,880131231,1,217,1218,3.2
177,4,2,-2,880131231,882141868,2010637,1218,271,3.3134328358208953
177,2,3,1,882141868,882141885,17,271,343,3.0
177,3,2,-1,882141885,882141918,33,343,358,2.6551724137931036
177,2,1,-1,882141918,882142141,223,358,243,2.357142857142857
177,1,3,2,882142141,882142221,80,243,338,2.75
177,3,4,1,882142221,882142295,74,338,92,3.7142857142857144
203,2,3,1,880433398,880433445,47,294,271,3.3134328358208953
203,3,3,0,880433445,880433474,29,271,336,2.4
203,3,3,0,880433474,880433558,84,336,323,3.0
203,3,3,0,880433558,880434298,740,323,257,3.7154471544715446
203,3,4,1,880434298,880434318,20,257,222,3.578125
203,4,3,-1,880434318,880434336,18,222,458,3.0588235294117645
203,3,5,2,880434336,880434359,23,458,283,3.901639344262295
203,5,3,-2,880434359,880434384,25,283,1,3.902439024390244
203,3,1,-2,880434384,880434411,27,1,100,4.0162162162162165
203,1,3,2,880434411,880434438,27,100,7,3.76056338028169
203,3,4,1,880434438,880434463,25,7,471,3.5714285714285716
203,4,5,1,880434463,880434810,347,471,50,4.306532663316583
203,5,3,-2,880434810,880434919,109,50,993,3.4838709677419355
203,3,4,1,880434919,880434940,21,993,93,3.5641025641025643
21,1,3,2,874950931,874950932,1,299,327,3.5076923076923077
21,3,2,-1,874950932,874951005,73,327,678,2.8181818181818183
21,2,1,-1,874951005,874951006,1,678,245,3.056179775280899
21,1,2,1,874951006,874951039,33,245,990,2.769230769230769
21,2,2,0,874951039,874951104,65,990,994,2.0
21,2,5,3,874951104,874951188,84,994,127,4.162790697674419
21,5,5,0,874951188,874951244,56,127,1,3.902439024390244
21,5,3,-2,874951244,874951245,1,1,473,2.9166666666666665
21,3,2,-1,874951245,874951292,47,473,547,3.6666666666666665
21,2,1,-1,874951292,874951314,22,547,758,2.2857142857142856
21,1,4,3,874951314,874951349,35,758,273,3.5238095238095237
21,4,1,-3,874951349,874951382,33,273,118,3.2764227642276422
21,1,2,1,874951382,874951416,34,118,281,3.2
21,2,3,1,874951416,874951446,30,281,291,3.2
21,3,3,0,874951446,874951447,1,291,975,3.411764705882353
21,3,1,-2,874951447,874951482,35,975,148,3.2131147540983607
21,1,3,2,874951482,874951616,134,148,628,3.573529411764706
21,3,3,0,874951616,874951617,1,628,242,3.5217391304347827
21,3,5,2,874951617,874951657,40,242,234,3.7674418604651163
21,5,5,0,874951657,874951658,1,234,185,3.9726027397260273
21,5,5,0,874951658,874951695,37,185,558,3.75
21,5,4,-1,874951695,874951696,1,558,218,3.5555555555555554
21,4,4,0,874951696,874951727,31,218,448,3.466666666666667
21,4,2,-2,874951727,874951797,70,448,453,2.0
21,2,1,-1,874951797,874951798,1,453,440,1.5
21,1,4,3,874951798,874951820,22,440,53,2.9523809523809526
21,4,1,-3,874951820,874951858,38,53,858,1.0
21,1,2,1,874951858,874951897,39,858,674,2.6875
21,2,1,-1,874951897,874951898,1,674,590,1.8888888888888888
21,1,1,0,874951898,874951916,18,590,769,2.2222222222222223
197,2,4,2,891409111,891409160,49,333,313,4.323076923076923
197,4,2,-2,891409160,891409199,39,313,340,3.7419354838709675
197,2,3,1,891409199,891409255,56,340,690,3.260869565217391
197,3,4,1,891409255,891409290,35,690,294,3.1052631578947367
197,4,3,-1,891409290,891409323,33,294,748,3.1043478260869564
197,3,2,-1,891409323,891409352,29,748,271,3.3134328358208953
197,2,3,1,891409352,891409387,35,271,288,3.5214285714285714
197,3,4,1,891409387,891409535,148,288,316,4.285714285714286
197,4,1,-3,891409535,891409564,29,316,688,2.111111111111111
197,1,2,1,891409564,891409593,29,688,678,2.8181818181818183
197,2,1,-1,891409593,891409683,90,678,1420,1.5
197,1,1,0,891409683,891409799,116,1420,56,4.051724137931035
197,1,5,4,891409799,891409838,39,56,210,3.921259842519685
197,5,5,0,891409838,891409839,1,210,22,4.215909090909091
197,5,5,0,891409839,891409893,54,22,82,3.6741573033707864
197,5,4,-1,891409893,891409894,1,82,228,3.7246376811594204
197,4,5,1,891409894,891409935,41,228,510,3.823529411764706
197,5,2,-3,891409935,891409981,46,510,33,3.2941176470588234
197,2,3,1,891409981,891409982,1,33,188,3.625
197,3,3,0,891409982,891410038,56,188,403,3.298507462686567
197,3,3,0,891410038,891410082,44,403,770,3.25
197,3,4,1,891410082,891410124,42,770,570,3.526315789473684
197,4,4,0,891410124,891410170,46,570,554,2.9555555555555557
134,5,4,-1,891732150,891732271,121,313,678,2.8181818181818183
134,4,2,-2,891732271,891732296,25,678,301,3.2465753424657535
134,2,3,1,891732296,891732334,38,301,286,3.442857142857143
134,3,4,1,891732334,891732335,1,286,328,3.4895833333333335
134,4,5,1,891732335,891732365,30,328,748,3.1043478260869564
134,5,4,-1,891732365,891732393,28,748,879,3.2291666666666665
134,4,4,0,891732393,891732418,25,879,316,4.285714285714286
134,4,2,-2,891732418,891732507,89,316,339,2.7058823529411766
134,2,2,0,891732507,891732532,25,339,892,2.9615384615384617
134,2,3,1,891732532,891732726,194,892,508,3.6923076923076925
134,3,5,2,891732726,891732756,30,508,1,3.902439024390244
180,4,5,1,877127189,877127237,48,186,372,3.6666666666666665
180,5,5,0,877127237,877127273,36,372,433,3.8035714285714284
180,5,4,-1,877127273,877127296,23,433,40,2.7037037037037037
180,4,1,-3,877127296,877127572,276,40,790,2.8518518518518516
180,1,5,4,877127572,877127721,149,790,68,3.5714285714285716
180,5,5,0,877127721,877127747,26,68,111,3.5106382978723403
180,5,4,-1,877127747,877127758,11,111,235,3.106382978723404
180,4,5,1,877127758,877127796,38,235,380,3.4878048780487805
180,5,5,0,877127796,877127815,19,380,222,3.578125
180,5,5,0,877127815,877127830,15,222,121,3.521212121212121
180,5,3,-2,877127830,877128137,307,121,732,3.6266666666666665
180,3,3,0,877128137,877128156,19,732,739,3.391304347826087
180,3,5,2,877128156,877128388,232,739,216,3.8454545454545452
180,5,4,-1,877128388,877355337,226949,216,735,3.58
180,4,4,0,877355337,877355472,135,735,939,3.6333333333333333
180,4,3,-1,877355472,877355568,96,939,28,3.923076923076923
180,3,5,2,877355568,877355598,30,28,658,3.393939393939394
180,5,5,0,877355598,877355617,19,658,196,3.9404761904761907
180,5,3,-2,877355617,877355713,96,196,403,3.298507462686567
180,3,5,2,877355713,877372278,16565,403,469,3.6842105263157894
180,5,3,-2,877372278,877442037,69759,469,79,3.956989247311828
180,3,3,0,877442037,877442079,42,79,356,3.2
180,3,4,1,877442079,877442098,19,356,431,3.422222222222222
180,4,5,1,877442098,877442125,27,431,53,2.9523809523809526
180,5,5,0,877442125,877544373,102248,53,631,3.581818181818182
180,5,5,0,877544373,877544384,11,631,961,3.4545454545454546
180,5,5,0,877544384,877544444,60,961,98,4.240875912408759
236,3,4,1,890115856,890115897,41,200,132,3.929411764705882
236,4,2,-2,890115897,890115933,36,132,176,3.967032967032967
236,2,4,2,890115933,890115966,33,176,435,3.8933333333333335
236,4,3,-1,890115966,890115996,30,435,521,3.787878787878788
236,3,5,2,890115996,890116032,36,521,127,4.162790697674419
236,5,2,-3,890116032,890116033,1,127,135,3.7974683544303796
236,2,4,2,890116033,890116095,62,135,699,3.736842105263158
236,4,4,0,890116095,890116132,37,699,673,3.393939393939394
236,4,2,-2,890116132,890116191,59,673,265,3.710144927536232
236,2,5,3,890116191,890116253,62,265,98,4.240875912408759
236,5,3,-2,890116253,890116254,1,98,632,3.9523809523809526
236,3,3,0,890116254,890116335,81,632,1401,3.0
236,3,5,2,890116335,890116426,91,1401,69,3.8015873015873014
236,5,3,-2,890116426,890116451,25,69,661,4.133333333333334
236,3,3,0,890116451,890116499,48,661,496,4.094594594594595
236,3,3,0,890116499,890116500,1,496,526,3.909090909090909
236,3,3,0,890116500,890116539,39,526,174,4.253521126760563
236,3,3,0,890116539,890116599,60,174,659,4.027777777777778
236,3,4,1,890116599,890116628,29,659,549,3.4871794871794872
236,4,3,-1,890116628,890116671,43,549,71,3.6575342465753424
236,3,2,-1,890116671,890116709,38,71,88,3.433734939759036
236,2,3,1,890116709,890116747,38,88,255,3.2027027027027026
236,3,5,2,890116747,890116792,45,255,9,3.8878504672897196
236,5,4,-1,890116792,890116793,1,9,298,3.779220779220779
236,4,4,0,890116793,890116817,24,298,222,3.578125
236,4,3,-1,890116817,890116818,1,222,117,3.689189189189189
236,3,2,-1,890116818,890116895,77,117,294,3.1052631578947367
236,2,2,0,890116895,890116915,20,294,532,2.7777777777777777
236,2,4,2,890116915,890116939,24,532,111,3.5106382978723403
236,4,2,-2,890116939,890116964,25,111,151,3.6544117647058822
236,2,4,2,890116964,890117001,37,151,237,3.7315436241610738
236,4,4,0,890117001,890117028,27,237,148,3.2131147540983607
236,4,4,0,890117028,890117029,1,148,591,3.7169811320754715
236,4,2,-2,890117029,890117073,44,591,864,3.2142857142857144
236,2,1,-1,890117073,890117095,22,864,411,2.911764705882353
236,1,3,2,890117095,890117223,128,411,866,3.3962264150943398
236,3,3,0,890117223,890117308,85,866,476,3.1216216216216215
236,3,3,0,890117308,890117409,101,476,717,2.9696969696969697
236,3,2,-1,890117409,890117465,56,717,1013,2.388888888888889
236,2,4,2,890117465,890117488,23,1013,1102,2.6
236,4,4,0,890117488,890117570,82,1102,934,3.0294117647058822
236,4,5,1,890117570,890117711,141,934,328,3.4895833333333335
236,5,3,-2,890117711,890117748,37,328,333,3.546666666666667
236,3,4,1,890117748,890117820,72,333,289,2.988888888888889
236,4,4,0,890117820,890117902,82,289,307,3.6031746031746033
236,4,3,-1,890117902,890118075,173,307,504,4.085714285714285
236,3,3,0,890118075,890118106,31,504,478,4.161290322580645
236,3,2,-1,890118106,890118153,47,478,210,3.921259842519685
236,2,2,0,890118153,890118206,53,210,183,3.951219512195122
236,2,5,3,890118206,890118228,22,183,97,3.7282608695652173
236,5,5,0,890118228,890118251,23,97,432,3.719298245614035
236,5,4,-1,890118251,890118307,56,432,199,4.191489361702128
236,4,3,-1,890118307,890118340,33,199,187,4.215189873417722
236,3,3,0,890118340,890118393,53,187,204,3.6744186046511627
236,3,4,1,890118393,890118417,24,204,79,3.956989247311828
236,4,2,-2,890118417,890118462,45,79,58,3.543859649122807
236,2,2,0,890118462,890118507,45,58,66,3.4705882352941178
236,2,3,1,890118507,890118543,36,66,510,3.823529411764706
236,3,1,-2,890118543,890118632,89,510,429,3.742857142857143
263,4,5,1,891296896,891296919,23,315,272,4.2
263,5,3,-2,891296919,891296969,50,272,258,3.7547169811320753
263,3,2,-1,891296969,891297330,361,258,294,3.1052631578947367
263,2,5,3,891297330,891297416,86,294,316,4.285714285714286
263,5,4,-1,891297416,891297417,1,316,245,3.056179775280899
263,4,2,-2,891297417,891297484,67,245,886,2.857142857142857
263,2,1,-1,891297484,891297485,1,886,323,3.0
263,1,2,1,891297485,891297677,192,323,260,2.4716981132075473
263,2,4,2,891297677,891297921,244,260,180,3.9473684210526314
263,4,4,0,891297921,891297988,67,180,98,4.240875912408759
263,4,5,1,891297988,891298046,58,98,498,4.290909090909091
263,5,5,0,891298046,891298107,61,498,194,4.029411764705882
263,5,3,-2,891298107,891298163,56,194,520,4.136363636363637
263,3,4,1,891298163,891298164,1,520,196,3.9404761904761907
263,4,5,1,891298164,891298218,54,196,496,4.094594594594595
263,5,4,-1,891298218,891298336,118,496,96,3.9130434782608696
263,4,3,-1,891298336,891298337,1,96,1020,3.727272727272727
263,3,5,2,891298337,891298391,54,1020,1126,3.625
263,5,5,0,891298391,891298392,1,1126,132,3.929411764705882
263,5,5,0,891298392,891298453,61,132,100,4.0162162162162165
263,5,5,0,891298453,891298592,139,100,515,4.202898550724638
263,5,4,-1,891298592,891298655,63,515,183,3.951219512195122
263,4,3,-1,891298655,891298727,72,183,153,3.7865168539325844
263,3,5,2,891298727,891298728,1,153,661,4.133333333333334
263,5,5,0,891298728,891298914,186,661,199,4.191489361702128
263,5,4,-1,891298914,891298976,62,199,482,3.9444444444444446
263,4,3,-1,891298976,891298977,1,482,99,3.8392857142857144
263,3,4,1,891298977,891299031,54,99,202,3.730337078651685
263,4,5,1,891299031,891299148,117,202,527,3.823529411764706
263,5,5,0,891299148,891299207,59,527,1,3.902439024390244
263,5,5,0,891299207,891299265,58,1,732,3.6266666666666665
263,5,5,0,891299265,891299324,59,732,511,4.096153846153846
263,5,2,-3,891299324,891299448,124,511,432,3.719298245614035
263,2,4,2,891299448,891299514,66,432,434,3.588235294117647
263,4,4,0,891299514,891299574,60,434,86,3.869565217391304
263,4,4,0,891299574,891299815,241,86,186,3.905263157894737
263,4,5,1,891299815,891299877,62,186,135,3.7974683544303796
263,5,3,-2,891299877,891299949,72,135,1444,2.3333333333333335
263,3,2,-1,891299949,891300103,154,1444,250,3.4698795180722892
109,4,2,-2,880563080,880563471,391,100,250,3.4698795180722892
109,2,1,-1,880563471,880563641,170,250,475,3.956043956043956
109,1,5,4,880563641,880564457,816,475,117,3.689189189189189
109,5,1,-4,880564457,880564534,77,117,410,3.0434782608695654
109,1,4,3,880564534,880564570,36,410,111,3.5106382978723403
109,4,3,-1,880564570,880564607,37,111,9,3.8878504672897196
109,3,2,-1,880564607,880564640,33,9,628,3.573529411764706
109,2,3,1,880564640,880564678,38,628,282,3.610526315789474
109,3,4,1,880564678,880564679,1,282,147,3.3142857142857145
109,4,5,1,880564679,880571661,6982,147,1016,3.559322033898305
109,5,4,-1,880571661,880571684,23,1016,845,3.661290322580645
109,4,2,-2,880571684,880571715,31,845,763,3.347826086956522
109,2,5,3,880571715,880571741,26,763,121,3.521212121212121
109,5,4,-1,880571741,880571770,29,121,237,3.7315436241610738
109,4,3,-1,880571770,880571801,31,237,118,3.2764227642276422
109,3,4,1,880571801,880571831,30,118,1028,2.857142857142857
109,4,4,0,880571831,880571872,41,1028,866,3.3962264150943398
109,4,2,-2,880571872,880571919,47,866,281,3.2
109,2,2,0,880571919,880571920,1,281,409,2.9615384615384617
109,2,4,2,880571920,880571979,59,409,1014,3.1
109,4,3,-1,880571979,880572108,129,1014,595,2.9166666666666665
109,3,3,0,880572108,880572134,26,595,928,3.142857142857143
109,3,4,1,880572134,880572296,162,928,411,2.911764705882353
109,4,2,-2,880572296,880572350,54,411,871,2.3823529411764706
109,2,3,1,880572350,880572382,32,871,413,2.5652173913043477
109,3,2,-1,880572382,880572407,25,413,931,2.2758620689655173
109,2,2,0,880572407,880572528,121,931,357,4.063291139240507
109,2,2,0,880572528,880572560,32,357,64,4.373737373737374
109,2,4,2,880572560,880572561,1,64,69,3.8015873015873014
109,4,4,0,880572561,880572588,27,69,223,4.108695652173913
109,4,5,1,880572588,880572642,54,223,520,4.136363636363637
109,5,5,0,880572642,880572680,38,520,82,3.6741573033707864
109,5,4,-1,880572680,880572755,75,82,98,4.240875912408759
109,4,1,-3,880572755,880572756,1,98,209,3.8275862068965516
109,1,3,2,880572756,880572786,30,209,186,3.905263157894737
109,3,3,0,880572786,880572891,105,186,216,3.8454545454545452
109,3,5,2,880572891,880573084,193,216,156,4.017857142857143
109,5,2,-3,880573084,880573085,1,156,317,3.774193548387097
109,2,4,2,880573085,880573263,178,317,89,3.9615384615384617
109,4,4,0,880573263,880577542,4279,89,12,4.358974358974359
109,4,3,-1,880577542,880577604,62,12,527,3.823529411764706
109,3,2,-1,880577604,880577734,130,527,200,3.8157894736842106
109,2,3,1,880577734,880577735,1,200,655,3.7857142857142856
109,3,5,2,880577735,880577804,69,655,56,4.051724137931035
109,5,4,-1,880577804,880577844,40,56,31,3.642857142857143
109,4,5,1,880577844,880577868,24,31,176,3.967032967032967
109,5,5,0,880577868,880577892,24,176,72,3.175438596491228
109,5,4,-1,880577892,880577961,69,72,179,3.8823529411764706
109,4,5,1,880577961,880578038,77,179,195,3.9072164948453607
109,5,4,-1,880578038,880578066,28,195,71,3.6575342465753424
109,4,5,1,880578066,880578093,27,71,380,3.4878048780487805
109,5,3,-2,880578093,880578121,28,380,367,3.4242424242424243
109,3,5,2,880578121,880578185,64,367,265,3.710144927536232
109,5,5,0,880578185,880578186,1,265,568,3.5853658536585367
109,5,4,-1,880578186,880578286,100,568,234,3.7674418604651163
109,4,4,0,880578286,880578358,72,234,177,3.875
109,4,4,0,880578358,880578388,30,177,588,3.8358208955223883
109,4,4,0,880578388,880578502,114,588,233,3.323529411764706
109,4,5,1,880578502,880578503,1,233,226,3.378787878787879
109,5,3,-2,880578503,880578598,95,226,215,3.662921348314607
109,3,5,2,880578598,880578632,34,215,229,3.185185185185185
109,5,4,-1,880578632,880578633,1,229,218,3.5555555555555554
109,4,4,0,880578633,880578711,78,218,356,3.2
109,4,4,0,880578711,880579237,526,356,393,3.5125
109,4,3,-1,880579237,880579371,134,393,631,3.581818181818182
109,3,5,2,880579371,880579417,46,631,227,3.169811320754717
109,5,2,-3,880579417,880579418,1,227,1039,3.9583333333333335
109,2,1,-1,880579418,880579757,339,1039,131,3.731707317073171
109,1,4,3,880579757,880579758,1,131,1222,2.6363636363636362
109,4,4,0,880579758,880579787,29,1222,94,2.8823529411764706
109,4,1,-3,880579787,880579916,129,94,158,2.7027027027027026
109,1,2,1,880579916,880580030,114,158,81,3.2857142857142856
109,2,4,2,880580030,880581942,1912,81,88,3.433734939759036
109,4,5,1,880581942,880581987,45,88,449,2.9069767441860463
109,5,4,-1,880581987,880582132,145,449,17,3.032258064516129
109,4,5,1,880582132,880582133,1,17,627,3.3823529411764706
109,5,5,0,880582133,880582384,251,627,665,2.72972972972973
109,5,2,-3,880582384,880582414,30,665,552,2.8095238095238093
109,2,3,1,880582414,880582469,55,552,68,3.5714285714285716
109,3,2,-1,880582469,880582633,164,68,441,2.4
109,2,3,1,880582633,880582679,46,441,63,3.125
109,3,3,0,880582679,880582783,104,63,29,2.5714285714285716
109,3,3,0,880582783,880582856,73,29,796,2.923076923076923
109,3,3,0,880582856,880583192,336,796,90,3.0
109,3,5,2,880583192,880583241,49,90,373,3.142857142857143
109,5,4,-1,880583241,880583308,67,373,1074,2.857142857142857
109,4,4,0,880583308,880583336,28,1074,53,2.9523809523809526
109,4,3,-1,880583336,880583410,74,53,810,2.9473684210526314
109,3,2,-1,880583410,880583463,53,810,1139,2.611111111111111
109,2,3,1,880583463,880583493,30,1139,722,2.9642857142857144
109,3,4,1,880583493,880583646,153,722,1157,3.142857142857143
109,4,3,-1,880583646,880583672,26,1157,395,2.5714285714285716
109,3,2,-1,880583672,880583753,81,395,452,2.6129032258064515
64,1,4,3,879365314,879365491,177,748,157,3.5714285714285716
64,4,4,0,879365491,879365558,67,157,100,4.0162162162162165
64,4,2,-2,879365558,879365590,32,100,652,3.9642857142857144
64,2,5,3,879365590,879365619,29,652,48,4.055555555555555
64,5,3,-2,879365619,879365670,51,48,71,3.6575342465753424
64,3,4,1,879365670,889737047,10371377,71,310,3.6666666666666665
64,4,2,-2,889737047,889737106,59,310,898,3.0869565217391304
64,2,1,-1,889737106,889737126,20,898,539,2.6666666666666665
64,1,2,1,889737126,889737269,143,539,311,3.761904761904762
64,2,4,2,889737269,889737376,107,311,431,3.422222222222222
64,4,3,-1,889737376,889737420,44,431,77,3.3857142857142857
64,3,5,2,889737420,889737478,58,77,174,4.253521126760563
64,5,3,-2,889737478,889737505,27,174,663,3.948717948717949
64,3,3,0,889737505,889737542,37,663,392,3.5555555555555554
64,3,4,1,889737542,889737567,25,392,176,3.967032967032967
64,4,2,-2,889737567,889737568,1,176,217,3.1538461538461537
64,2,4,2,889737568,889737593,25,217,318,4.5046728971962615
64,4,3,-1,889737593,889737609,16,318,2,3.0851063829787235
64,3,4,1,889737609,889737654,45,2,98,4.240875912408759
64,4,4,0,889737654,889737691,37,98,95,3.8194444444444446
64,4,5,1,889737691,889737710,19,95,194,4.029411764705882
64,5,4,-1,889737710,889737748,38,194,96,3.9130434782608696
64,4,4,0,889737748,889737771,23,96,435,3.8933333333333335
64,4,5,1,889737771,889737851,80,435,520,4.136363636363637
64,5,5,0,889737851,889737914,63,520,183,3.951219512195122
64,5,4,-1,889737914,889737943,29,183,79,3.956989247311828
64,4,1,-3,889737943,889737968,25,79,1065,3.1578947368421053
64,1,4,3,889737968,889737992,24,1065,196,3.9404761904761907
64,4,5,1,889737992,889738085,93,196,12,4.358974358974359
64,5,4,-1,889738085,889739051,966,12,143,3.56
64,4,4,0,889739051,889739091,40,143,69,3.8015873015873014
64,4,3,-1,889739091,889739138,47,69,4,3.5538461538461537
64,3,5,2,889739138,889739158,20,4,70,3.5833333333333335
64,5,4,-1,889739158,889739212,54,70,463,3.6818181818181817
64,4,5,1,889739212,889739243,31,463,633,3.9
64,5,4,-1,889739243,889739318,75,633,211,3.958904109589041
64,4,3,-1,889739318,889739380,62,211,241,3.5625
64,3,5,2,889739380,889739415,35,241,175,3.8354430379746836
64,5,2,-3,889739415,889739490,75,175,451,3.207792207792208
64,2,4,2,889739490,889739517,27,451,141,3.4827586206896552
64,4,4,0,889739517,889739569,52,141,423,3.7016129032258065
64,4,4,0,889739569,889739586,17,423,188,3.625
64,4,3,-1,889739586,889739648,62,188,731,3.4
64,3,3,0,889739648,889739678,30,731,420,3.5652173913043477
64,3,3,0,889739678,889739733,55,420,17,3.032258064516129
64,3,4,1,889739733,889739779,46,17,511,4.096153846153846
64,4,5,1,889739779,889739806,27,511,778,3.5925925925925926
64,5,5,0,889739806,889739834,28,778,1141,3.6666666666666665
64,5,3,-2,889739834,889739883,49,1141,546,2.9789473684210526
64,3,4,1,889739883,889739903,20,546,959,3.4583333333333335
64,4,4,0,889739903,889739953,50,959,403,3.298507462686567
64,4,2,-2,889739953,889739954,1,403,768,3.238095238095238
64,2,4,2,889739954,889739975,21,768,1133,3.076923076923077
64,4,3,-1,889739975,889740011,36,1133,212,3.230769230769231
64,3,3,0,889740011,889740033,22,212,679,3.2432432432432434
64,3,4,1,889740033,889740056,23,679,284,3.1547619047619047
64,4,3,-1,889740056,889740154,98,284,356,3.2
64,3,4,1,889740154,889740199,45,356,684,3.847826086956522
64,4,2,-2,889740199,889740225,26,684,101,3.4827586206896552
64,2,1,-1,889740225,889740260,35,101,1139,2.611111111111111
64,1,1,0,889740260,889740286,26,1139,476,3.1216216216216215
64,1,3,2,889740286,889740310,24,476,559,3.477272727272727
64,3,4,1,889740310,889740342,32,559,503,3.6363636363636362
64,4,2,-2,889740342,889740367,25,503,384,2.7941176470588234
64,2,4,2,889740367,889740394,27,384,591,3.7169811320754715
64,4,3,-1,889740394,889740415,21,591,38,2.784313725490196
64,3,1,-2,889740415,889740462,47,38,240,3.0350877192982457
64,1,4,3,889740462,889740567,105,240,235,3.106382978723404
64,4,3,-1,889740567,889740602,35,235,569,2.4285714285714284
64,3,2,-1,889740602,889740654,52,569,62,3.048780487804878
64,2,1,-1,889740654,889740676,22,62,1140,2.1666666666666665
64,1,3,2,889740676,889740718,42,1140,531,3.7435897435897436
64,3,3,0,889740718,889740880,162,531,227,3.169811320754717
114,4,5,1,881259525,881259955,430,357,175,3.8354430379746836
114,5,4,-1,881259955,881259994,39,175,496,4.094594594594595
114,4,5,1,881259994,881260170,176,496,474,4.172413793103448
114,5,4,-1,881260170,881260246,76,474,483,4.475609756097561
114,4,3,-1,881260246,881260303,57,483,507,3.6285714285714286
114,3,3,0,881260303,881260409,106,507,485,3.717948717948718
114,3,3,0,881260409,881260441,32,485,204,3.6744186046511627
114,3,4,1,881260441,881260473,32,204,646,3.9285714285714284
114,4,4,0,881260473,881260506,33,646,197,4.112676056338028
114,4,3,-1,881260506,881260545,39,197,56,4.051724137931035
114,3,4,1,881260545,881260611,66,56,135,3.7974683544303796
114,4,3,-1,881260611,881309622,49011,135,153,3.7865168539325844
114,3,5,2,881309622,881309662,40,153,522,3.8461538461538463
114,5,3,-2,881309662,881309718,56,522,180,3.9473684210526314
239,5,1,-4,889178562,889178616,54,528,190,4.233333333333333
239,1,4,3,889178616,889178652,36,190,705,3.7857142857142856
239,4,4,0,889178652,889178688,36,705,185,3.9726027397260273
239,4,5,1,889178688,889178729,41,185,12,4.358974358974359
239,5,3,-2,889178729,889178762,33,12,234,3.7674418604651163
239,3,5,2,889178762,889178887,125,234,513,4.526315789473684
239,5,5,0,889178887,889178986,99,513,132,3.929411764705882
239,5,5,0,889178986,889179032,46,132,1070,4.0
239,5,5,0,889179032,889179033,1,1070,134,4.174603174603175
239,5,5,0,889179033,889179095,62,134,474,4.172413793103448
239,5,4,-1,889179095,889179131,36,474,174,4.253521126760563
239,4,5,1,889179131,889179253,122,174,1099,3.7142857142857144
239,5,5,0,889179253,889179290,37,1099,530,4.125
239,5,5,0,889179290,889179291,1,530,736,4.083333333333333
239,5,4,-1,889179291,889179478,187,736,56,4.051724137931035
239,4,5,1,889179478,889179623,145,56,462,3.7954545454545454
239,5,3,-2,889179623,889179808,185,462,81,3.2857142857142856
239,3,5,2,889179808,889180041,233,81,65,3.511111111111111
239,5,5,0,889180041,889180071,30,65,183,3.951219512195122
239,5,2,-3,889180071,889180169,98,183,47,3.5869565217391304
239,2,3,1,889180169,889180338,169,47,430,4.136363636363637
239,3,5,2,889180338,889180410,72,430,179,3.8823529411764706
239,5,5,0,889180410,889180411,1,179,165,3.9130434782608696
239,5,5,0,889180411,889180446,35,165,9,3.8878504672897196
239,5,5,0,889180446,889180447,1,9,433,3.8035714285714284
239,5,5,0,889180447,889180487,40,433,1098,3.533333333333333
239,5,5,0,889180487,889180530,43,1098,650,3.1363636363636362
239,5,5,0,889180530,889180578,48,650,45,4.130434782608695
239,5,5,0,889180578,889180616,38,45,493,3.909090909090909
239,5,5,0,889180616,889180617,1,493,663,3.948717948717949
239,5,2,-3,889180617,889180651,34,663,1115,3.3846153846153846
239,2,5,3,889180651,889180747,96,1115,654,4.119047619047619
239,5,3,-2,889180747,889180888,141,654,1332,3.0
239,3,5,2,889180888,889180921,33,1332,512,3.888888888888889
239,5,3,-2,889180921,889180949,28,512,518,3.5833333333333335
239,3,5,2,889180949,889180978,29,518,428,3.744186046511628
239,5,5,0,889180978,889181015,37,428,1065,3.1578947368421053
239,5,5,0,889181015,889181047,32,1065,198,4.04
239,5,5,0,889181047,889181048,1,198,421,3.462962962962963
239,5,5,0,889181048,889181093,45,421,116,3.6666666666666665
239,5,2,-3,889181093,889181247,154,116,312,3.0
239,2,1,-1,889181247,889181248,1,312,304,3.5306122448979593
117,5,5,0,880124306,880124339,33,268,307,3.6031746031746033
117,5,3,-2,880124339,880124378,39,307,748,3.1043478260869564
117,3,4,1,880124378,880124397,19,748,271,3.3134328358208953
117,4,5,1,880124397,880124413,16,271,886,2.857142857142857
117,5,4,-1,880124413,880124435,22,886,678,2.8181818181818183
117,4,4,0,880124435,880124509,74,678,358,2.6551724137931036
117,4,5,1,880124509,880124648,139,358,181,3.98974358974359
117,5,3,-2,880124648,880125780,1132,181,7,3.76056338028169
117,3,5,2,880125780,880125887,107,7,15,3.725663716814159
117,5,5,0,880125887,880125911,24,15,257,3.7154471544715446
117,5,3,-2,880125911,880126038,127,257,240,3.0350877192982457
117,3,4,1,880126038,880126083,45,240,1,3.902439024390244
117,4,5,1,880126083,880126174,91,1,405,3.25
117,5,3,-2,880126174,880126232,58,405,411,2.911764705882353
117,3,5,2,880126232,880126295,63,411,282,3.610526315789474
117,5,4,-1,880126295,880126336,41,282,109,3.282608695652174
117,4,4,0,880126336,880126373,37,109,151,3.6544117647058822
117,4,3,-1,880126373,880126392,19,151,596,3.180327868852459
117,3,5,2,880126392,880126461,69,596,117,3.689189189189189
117,5,5,0,880126461,881008815,882354,117,1016,3.559322033898305
117,5,3,-2,881008815,881009471,656,1016,928,3.142857142857143
117,3,3,0,881009471,881009758,287,928,546,2.9789473684210526
117,3,5,2,881009758,881009890,132,546,763,3.347826086956522
117,5,4,-1,881009890,881010052,162,763,597,3.2771084337349397
117,4,3,-1,881010052,881010219,167,597,829,2.4615384615384617
117,3,3,0,881010219,881010322,103,829,252,2.911392405063291
117,3,1,-2,881010322,881010401,79,252,743,1.9545454545454546
117,1,3,2,881010401,881010610,209,743,368,1.8823529411764706
117,3,3,0,881010610,881010727,117,368,1165,1.8
117,3,3,0,881010727,881010728,1,1165,931,2.2758620689655173
117,3,5,2,881010728,881011350,622,931,12,4.358974358974359
117,5,4,-1,881011350,881011376,26,12,156,4.017857142857143
117,4,4,0,881011376,881011393,17,156,174,4.253521126760563
117,4,4,0,881011393,881011413,20,174,789,3.7777777777777777
117,4,5,1,881011413,881011727,314,789,164,3.6140350877192984
117,5,5,0,881011727,881011824,97,164,11,3.8904109589041096
117,5,4,-1,881011824,881012110,286,11,132,3.929411764705882
117,4,5,1,881012110,881012174,64,132,628,3.573529411764706
117,5,5,0,881012174,881012193,19,628,214,3.272727272727273
117,5,5,0,881012193,881012255,62,214,195,3.9072164948453607
117,5,4,-1,881012255,881012293,38,195,210,3.921259842519685
117,4,4,0,881012293,881012430,137,210,98,4.240875912408759
117,4,1,-3,881012430,881012472,42,98,143,3.56
117,1,5,4,881012472,881012530,58,143,96,3.9130434782608696
117,5,5,0,881012530,881012550,20,96,168,4.0476190476190474
117,5,5,0,881012550,881012601,51,168,421,3.462962962962963
117,5,5,0,881012601,881012623,22,421,172,4.225225225225225
117,5,4,-1,881012623,881012940,317,172,265,3.710144927536232
117,4,5,1,881012940,886018996,5006056,265,751,3.3896103896103895
117,5,2,-3,886018996,886019030,34,751,895,3.142857142857143
65,3,1,-2,879216479,879216529,50,69,70,3.5833333333333335
65,1,4,3,879216529,879216567,38,70,511,4.096153846153846
65,4,5,1,879216567,879216605,38,511,97,3.7282608695652173
65,5,5,0,879216605,879216637,32,97,196,3.9404761904761907
65,5,3,-2,879216637,879216672,35,196,65,3.511111111111111
65,3,5,2,879216672,879216702,30,65,423,3.7016129032258065
65,5,4,-1,879216702,879216734,32,423,28,3.923076923076923
65,4,4,0,879216734,879216769,35,28,655,3.7857142857142856
65,4,4,0,879216769,879216797,28,655,191,4.168674698795181
65,4,5,1,879216797,879216825,28,191,356,3.2
65,5,4,-1,879216825,879216949,124,356,736,4.083333333333333
65,4,3,-1,879216949,879217002,53,736,1044,3.2777777777777777
65,3,5,2,879217002,879217032,30,1044,378,3.6904761904761907
65,5,5,0,879217032,879217138,106,378,9,3.8878504672897196
65,5,4,-1,879217138,879217258,120,9,1129,3.4444444444444446
65,4,1,-3,879217258,879217290,32,1129,7,3.76056338028169
65,1,4,3,879217290,879217320,30,7,237,3.7315436241610738
65,4,4,0,879217320,879217349,29,237,1142,4.0476190476190474
65,4,3,-1,879217349,879217406,57,1142,255,3.2027027027027026
65,3,4,1,879217406,879217434,28,255,471,3.5714285714285716
65,4,4,0,879217434,879217458,24,471,121,3.521212121212121
65,4,3,-1,879217458,879217558,100,121,100,4.0162162162162165
65,3,5,2,879217558,879217689,131,100,676,3.3142857142857145
65,5,4,-1,879217689,879217852,163,676,211,3.958904109589041
65,4,4,0,879217852,879217881,29,211,194,4.029411764705882
65,4,4,0,879217881,879217912,31,194,216,3.8454545454545452
65,4,4,0,879217912,879217913,1,216,210,3.921259842519685
65,4,3,-1,879217913,879217942,29,210,1041,3.3333333333333335
65,3,3,0,879217942,879217972,30,1041,66,3.4705882352941178
65,3,4,1,879217972,879217998,26,66,514,4.033333333333333
65,4,4,0,879217998,879218025,27,514,435,3.8933333333333335
65,4,4,0,879218025,879218449,424,435,185,3.9726027397260273
137,3,5,2,881432671,881432735,64,289,680,2.8333333333333335
137,5,4,-1,881432735,881432756,21,680,687,2.1481481481481484
137,4,4,0,881432756,881432790,34,687,243,2.357142857142857
137,4,5,1,881432790,881432987,197,243,597,3.2771084337349397
137,5,3,-2,881432987,881433048,61,597,1,3.902439024390244
137,3,3,0,881433048,881433090,42,1,866,3.3962264150943398
137,3,5,2,881433090,881433116,26,866,546,2.9789473684210526
137,5,5,0,881433116,881433179,63,546,118,3.2764227642276422
137,5,5,0,881433179,881433336,157,118,405,3.25
137,5,5,0,881433336,881433409,73,405,1028,2.857142857142857
137,5,2,-3,881433409,881433435,26,1028,1117,3.0
137,2,5,3,881433435,881433490,55,1117,411,2.911764705882353
137,5,1,-4,881433490,881433524,34,411,476,3.1216216216216215
137,1,1,0,881433524,881433605,81,476,51,3.5277777777777777
137,1,5,4,881433605,881433654,49,51,210,3.921259842519685
137,5,5,0,881433654,881433689,35,210,195,3.9072164948453607
257,4,3,-1,879029581,879029620,39,307,301,3.2465753424657535
257,3,5,2,879029620,879029716,96,301,475,3.956043956043956
257,5,4,-1,879029716,879547534,517818,475,113,4.25
257,4,4,0,879547534,879547655,121,113,86,3.869565217391304
257,4,5,1,879547655,879547717,62,86,57,4.133333333333334
257,5,5,0,879547717,880496690,948973,57,381,3.2758620689655173
257,5,2,-3,880496690,880496943,253,381,1472,2.0
257,2,5,3,880496943,882049897,1552954,1472,50,4.306532663316583
257,5,4,-1,882049897,882049932,35,50,137,3.9545454545454546
257,4,5,1,882049932,882049950,18,137,100,4.0162162162162165
257,5,5,0,882049950,882050131,181,100,181,3.98974358974359
257,5,4,-1,882050131,882050150,19,181,1010,3.611111111111111
257,4,4,0,882050150,882050151,1,1010,936,3.727272727272727
257,4,2,-2,882050151,882050168,17,936,237,3.7315436241610738
257,2,5,3,882050168,882050187,19,237,1008,3.5
257,5,3,-2,882050187,882050202,15,1008,221,3.6923076923076925
257,3,2,-1,882050202,882050236,34,221,130,1.8461538461538463
257,2,3,1,882050236,882050360,124,130,121,3.521212121212121
257,3,3,0,882050360,882050397,37,121,405,3.25
257,3,4,1,882050397,884151807,2101410,405,245,3.056179775280899
111,4,4,0,891679840,891679901,61,304,242,3.5217391304347827
111,4,3,-1,891679901,891679939,38,242,1024,3.0
111,3,5,2,891679939,891679971,32,1024,302,4.133333333333334
111,5,4,-1,891679971,891680028,57,302,311,3.761904761904762
111,4,3,-1,891680028,891680076,48,311,321,3.0172413793103448
111,3,2,-1,891680076,891680243,167,321,305,3.5789473684210527
285,2,4,2,890595408,890595456,48,258,346,3.5128205128205128
285,4,5,1,890595456,890595479,23,346,538,3.25
285,5,5,0,890595479,890595584,105,538,288,3.5214285714285714
285,5,4,-1,890595584,890595636,52,288,100,4.0162162162162165
285,4,3,-1,890595636,890595777,141,100,64,4.373737373737374
285,3,4,1,890595777,890595859,82,64,191,4.168674698795181
285,4,5,1,890595859,890595900,41,191,198,4.04
96,4,5,1,884402860,884402896,36,156,89,3.9615384615384617
96,5,4,-1,884402896,884402977,81,89,514,4.033333333333333
96,4,4,0,884402977,884402978,1,514,190,4.233333333333333
96,4,5,1,884402978,884403020,42,190,174,4.253521126760563
96,5,4,-1,884403020,884403095,75,174,216,3.8454545454545452
96,4,5,1,884403095,884403123,28,216,23,3.9047619047619047
96,5,5,0,884403123,884403214,91,23,98,4.240875912408759
96,5,5,0,884403214,884403215,1,98,200,3.8157894736842106
96,5,5,0,884403215,884403250,35,200,91,3.6
96,5,5,0,884403250,884403336,86,91,64,4.373737373737374
96,5,5,0,884403336,884403465,129,64,198,4.04
96,5,3,-2,884403465,884403500,35,198,435,3.8933333333333335
96,3,4,1,884403500,884403531,31,435,87,3.9
96,4,5,1,884403531,884403574,43,87,1,3.902439024390244
96,5,5,0,884403574,884403687,113,1,181,3.98974358974359
96,5,5,0,884403687,884403811,124,181,7,3.76056338028169
96,5,5,0,884403811,884403866,55,7,170,4.242424242424242
96,5,5,0,884403866,884403993,127,170,1154,3.6
96,5,5,0,884403993,884404017,24,1154,1232,2.6666666666666665
116,2,3,1,876452054,876452133,79,333,299,3.0
116,3,3,0,876452133,876452186,53,299,323,3.0
116,3,3,0,876452186,876452228,42,323,872,3.0
116,3,4,1,876452228,876452443,215,872,515,4.202898550724638
116,4,3,-1,876452443,876452492,49,515,253,3.5
116,3,3,0,876452492,876452524,32,253,255,3.2027027027027026
116,3,3,0,876452524,876452555,31,255,298,3.779220779220779
116,3,3,0,876452555,876452582,27,298,1216,3.5
116,3,4,1,876452582,876452606,24,1216,250,3.4698795180722892
116,4,2,-2,876452606,876452651,45,250,532,2.7777777777777777
116,2,2,0,876452651,876452705,54,532,249,3.3275862068965516
116,2,2,0,876452705,876452806,101,249,650,3.1363636363636362
116,2,5,3,876452806,876452854,48,650,596,3.180327868852459
116,5,3,-2,876452854,876453171,317,596,1082,2.6666666666666665
116,3,2,-1,876453171,876453191,20,1082,1244,2.7777777777777777
116,2,1,-1,876453191,876453222,31,1244,1256,2.0
116,1,3,2,876453222,876453422,200,1256,1214,1.8
116,3,4,1,876453422,876453519,97,1214,730,3.8
116,4,4,0,876453519,876453560,41,730,221,3.6923076923076925
116,4,4,0,876453560,876453626,66,221,195,3.9072164948453607
116,4,4,0,876453626,876453681,55,195,193,3.883720930232558
116,4,3,-1,876453681,876453733,52,193,116,3.6666666666666665
116,3,3,0,876453733,876453800,67,116,421,3.462962962962963
116,3,4,1,876453800,876453847,47,421,292,3.6666666666666665
116,4,2,-2,876453847,876453865,18,292,1220,2.9166666666666665
116,2,5,3,876453865,876453915,50,1220,203,3.826923076923077
116,5,2,-3,876453915,876453961,46,203,607,4.136363636363637
116,2,2,0,876453961,876454052,91,607,65,3.511111111111111
116,2,4,2,876454052,876454090,38,65,390,4.0
116,4,2,-2,876454090,876454109,19,390,1253,1.3333333333333333
116,2,4,2,876454109,876454174,65,1253,199,4.191489361702128
116,4,4,0,876454174,876454191,17,199,479,4.25
116,4,5,1,876454191,876454257,66,479,127,4.162790697674419
116,5,2,-3,876454257,876454308,51,127,137,3.9545454545454546
116,2,3,1,876454308,879864042,3409734,137,270,3.7804878048780486
116,3,3,0,879864042,881246591,1382549,270,887,3.5789473684210527
116,3,3,0,881246591,886309505,5062914,887,272,4.2
116,3,4,1,886309505,886309549,44,272,310,3.6666666666666665
116,4,2,-2,886309549,886309573,24,310,539,2.6666666666666665
116,2,4,2,886309573,886309958,385,539,655,3.7857142857142856
116,4,3,-1,886309958,886977926,667968,655,350,3.2
116,3,3,0,886977926,886978067,141,350,311,3.761904761904762
116,3,5,2,886978067,886978155,88,311,313,4.323076923076923
116,5,3,-2,886978155,887605454,627299,313,1020,3.727272727272727
116,3,3,0,887605454,890131577,2526123,1020,751,3.3896103896103895
116,3,2,-1,890131577,890632956,501379,751,903,2.6666666666666665
116,2,3,1,890632956,890633075,119,903,303,3.75
116,3,3,0,890633075,892683732,2050657,303,301,3.2465753424657535
116,3,5,2,892683732,892683820,88,301,344,4.0
116,5,3,-2,892683820,892683858,38,344,20,3.375
73,5,5,0,888625042,888625292,250,64,173,4.1441441441441444
73,5,5,0,888625292,888625343,51,173,154,3.6031746031746033
73,5,5,0,888625343,888625422,79,154,657,4.341463414634147
73,5,5,0,888625422,888625553,131,657,188,3.625
73,5,1,-4,888625553,888625592,39,188,894,2.0
73,1,5,4,888625592,888625685,93,894,89,3.9615384615384617
73,5,4,-1,888625685,888625753,68,89,480,4.283018867924528
73,4,3,-1,888625753,888625754,1,480,206,3.0
73,3,5,2,888625754,888625785,31,206,175,3.8354430379746836
73,5,5,0,888625785,888625835,50,175,518,3.5833333333333335
73,5,3,-2,888625835,888625857,22,518,507,3.6285714285714286
73,3,4,1,888625857,888625956,99,507,7,3.76056338028169
73,4,5,1,888625956,888625980,24,7,59,4.0
73,5,5,0,888625980,888626007,27,59,357,4.063291139240507
73,5,4,-1,888626007,888626120,113,357,100,4.0162162162162165
73,4,4,0,888626120,888626153,33,100,514,4.033333333333333
73,4,4,0,888626153,888626177,24,514,196,3.9404761904761907
73,4,5,1,888626177,888626199,22,196,171,4.090909090909091
73,5,4,-1,888626199,888626220,21,171,32,3.7222222222222223
73,4,4,0,888626220,888626299,79,32,1149,3.857142857142857
73,4,5,1,888626299,888626371,72,1149,135,3.7974683544303796
73,5,5,0,888626371,888626415,44,135,81,3.2857142857142856
73,5,4,-1,888626415,888626437,22,81,433,3.8035714285714284
73,4,3,-1,888626437,888626468,31,433,28,3.923076923076923
73,3,3,0,888626468,888626496,28,28,152,3.6785714285714284
73,3,2,-1,888626496,888626523,27,152,96,3.9130434782608696
73,2,2,0,888626523,888626577,54,96,202,3.730337078651685
73,2,4,2,888626577,888792192,165615,202,286,3.442857142857143
73,4,4,0,888792192,888792247,55,286,272,4.2
73,4,2,-2,888792247,888792410,163,272,289,2.988888888888889
73,2,2,0,888792410,888792535,125,289,683,2.176470588235294
73,2,2,0,888792535,888792938,403,683,255,3.2027027027027026
221,4,4,0,875243990,875244087,97,259,181,3.98974358974359
221,4,4,0,875244087,875244125,38,181,50,4.306532663316583
221,4,4,0,875244125,875244160,35,50,508,3.6923076923076925
221,4,5,1,875244160,875244183,23,508,273,3.5238095238095237
221,5,4,-1,875244183,875244204,21,273,7,3.76056338028169
221,4,3,-1,875244204,875244232,28,7,222,3.578125
221,3,4,1,875244232,875244268,36,222,1017,3.0
221,4,4,0,875244268,875244289,21,1017,1134,2.888888888888889
221,4,4,0,875244289,875244352,63,1134,240,3.0350877192982457
221,4,2,-2,875244352,875244369,17,240,109,3.282608695652174
221,2,3,1,875244369,875244387,18,109,1067,3.533333333333333
221,3,5,2,875244387,875244457,70,1067,246,4.0
221,5,4,-1,875244457,875244475,18,246,1012,3.2916666666666665
221,4,4,0,875244475,875244512,37,1012,544,3.185185185185185
221,4,5,1,875244512,875244557,45,544,150,3.803921568627451
221,5,4,-1,875244557,875244558,1,150,282,3.610526315789474
221,4,4,0,875244558,875244598,40,282,762,3.3962264150943398
221,4,3,-1,875244598,875244633,35,762,405,3.25
221,3,3,0,875244633,875244694,61,405,824,2.590909090909091
221,3,3,0,875244694,875244713,19,824,1016,3.559322033898305
221,3,3,0,875244713,875244766,53,1016,685,3.2666666666666666
221,3,4,1,875244766,875244792,26,685,1011,3.1
221,4,2,-2,875244792,875244813,21,1011,121,3.521212121212121
221,2,3,1,875244813,875244866,53,121,108,3.107142857142857
221,3,4,1,875244866,875244901,35,108,3,3.0625
221,4,4,0,875244901,875245077,176,3,1059,2.764705882352941
221,4,2,-2,875245077,875245100,23,1059,407,2.611111111111111
221,2,2,0,875245100,875245167,67,407,423,3.7016129032258065
221,2,4,2,875245167,875245223,56,423,32,3.7222222222222223
221,4,2,-2,875245223,875245265,42,32,485,3.717948717948718
221,2,4,2,875245265,875245319,54,485,55,4.051282051282051
221,4,5,1,875245319,875245350,31,55,64,4.373737373737374
221,5,3,-2,875245350,875245374,24,64,470,3.72
221,3,4,1,875245374,875245406,32,470,17,3.032258064516129
221,4,4,0,875245406,875245462,56,17,23,3.9047619047619047
221,4,3,-1,875245462,875245481,19,23,469,3.6842105263157894
221,3,4,1,875245481,875245514,33,469,174,4.253521126760563
221,4,5,1,875245514,875245533,19,174,156,4.017857142857143
221,5,4,-1,875245533,875245574,41,156,461,3.3333333333333335
221,4,5,1,875245574,875245592,18,461,56,4.051724137931035
221,5,3,-2,875245592,875245618,26,56,623,3.0454545454545454
221,3,4,1,875245618,875245641,23,623,186,3.905263157894737
221,4,5,1,875245641,875245672,31,186,96,3.9130434782608696
221,5,5,0,875245672,875245690,18,96,318,4.5046728971962615
221,5,4,-1,875245690,875245715,25,318,79,3.956989247311828
221,4,4,0,875245715,875245739,24,79,789,3.7777777777777777
221,4,5,1,875245739,875245760,21,789,210,3.921259842519685
221,5,4,-1,875245760,875245776,16,210,695,3.0
221,4,4,0,875245776,875245798,22,695,39,3.107142857142857
221,4,5,1,875245798,875245813,15,39,42,3.893617021276596
221,5,3,-2,875245813,875245870,57,42,70,3.5833333333333335
221,3,5,2,875245870,875245907,37,70,172,4.225225225225225
221,5,4,-1,875245907,875245989,82,172,178,4.378378378378378
221,4,4,0,875245989,875246008,19,178,204,3.6744186046511627
221,4,3,-1,875246008,875246124,116,204,1035,3.03125
221,3,4,1,875246124,875246183,59,1035,550,3.272727272727273
221,4,3,-1,875246183,875246209,26,550,588,3.8358208955223883
221,3,3,0,875246209,875246247,38,588,265,3.710144927536232
221,3,4,1,875246247,875246308,61,265,218,3.5555555555555554
221,4,4,0,875246308,875246359,51,218,231,2.938775510204082
221,4,4,0,875246359,875246398,39,231,568,3.5853658536585367
221,4,3,-1,875246398,875246459,61,568,1267,2.909090909090909
221,3,4,1,875246459,875246482,23,1267,940,2.4
221,4,3,-1,875246482,875246506,24,940,230,3.3518518518518516
221,3,3,0,875246506,875246552,46,230,780,3.08
221,3,4,1,875246552,875246632,80,780,33,3.2941176470588234
221,4,3,-1,875246632,875246662,30,33,1010,3.611111111111111
221,3,3,0,875246662,875246710,48,1010,1185,2.111111111111111
221,3,3,0,875246710,875246745,35,1185,1218,3.2
221,3,3,0,875246745,875246783,38,1218,1090,2.3529411764705883
221,3,3,0,875246783,875246824,41,1090,576,3.125
221,3,3,0,875246824,875246857,33,576,94,2.8823529411764706
221,3,3,0,875246857,875246919,62,94,384,2.7941176470588234
221,3,5,2,875246919,875246944,25,384,721,3.4583333333333335
221,5,4,-1,875246944,875247023,79,721,578,3.066666666666667
221,4,4,0,875247023,875247421,398,578,1217,3.4166666666666665
221,4,4,0,875247421,875247454,33,1217,684,3.847826086956522
221,4,3,-1,875247454,875247522,68,684,227,3.169811320754717
221,3,3,0,875247522,875247565,43,227,1208,2.6666666666666665
221,3,3,0,875247565,875247833,268,1208,1407,2.375
221,3,2,-1,875247833,875247855,22,1407,1250,1.6
221,2,5,3,875247855,885081300,9833445,1250,346,3.5128205128205128
235,2,4,2,889654460,889654483,23,1105,346,3.5128205128205128
235,4,4,0,889654483,889654530,47,346,269,4.085106382978723
235,4,3,-1,889654530,889654553,23,269,898,3.0869565217391304
235,3,3,0,889654553,889654594,41,898,327,3.5076923076923077
235,3,3,0,889654594,889654638,44,327,292,3.6666666666666665
235,3,1,-2,889654638,889654821,183,292,338,2.75
235,1,4,3,889654821,889654971,150,338,175,3.8354430379746836
235,4,3,-1,889654971,889655044,73,175,198,4.04
235,3,4,1,889655044,889655045,1,198,647,4.142857142857143
235,4,4,0,889655045,889655086,41,647,515,4.202898550724638
235,4,4,0,889655086,889655162,76,515,87,3.9
235,4,5,1,889655162,889655204,42,87,193,3.883720930232558
235,5,2,-3,889655204,889655266,62,193,66,3.4705882352941178
235,2,4,2,889655266,889655298,32,66,192,4.090909090909091
235,4,3,-1,889655298,889655360,62,192,181,3.98974358974359
235,3,2,-1,889655360,889655403,43,181,82,3.6741573033707864
235,2,5,3,889655403,889655434,31,82,435,3.8933333333333335
235,5,4,-1,889655434,889655435,1,435,185,3.9726027397260273
235,4,4,0,889655435,889655468,33,185,69,3.8015873015873014
235,4,2,-2,889655468,889655490,22,69,431,3.422222222222222
235,2,5,3,889655490,889655550,60,431,275,4.087912087912088
235,5,4,-1,889655550,889655571,21,275,135,3.7974683544303796
235,4,5,1,889655571,889655619,48,135,70,3.5833333333333335
235,5,4,-1,889655619,889655662,43,70,648,3.9545454545454546
235,4,4,0,889655662,889655723,61,648,1134,2.888888888888889
235,4,5,1,889655723,889655820,97,1134,1176,4.0
235,5,5,0,889655820,889655858,38,1176,419,3.8208955223880596
235,5,4,-1,889655858,889656007,149,419,190,4.233333333333333
235,4,4,0,889656007,889656008,1,190,463,3.6818181818181817
235,4,5,1,889656008,889656028,20,463,179,3.8823529411764706
235,5,5,0,889656028,889656044,16,179,512,3.888888888888889
235,5,5,0,889656044,889656090,46,512,1021,3.8666666666666667
235,5,4,-1,889656090,889656113,23,1021,170,4.242424242424242
235,4,4,0,889656113,889656132,19,170,923,4.142857142857143
164,5,4,-1,889401221,889401241,20,300,690,3.260869565217391
164,4,4,0,889401241,889401263,22,690,751,3.3896103896103895
164,4,5,1,889401263,889401284,21,751,307,3.6031746031746033
164,5,4,-1,889401284,889401318,34,307,323,3.0
164,4,5,1,889401318,889401410,92,323,748,3.1043478260869564
164,5,4,-1,889401410,889401456,46,748,984,2.6666666666666665
164,4,5,1,889401456,889401490,34,984,689,3.1538461538461537
164,5,4,-1,889401490,889401510,20,689,1025,2.95
164,4,2,-2,889401510,889401691,181,1025,342,2.64
164,2,3,1,889401691,889401771,80,342,276,3.6036036036036037
164,3,2,-1,889401771,889401816,45,276,237,3.7315436241610738
164,2,5,3,889401816,889401852,36,237,118,3.2764227642276422
164,5,4,-1,889401852,889401927,75,118,222,3.578125
164,4,5,1,889401927,889401963,36,222,291,3.2
164,5,5,0,889401963,889401981,18,291,742,3.5555555555555554
164,5,4,-1,889401981,889402030,49,742,248,3.746268656716418
164,4,4,0,889402030,889402050,20,248,458,3.0588235294117645
164,4,3,-1,889402050,889402071,21,458,845,3.661290322580645
164,3,3,0,889402071,889402091,20,845,1016,3.559322033898305
164,3,5,2,889402091,889402121,30,1016,866,3.3962264150943398
164,5,4,-1,889402121,889402160,39,866,619,3.4782608695652173
164,4,4,0,889402160,889402203,43,619,825,2.914285714285714
164,4,5,1,889402203,889402245,42,825,471,3.5714285714285716
164,5,3,-2,889402245,889402265,20,471,717,2.9696969696969697
164,3,3,0,889402265,889402298,33,717,620,3.0
164,3,4,1,889402298,889402340,42,620,826,2.5555555555555554
164,4,2,-2,889402340,889402389,49,826,406,2.5294117647058822
164,2,2,0,889402389,889402443,54,406,407,2.611111111111111
164,2,5,3,889402443,889402547,104,407,934,3.0294117647058822
281,1,2,1,881200297,881200457,160,308,338,2.75
281,2,3,1,881200457,881200491,34,338,331,3.5517241379310347
281,3,3,0,881200491,881200519,28,331,682,3.0476190476190474
281,3,4,1,881200519,881200603,84,682,332,3.6511627906976742
281,4,3,-1,881200603,881200704,101,332,289,2.988888888888889
281,3,5,2,881200704,881200745,41,289,304,3.5306122448979593
281,5,1,-4,881200745,881200789,44,304,342,2.64
182,5,3,-2,876435435,885613067,9177632,69,237,3.7315436241610738
182,3,3,0,885613067,885613117,50,237,121,3.521212121212121
182,3,3,0,885613117,885613152,35,121,293,3.630434782608696
182,3,3,0,885613152,885613180,28,293,222,3.578125
182,3,4,1,885613180,885613216,36,222,471,3.5714285714285716
129,3,4,1,883244011,883244059,48,303,1176,4.0
129,4,3,-1,883244059,883244707,648,1176,304,3.5306122448979593
129,3,2,-1,883244707,883244737,30,304,339,2.7058823529411766
129,2,2,0,883244737,883245311,574,339,903,2.6666666666666665
129,2,2,0,883245311,883245452,141,903,258,3.7547169811320753
45,3,4,1,881014015,881014070,55,596,225,3.0714285714285716
45,4,4,0,881014070,881014130,60,225,284,3.1547619047619047
45,4,3,-1,881014130,881014193,63,284,21,2.9210526315789473
45,3,4,1,881014193,881014247,54,21,952,3.3529411764705883
45,4,3,-1,881014247,881014550,303,952,24,3.3728813559322033
45,3,4,1,881014550,881014620,70,24,108,3.107142857142857
45,4,3,-1,881014620,881014785,165,108,1001,2.6666666666666665
45,3,4,1,881014785,881015310,525,1001,764,3.1176470588235294
45,4,3,-1,881015310,881015386,76,764,826,2.5555555555555554
45,3,3,0,881015386,881015729,343,826,476,3.1216216216216215
45,3,2,-1,881015729,881016056,327,476,1061,2.9166666666666665
131,5,4,-1,883681313,883681351,38,124,287,3.4516129032258065
131,4,4,0,883681351,883681384,33,287,744,3.5714285714285716
131,4,4,0,883681384,883681418,34,744,127,4.162790697674419
131,4,3,-1,883681418,883681442,24,127,293,3.630434782608696
131,3,3,0,883681442,883681466,24,293,813,4.055555555555555
131,3,4,1,883681466,883681514,48,813,126,3.8620689655172415
131,4,3,-1,883681514,883681561,47,126,221,3.6923076923076925
131,3,5,2,883681561,883681723,162,221,276,3.6036036036036037
230,3,4,1,880484320,880484338,18,140,69,3.8015873015873014
230,4,5,1,880484338,880484370,32,69,1,3.902439024390244
230,5,5,0,880484370,880484391,21,1,98,4.240875912408759
230,5,5,0,880484391,880484415,24,98,223,4.108695652173913
230,5,5,0,880484415,880484416,1,223,64,4.373737373737374
230,5,5,0,880484416,880484444,28,64,28,3.923076923076923
230,5,5,0,880484444,880484475,31,28,132,3.929411764705882
230,5,3,-2,880484475,880484476,1,132,205,3.717391304347826
230,3,5,2,880484476,880484501,25,205,496,4.094594594594595
230,5,4,-1,880484501,880484523,22,496,172,4.225225225225225
230,4,5,1,880484523,880484544,21,172,265,3.710144927536232
230,5,5,0,880484544,880484567,23,265,515,4.202898550724638
230,5,4,-1,880484567,880484587,20,515,419,3.8208955223880596
230,4,4,0,880484587,880484616,29,419,204,3.6744186046511627
230,4,4,0,880484616,880484637,21,204,70,3.5833333333333335
230,4,5,1,880484637,880484661,24,70,627,3.3823529411764706
230,5,2,-3,880484661,880484683,22,627,96,3.9130434782608696
230,2,5,3,880484683,880484755,72,96,50,4.306532663316583
230,5,4,-1,880484755,880484756,1,50,234,3.7674418604651163
230,4,5,1,880484756,880484778,22,234,79,3.956989247311828
230,5,5,0,880484778,880484825,47,79,423,3.7016129032258065
230,5,3,-2,880484825,880484850,25,423,144,3.9545454545454546
230,3,4,1,880484850,880484870,20,144,499,4.0
230,4,5,1,880484870,880484937,67,499,418,3.825
230,5,5,0,880484937,880484975,38,418,210,3.921259842519685
230,5,3,-2,880484975,880485043,68,210,91,3.6
230,3,4,1,880485043,880485066,23,91,181,3.98974358974359
230,4,4,0,880485066,880485110,44,181,432,3.719298245614035
230,4,3,-1,880485110,880485136,26,432,1050,3.6153846153846154
230,3,5,2,880485136,880485159,23,1050,378,3.6904761904761907
230,5,5,0,880485159,880485181,22,378,951,2.6666666666666665
230,5,3,-2,880485181,880485197,16,951,138,2.6
230,3,2,-1,880485197,880485216,19,138,135,3.7974683544303796
230,2,1,-1,880485216,880485235,19,135,385,3.6129032258064515
230,1,3,2,880485235,880485254,19,385,431,3.422222222222222
230,3,1,-2,880485254,880485283,29,431,209,3.8275862068965516
230,1,3,2,880485283,880485311,28,209,609,3.7058823529411766
230,3,4,1,880485311,880485330,19,609,371,3.0
230,4,4,0,880485330,880485352,22,371,1192,3.0
230,4,4,0,880485352,880485380,28,1192,582,3.7457627118644066
230,4,4,0,880485380,880485402,22,582,451,3.207792207792208
230,4,3,-1,880485402,880485421,19,451,628,3.573529411764706
230,3,4,1,880485421,880485445,24,628,176,3.967032967032967
230,4,5,1,880485445,880485468,23,176,161,3.5844155844155843
230,5,3,-2,880485468,880485489,21,161,926,2.7857142857142856
230,3,3,0,880485489,880485530,41,926,10,3.85
230,3,5,2,880485530,880485573,43,10,276,3.6036036036036037
230,5,2,-3,880485573,880485594,21,276,693,3.6285714285714286
230,2,5,3,880485594,880485611,17,693,739,3.391304347826087
230,5,4,-1,880485611,880485634,23,739,405,3.25
230,4,2,-2,880485634,880485656,22,405,511,4.096153846153846
230,2,4,2,880485656,880485689,33,511,570,3.526315789473684
230,4,4,0,880485689,880485856,167,570,100,4.0162162162162165
126,4,2,-2,887853568,887853919,351,751,326,3.262295081967213
126,2,5,3,887853919,887854726,807,326,313,4.323076923076923
126,5,3,-2,887854726,887854777,51,313,322,3.0476190476190474
126,3,3,0,887854777,887854825,48,322,303,3.75
126,3,2,-1,887854825,887854892,67,303,350,3.2
126,2,4,2,887854892,887854943,51,350,300,3.6861313868613137
126,4,5,1,887854943,887854982,39,300,340,3.7419354838709675
126,5,1,-4,887854982,887855034,52,340,682,3.0476190476190474
126,1,3,2,887855034,887855087,53,682,327,3.5076923076923077
126,3,1,-2,887855087,887855173,86,327,260,2.4716981132075473
126,1,3,2,887855173,887855174,1,260,289,2.988888888888889
126,3,4,1,887855174,887855231,57,289,316,4.285714285714286
126,4,2,-2,887855231,887855283,52,316,905,3.357142857142857
126,2,5,3,887855283,887855342,59,905,243,2.357142857142857
231,4,3,-1,879965704,879965760,56,15,255,3.2027027027027026
231,3,3,0,879965760,879966018,258,255,476,3.1216216216216215
231,3,3,0,879966018,879966146,128,476,597,3.2771084337349397
231,3,1,-2,879966146,879966209,63,597,151,3.6544117647058822
231,1,4,3,879966209,888605274,8639065,151,846,3.1052631578947367
280,3,2,-1,891699925,891699964,39,751,690,3.260869565217391
280,2,2,0,891699964,891700021,57,690,294,3.1052631578947367
280,2,2,0,891700021,891700080,59,294,748,3.1043478260869564
280,2,2,0,891700080,891700106,26,748,323,3.0
280,2,2,0,891700106,891700124,18,323,678,2.8181818181818183
280,2,5,3,891700124,891700184,60,678,316,4.285714285714286
280,5,5,0,891700184,891700185,1,316,324,3.2291666666666665
280,5,5,0,891700185,891700208,23,324,98,4.240875912408759
280,5,4,-1,891700208,891700242,34,98,69,3.8015873015873014
280,4,5,1,891700242,891700257,15,69,13,3.5454545454545454
280,5,3,-2,891700257,891700276,19,13,182,3.842857142857143
280,3,3,0,891700276,891700303,27,182,195,3.9072164948453607
280,3,5,2,891700303,891700321,18,195,496,4.094594594594595
280,5,4,-1,891700321,891700366,45,496,70,3.5833333333333335
280,4,3,-1,891700366,891700400,34,70,655,3.7857142857142856
280,3,3,0,891700400,891700426,26,655,282,3.610526315789474
280,3,2,-1,891700426,891700475,49,282,735,3.58
280,2,2,0,891700475,891700496,21,735,1181,2.6
280,2,5,3,891700496,891700552,56,1181,22,4.215909090909091
280,5,3,-2,891700552,891700553,1,22,471,3.5714285714285716
280,3,5,2,891700553,891700570,17,471,95,3.8194444444444446
280,5,4,-1,891700570,891700588,18,95,265,3.710144927536232
280,4,3,-1,891700588,891700607,19,265,1063,3.642857142857143
280,3,3,0,891700607,891700624,17,1063,222,3.578125
280,3,3,0,891700624,891700643,19,222,204,3.6744186046511627
280,3,5,2,891700643,891700681,38,204,153,3.7865168539325844
280,5,3,-2,891700681,891700682,1,153,507,3.6285714285714286
280,3,2,-1,891700682,891700699,17,507,76,3.1875
280,2,3,1,891700699,891700715,16,76,73,3.588235294117647
280,3,3,0,891700715,891700733,18,73,157,3.5714285714285716
280,3,5,2,891700733,891700751,18,157,486,3.9565217391304346
280,5,3,-2,891700751,891700768,17,486,172,4.225225225225225
280,3,4,1,891700768,891700783,15,172,663,3.948717948717949
280,4,3,-1,891700783,891700803,20,663,234,3.7674418604651163
280,3,4,1,891700803,891700818,15,234,71,3.6575342465753424
280,4,2,-2,891700818,891700836,18,71,197,4.112676056338028
280,2,5,3,891700836,891700850,14,197,928,3.142857142857143
280,5,2,-3,891700850,891700925,75,928,82,3.6741573033707864
280,2,2,0,891700925,891700963,38,82,405,3.25
280,2,3,1,891700963,891700983,20,405,692,3.56
280,3,5,2,891700983,891701002,19,692,367,3.4242424242424243
280,5,4,-1,891701002,891701090,88,367,1478,2.7
280,4,5,1,891701090,891701114,24,1478,1099,3.7142857142857144
280,5,3,-2,891701114,891701148,34,1099,465,3.75
280,3,3,0,891701148,891701188,40,465,128,3.45
280,3,4,1,891701188,891701223,35,128,673,3.393939393939394
280,4,3,-1,891701223,891701248,25,673,181,3.98974358974359
280,3,3,0,891701248,891701278,30,181,1060,3.235294117647059
280,3,4,1,891701278,891701302,24,1060,544,3.185185185185185
280,4,5,1,891701302,891701328,26,544,392,3.5555555555555554
280,5,3,-2,891701328,891701344,16,392,239,3.423076923076923
280,3,3,0,891701344,891701359,15,239,739,3.391304347826087
280,3,5,2,891701359,891701377,18,739,451,3.207792207792208
280,5,3,-2,891701377,891701405,28,451,228,3.7246376811594204
280,3,3,0,891701405,891701431,26,228,162,3.4651162790697674
280,3,4,1,891701431,891701474,43,162,218,3.5555555555555554
280,4,3,-1,891701474,891701506,32,218,403,3.298507462686567
280,3,4,1,891701506,891701530,24,403,203,3.826923076923077
280,4,4,0,891701530,891701531,1,203,431,3.422222222222222
280,4,3,-1,891701531,891701556,25,431,88,3.433734939759036
280,3,3,0,891701556,891701583,27,88,559,3.477272727272727
280,3,3,0,891701583,891701614,31,559,728,3.05
280,3,5,2,891701614,891701649,35,728,235,3.106382978723404
280,5,3,-2,891701649,891701666,17,235,595,2.9166666666666665
280,3,4,1,891701666,891701685,19,595,764,3.1176470588235294
280,4,3,-1,891701685,891701723,38,764,215,3.662921348314607
280,3,2,-1,891701723,891701764,41,215,158,2.7027027027027026
280,2,3,1,891701764,891701765,1,158,448,3.466666666666667
280,3,4,1,891701765,891701785,20,448,1035,3.03125
280,4,4,0,891701785,891701816,31,1035,765,3.0
280,4,5,1,891701816,891701853,37,765,723,3.5384615384615383
280,5,4,-1,891701853,891701871,18,723,586,2.875
280,4,5,1,891701871,891701913,42,586,389,3.272727272727273
280,5,4,-1,891701913,891701928,15,389,1066,3.2
280,4,4,0,891701928,891701974,46,1066,225,3.0714285714285716
280,4,3,-1,891701974,891701997,23,225,866,3.3962264150943398
280,3,3,0,891701997,891701998,1,866,226,3.378787878787879
280,3,4,1,891701998,891702013,15,226,790,2.8518518518518516
280,4,4,0,891702013,891702028,15,790,468,3.380952380952381
280,4,3,-1,891702028,891702049,21,468,731,3.4
280,3,3,0,891702049,891702122,73,731,103,2.2
280,3,3,0,891702122,891702153,31,103,227,3.169811320754717
280,3,3,0,891702153,891702198,45,227,145,2.3636363636363638
280,3,3,0,891702198,891702199,1,145,542,2.888888888888889
280,3,3,0,891702199,891702214,15,542,1182,2.4285714285714284
280,3,4,1,891702214,891702252,38,1182,975,3.411764705882353
280,4,4,0,891702252,891702276,24,975,72,3.175438596491228
280,4,2,-2,891702276,891702291,15,72,934,3.0294117647058822
280,2,3,1,891702291,891702304,13,934,540,2.4615384615384617
280,3,4,1,891702304,891702323,19,540,393,3.5125
280,4,4,0,891702323,891702324,1,393,1112,2.9
280,4,3,-1,891702324,891702338,14,1112,571,2.5
280,3,2,-1,891702338,891702406,68,571,3,3.0625
280,2,2,0,891702406,891702422,16,3,575,2.619047619047619
280,2,3,1,891702422,891702441,19,575,585,2.5384615384615383
280,3,3,0,891702441,891702457,16,585,1479,3.5
280,3,2,-1,891702457,891702485,28,1479,670,2.9375
280,2,5,3,891702485,891702544,59,670,1217,3.4166666666666665
288,2,3,1,886372841,886372937,96,294,289,2.988888888888889
288,3,1,-2,886372937,886373007,70,289,327,3.5076923076923077
288,1,5,4,886373007,886373071,64,327,269,4.085106382978723
288,5,3,-2,886373071,886373474,403,269,173,4.1441441441441444
288,3,3,0,886373474,886373509,35,173,210,3.921259842519685
288,3,4,1,886373509,886373534,25,210,200,3.8157894736842106
288,4,2,-2,886373534,886373565,31,200,1039,3.9583333333333335
288,2,4,2,886373565,886373591,26,1039,515,4.202898550724638
288,4,4,0,886373591,886373619,28,515,157,3.5714285714285716
288,4,4,0,886373619,886374130,511,157,12,4.358974358974359
288,4,5,1,886374130,886374286,156,12,22,4.215909090909091
288,5,2,-3,886374286,886374316,30,22,214,3.272727272727273
288,2,5,3,886374316,886374342,26,214,178,4.378378378378378
288,5,5,0,886374342,886374365,23,178,64,4.373737373737374
288,5,4,-1,886374365,886374473,108,64,234,3.7674418604651163
288,4,4,0,886374473,886374520,47,234,50,4.306532663316583
288,4,4,0,886374520,886629592,255072,50,216,3.8454545454545452
288,4,1,-3,886629592,886629664,72,216,175,3.8354430379746836
288,1,5,4,886629664,886629749,85,175,100,4.0162162162162165
288,5,4,-1,886629749,886892177,262428,100,15,3.725663716814159
288,4,4,0,886892177,886892195,18,15,237,3.7315436241610738
288,4,5,1,886892195,886892241,46,237,13,3.5454545454545454
288,5,5,0,886892241,889225463,2333222,13,272,4.2
288,5,5,0,889225463,889225535,72,272,202,3.730337078651685
288,5,4,-1,889225535,889225633,98,202,435,3.8933333333333335
152,4,4,0,880148664,880148735,71,275,151,3.6544117647058822
152,4,5,1,880148735,880148782,47,151,111,3.5106382978723403
152,5,2,-3,880148782,880148941,159,111,596,3.180327868852459
152,2,3,1,880148941,880149045,104,596,25,3.3185840707964602
152,3,5,2,880149045,880149074,29,25,685,3.2666666666666666
152,5,5,0,880149074,880149165,91,685,125,3.5555555555555554
152,5,5,0,880149165,880149166,1,125,274,3.5609756097560976
152,5,4,-1,880149166,880149197,31,274,740,3.423076923076923
152,4,5,1,880149197,880149224,27,740,866,3.3962264150943398
152,5,3,-2,880149224,880149253,29,866,21,2.9210526315789473
152,3,4,1,880149253,880149350,97,21,411,2.911764705882353
152,4,2,-2,880149350,880149686,336,411,120,2.3421052631578947
152,2,5,3,880149686,880149882,196,120,215,3.662921348314607
152,5,5,0,880149882,880150075,193,215,660,3.71875
152,5,5,0,880150075,882474000,2323925,660,69,3.8015873015873014
152,5,5,0,882474000,882474435,435,69,483,4.475609756097561
152,5,4,-1,882474435,882474734,299,483,632,3.9523809523809526
152,4,5,1,882474734,882474845,111,632,133,3.7777777777777777
152,5,5,0,882474845,882474898,53,133,162,3.4651162790697674
152,5,4,-1,882474898,882474970,72,162,234,3.7674418604651163
152,4,5,1,882474970,882475618,648,234,1053,3.3846153846153846
152,5,3,-2,882475618,882475972,354,1053,367,3.4242424242424243
152,3,5,2,882475972,882476363,391,367,161,3.5844155844155843
152,5,4,-1,882476363,882476632,269,161,944,2.75
152,4,3,-1,882476632,882476683,51,944,778,3.5925925925925926
152,3,5,2,882476683,882477356,673,778,720,3.2
152,5,5,0,882477356,882477402,46,720,49,3.3
152,5,5,0,882477402,882477430,28,49,167,2.8181818181818183
152,5,5,0,882477430,882477572,142,167,80,2.967741935483871
152,5,4,-1,882477572,882477755,183,80,1035,3.03125
152,4,5,1,882477755,882829150,351395,1035,966,4.7
152,5,5,0,882829150,884018390,1189240,966,155,3.0588235294117645
152,5,5,0,884018390,884018430,40,155,393,3.5125
152,5,5,0,884018430,884018821,391,393,790,2.8518518518518516
152,5,3,-2,884018821,884018842,21,790,871,2.3823529411764706
152,3,3,0,884018842,884018905,63,871,401,2.6774193548387095
152,3,4,1,884018905,884018961,56,401,783,2.388888888888889
152,4,5,1,884018961,884019001,40,783,716,3.1904761904761907
152,5,4,-1,884019001,884019146,145,716,364,2.8095238095238093
152,4,5,1,884019146,884019189,43,364,780,3.08
152,5,5,0,884019189,884035964,16775,780,88,3.433734939759036
152,5,4,-1,884035964,886535827,2499863,88,1300,2.5
152,4,2,-2,886535827,890322385,3786558,1300,319,3.0408163265306123
217,4,1,-3,889069555,889069684,129,300,172,4.225225225225225
217,1,5,4,889069684,889069709,25,172,56,4.051724137931035
217,5,5,0,889069709,889069741,32,56,22,4.215909090909091
217,5,4,-1,889069741,889069782,41,22,568,3.5853658536585367
217,4,2,-2,889069782,889069808,26,568,808,2.4444444444444446
217,2,1,-1,889069808,889069842,34,808,550,3.272727272727273
217,1,4,3,889069842,889069878,36,550,233,3.323529411764706
217,4,3,-1,889069878,889069903,25,233,17,3.032258064516129
217,3,1,-2,889069903,889069944,41,17,121,3.521212121212121
217,1,3,2,889069944,889069974,30,121,541,2.9473684210526314
217,3,1,-2,889069974,889070011,37,541,27,3.235294117647059
217,1,2,1,889070011,889070050,39,27,1228,2.5
217,2,5,3,889070050,889070087,37,1228,578,3.066666666666667
217,5,2,-3,889070087,889070109,22,578,182,3.842857142857143
217,2,3,1,889070109,889070174,65,182,147,3.3142857142857145
217,3,2,-1,889070174,889070196,22,147,546,2.9789473684210526
217,2,3,1,889070196,889070211,15,546,562,3.2941176470588234
217,3,2,-1,889070211,889070232,21,562,827,2.4375
217,2,1,-1,889070232,889070266,34,827,779,2.2
217,1,4,3,889070266,889070287,21,779,391,2.4285714285714284
217,4,2,-2,889070287,889070307,20,391,373,3.142857142857143
79,4,4,0,891271180,891271203,23,340,303,3.75
79,4,4,0,891271203,891271245,42,303,900,4.2
79,4,4,0,891271245,891271278,33,900,319,3.0408163265306123
79,4,5,1,891271278,891271308,30,319,258,3.7547169811320753
79,5,4,-1,891271308,891271627,319,258,275,4.087912087912088
79,4,5,1,891271627,891271676,49,275,116,3.6666666666666665
79,5,2,-3,891271676,891271697,21,116,1161,3.4
79,2,5,3,891271697,891271719,22,1161,236,3.2666666666666666
79,5,5,0,891271719,891271741,22,236,763,3.347826086956522
79,5,5,0,891271741,891271806,65,763,582,3.7457627118644066
79,5,4,-1,891271806,891271870,64,582,1,3.902439024390244
79,4,4,0,891271870,891271957,87,1,222,3.578125
79,4,4,0,891271957,891271982,25,222,1008,3.5
79,4,3,-1,891271982,891272015,33,1008,288,3.5214285714285714
79,3,5,2,891272015,891272016,1,288,7,3.76056338028169
75,1,2,1,884049789,884049820,31,322,988,2.5555555555555554
75,2,5,3,884049820,884049875,55,988,25,3.3185840707964602
75,5,4,-1,884049875,884049876,1,25,864,3.2142857142857144
75,4,5,1,884049876,884049939,63,864,475,3.956043956043956
75,5,4,-1,884049939,884050046,107,475,408,4.4772727272727275
75,4,5,1,884050046,884050102,56,408,13,3.5454545454545454
75,5,3,-2,884050102,884050134,32,13,147,3.3142857142857145
75,3,3,0,884050134,884050194,60,147,845,3.661290322580645
75,3,2,-1,884050194,884050309,115,845,756,2.6885245901639343
75,2,1,-1,884050309,884050393,84,756,825,2.914285714285714
75,1,3,2,884050393,884050422,29,825,546,2.9789473684210526
75,3,4,1,884050422,884050450,28,546,121,3.521212121212121
75,4,1,-3,884050450,884050502,52,121,291,3.2
75,1,1,0,884050502,884050531,29,291,1001,2.6666666666666665
75,1,1,0,884050531,884050590,59,1001,742,3.5555555555555554
75,1,1,0,884050590,884050661,71,742,240,3.0350877192982457
75,1,4,3,884050661,884050705,44,240,1048,2.857142857142857
75,4,2,-2,884050705,884050733,28,1048,866,3.3962264150943398
75,2,3,1,884050733,884050760,27,866,118,3.2764227642276422
75,3,5,2,884050760,884050829,69,118,460,3.0
75,5,4,-1,884050829,884050979,150,460,696,3.138888888888889
75,4,1,-3,884050979,884051056,77,696,824,2.590909090909091
75,1,2,1,884051056,884051113,57,824,833,2.9444444444444446
75,2,2,0,884051113,884051610,497,833,304,3.5306122448979593
75,2,5,3,884051610,884051635,25,304,271,3.3134328358208953
75,5,5,0,884051635,884051921,286,271,496,4.094594594594595
75,5,5,0,884051921,884051948,27,496,190,4.233333333333333
245,4,3,-1,888513212,888513279,67,222,151,3.6544117647058822
245,3,4,1,888513279,888513326,47,151,597,3.2771084337349397
245,4,2,-2,888513326,888513344,18,597,473,2.9166666666666665
245,2,4,2,888513344,888513361,17,473,596,3.180327868852459
245,4,3,-1,888513361,888513393,32,596,1047,2.6923076923076925
245,3,5,2,888513393,888513447,54,1047,1028,2.857142857142857
245,5,5,0,888513447,888513522,75,1028,1033,3.0
245,5,4,-1,888513522,888513575,53,1033,112,2.7
245,4,4,0,888513575,888513664,89,112,50,4.306532663316583
245,4,4,0,888513664,888513691,27,50,258,3.7547169811320753
245,4,1,-3,888513691,888513860,169,258,894,2.0
282,4,4,0,879949394,879949438,44,319,268,3.9838709677419355
282,4,3,-1,879949438,879949468,30,268,338,2.75
282,3,2,-1,879949468,879949504,36,338,879,3.2291666666666665
282,2,4,2,879949504,879949525,21,879,294,3.1052631578947367
282,4,3,-1,879949525,879949594,69,294,358,2.6551724137931036
282,3,3,0,879949594,881702919,1753325,358,271,3.3134328358208953
282,3,4,1,881702919,881702939,20,271,343,3.0
282,4,2,-2,881702939,881703044,105,343,689,3.1538461538461537
78,3,1,-2,879633495,879633567,72,294,323,3.0
78,1,3,2,879633567,879633702,135,323,298,3.779220779220779
78,3,4,1,879633702,879633745,43,298,255,3.2027027027027026
78,4,4,0,879633745,879633766,21,255,93,3.5641025641025643
78,4,3,-1,879633766,879633767,1,93,476,3.1216216216216215
78,3,3,0,879633767,879633785,18,476,25,3.3185840707964602
78,3,3,0,879633785,879634199,414,25,871,2.3823529411764706
78,3,4,1,879634199,879634223,24,871,412,2.272727272727273
78,4,5,1,879634223,879634264,41,412,237,3.7315436241610738
118,4,5,1,875384514,875384612,98,528,179,3.8823529411764706
118,5,5,0,875384612,875384647,35,179,200,3.8157894736842106
118,5,5,0,875384647,875384751,104,200,100,4.0162162162162165
118,5,5,0,875384751,875384885,134,100,511,4.096153846153846
118,5,4,-1,875384885,875384916,31,511,603,4.315789473684211
118,4,5,1,875384916,875384946,30,603,156,4.017857142857143
118,5,5,0,875384946,875384979,33,156,23,3.9047619047619047
118,5,5,0,875384979,875385007,28,23,654,4.119047619047619
118,5,5,0,875385007,875385099,92,654,55,4.051282051282051
118,5,5,0,875385099,875385136,37,55,960,3.0
118,5,5,0,875385136,875385198,62,960,774,3.0
118,5,5,0,875385198,875385228,30,774,558,3.75
118,5,2,-3,875385228,875385256,28,558,5,3.1481481481481484
118,2,5,3,875385256,875385280,24,5,53,2.9523809523809526
118,5,4,-1,875385280,875385306,26,53,413,2.5652173913043477
118,4,5,1,875385306,875385386,80,413,675,3.625
118,5,4,-1,875385386,875385442,56,675,1079,2.1923076923076925
283,4,5,1,879297318,879297347,29,151,125,3.5555555555555554
283,5,4,-1,879297347,879297442,95,125,409,2.9615384615384617
283,4,4,0,879297442,879297526,84,409,1079,2.1923076923076925
283,4,5,1,879297526,879297545,19,1079,1114,3.2
283,5,3,-2,879297545,879297867,322,1114,407,2.611111111111111
283,3,4,1,879297867,879297904,37,407,820,3.0444444444444443
283,4,5,1,879297904,879297965,61,820,95,3.8194444444444446
283,5,4,-1,879297965,879297966,1,95,627,3.3823529411764706
283,4,5,1,879297966,879298239,273,627,186,3.905263157894737
283,5,4,-1,879298239,879298270,31,186,175,3.8354430379746836
283,4,4,0,879298270,879298333,63,175,433,3.8035714285714284
171,4,4,0,891034641,891034684,43,262,268,3.9838709677419355
171,4,2,-2,891034684,891034801,117,268,326,3.262295081967213
107,4,4,0,891264296,891264327,31,302,305,3.5789473684210527
107,4,4,0,891264327,891264387,60,305,268,3.9838709677419355
107,4,2,-2,891264387,891264432,45,268,321,3.0172413793103448
107,2,5,3,891264432,891264501,69,321,902,3.9444444444444446
107,5,1,-4,891264501,891264535,34,902,322,3.0476190476190474
107,1,3,2,891264535,891264598,63,322,264,2.65
107,3,3,0,891264598,891264659,61,264,325,2.625
226,4,5,1,883888639,883888853,214,270,408,4.4772727272727275
226,5,5,0,883888853,883888892,39,408,169,4.548387096774194
226,5,4,-1,883888892,883888978,86,169,176,3.967032967032967
226,4,3,-1,883888978,883889012,34,176,652,3.9642857142857144
226,3,4,1,883889012,883889102,90,652,56,4.051724137931035
226,4,3,-1,883889102,883889146,44,56,209,3.8275862068965516
226,3,5,2,883889146,883889147,1,209,98,4.240875912408759
226,5,5,0,883889147,883889229,82,98,89,3.9615384615384617
226,5,3,-2,883889229,883889256,27,89,513,4.526315789473684
226,3,5,2,883889256,883889322,66,513,12,4.358974358974359
226,5,3,-2,883889322,883889355,33,12,23,3.9047619047619047
226,3,4,1,883889355,883889430,75,23,69,3.8015873015873014
226,4,4,0,883889430,883889479,49,69,24,3.3728813559322033
226,4,4,0,883889479,883889507,28,24,405,3.25
226,4,4,0,883889507,883889690,183,405,224,3.4545454545454546
226,4,3,-1,883889690,883889764,74,224,275,4.087912087912088
226,3,2,-1,883889764,883889811,47,275,283,3.901639344262295
226,2,3,1,883889811,883889884,73,283,596,3.180327868852459
226,3,4,1,883889884,883889984,100,596,508,3.6923076923076925
306,4,5,1,876503793,876504026,233,286,116,3.6666666666666665
306,5,4,-1,876504026,876504054,28,116,744,3.5714285714285716
306,4,4,0,876504054,876504442,388,744,111,3.5106382978723403
306,4,3,-1,876504442,876504472,30,111,756,2.6885245901639343
306,3,2,-1,876504472,876504581,109,756,1028,2.857142857142857
306,2,4,2,876504581,876504614,33,1028,1514,3.6666666666666665
173,5,4,-1,877556626,877556926,300,305,874,3.230769230769231
173,4,4,0,877556926,877557028,102,874,332,3.6511627906976742
173,4,5,1,877557028,877557076,48,332,879,3.2291666666666665
173,5,4,-1,877557076,877557077,1,879,937,3.5
173,4,1,-3,877557077,877557132,55,937,687,2.1481481481481484
173,1,5,4,877557132,877557168,36,687,327,3.5076923076923077
173,5,3,-2,877557168,877557239,71,327,259,2.492063492063492
173,3,4,1,877557239,877557345,106,259,329,3.25
173,4,5,1,877557345,877557369,24,329,292,3.6666666666666665
185,3,4,1,883524206,883524249,43,239,23,3.9047619047619047
185,4,4,0,883524249,883524320,71,23,275,4.087912087912088
185,4,4,0,883524320,883524364,44,275,638,3.923076923076923
185,4,4,0,883524364,883524396,32,638,9,3.8878504672897196
185,4,5,1,883524396,883524428,32,9,423,3.7016129032258065
185,5,4,-1,883524428,883524475,47,423,181,3.98974358974359
185,4,5,1,883524475,883524507,32,181,285,4.181818181818182
185,5,4,-1,883524507,883524529,22,285,111,3.5106382978723403
185,4,3,-1,883524529,883525255,726,111,15,3.725663716814159
150,4,5,1,878746225,878746257,32,324,268,3.9838709677419355
150,5,2,-3,878746257,878746636,379,268,100,4.0162162162162165
150,2,4,2,878746636,878746720,84,100,458,3.0588235294117645
150,4,3,-1,878746720,878746824,104,458,150,3.803921568627451
150,3,4,1,878746824,878746852,28,150,123,3.297872340425532
150,4,4,0,878746852,878746889,37,123,13,3.5454545454545454
150,4,5,1,878746889,878746982,93,13,276,3.6036036036036037
150,5,4,-1,878746982,878747017,35,276,221,3.6923076923076925
150,4,4,0,878747017,878747018,1,221,628,3.573529411764706
150,4,4,0,878747018,878747090,72,628,410,3.0434782608695654
274,5,5,0,878944406,878944464,58,748,300,3.6861313868613137
274,5,3,-2,878944464,878944491,27,300,873,2.7586206896551726
274,3,3,0,878944491,878944543,52,873,877,2.619047619047619
274,3,5,2,878944543,878944679,136,877,50,4.306532663316583
274,5,5,0,878944679,878945365,686,50,181,3.98974358974359
274,5,3,-2,878945365,878945404,39,181,596,3.180327868852459
274,3,5,2,878945404,878945437,33,596,713,3.5
274,5,4,-1,878945437,878945466,29,713,1,3.902439024390244
274,4,4,0,878945466,878945541,75,1,111,3.5106382978723403
274,4,5,1,878945541,878945542,1,111,685,3.2666666666666666
274,5,5,0,878945542,878945579,37,685,845,3.661290322580645
274,5,5,0,878945579,878945610,31,845,762,3.3962264150943398
274,5,4,-1,878945610,878945645,35,762,476,3.1216216216216215
274,4,4,0,878945645,878945678,33,476,237,3.7315436241610738
274,4,4,0,878945678,878945711,33,237,125,3.5555555555555554
274,4,4,0,878945711,878945763,52,125,1051,3.625
274,4,4,0,878945763,878945818,55,1051,277,3.6
274,4,4,0,878945818,878945840,22,277,405,3.25
274,4,3,-1,878945840,878945888,48,405,411,2.911764705882353
274,3,3,0,878945888,878945918,30,411,472,2.984375
274,3,4,1,878945918,878945939,21,472,1152,3.4375
274,4,4,0,878945939,878945963,24,1152,274,3.5609756097560976
274,4,3,-1,878945963,878946030,67,274,756,2.6885245901639343
274,3,4,1,878946030,878946107,77,756,866,3.3962264150943398
274,4,3,-1,878946107,878946133,26,866,597,3.2771084337349397
274,3,2,-1,878946133,878946162,29,597,1163,2.1666666666666665
274,2,2,0,878946162,878946204,42,1163,846,3.1052631578947367
274,2,5,3,878946204,878946536,332,846,234,3.7674418604651163
274,5,5,0,878946536,878946577,41,234,478,4.161290322580645
274,5,4,-1,878946577,878946612,35,478,200,3.8157894736842106
274,4,5,1,878946612,878946644,32,200,164,3.6140350877192984
274,5,5,0,878946644,878946645,1,164,629,3.3333333333333335
274,5,4,-1,878946645,878946677,32,629,88,3.433734939759036
188,3,2,-1,875071293,875071361,68,326,877,2.619047619047619
188,2,3,1,875071361,875071443,82,877,259,2.492063492063492
188,3,5,2,875071443,875071581,138,259,632,3.9523809523809526
188,5,4,-1,875071581,875071658,77,632,199,4.191489361702128
188,4,3,-1,875071658,875071710,52,199,205,3.717391304347826
188,3,4,1,875071710,875071775,65,205,553,3.5
188,4,4,0,875071775,875072009,234,553,69,3.8015873015873014
188,4,4,0,875072009,875072087,78,69,764,3.1176470588235294
188,4,2,-2,875072087,875072148,61,764,864,3.2142857142857144
188,2,3,1,875072148,875072211,63,864,187,4.215189873417722
188,3,4,1,875072211,875072328,117,187,77,3.3857142857142857
188,4,5,1,875072328,875072393,65,77,79,3.956989247311828
188,5,5,0,875072393,875072459,66,79,22,4.215909090909091
188,5,5,0,875072459,875072518,59,22,318,4.5046728971962615
188,5,5,0,875072518,875072583,65,318,692,3.56
188,5,4,-1,875072583,875072674,91,692,474,4.172413793103448
188,4,4,0,875072674,875072741,67,474,50,4.306532663316583
188,4,1,-3,875072741,875072799,58,50,240,3.0350877192982457
188,1,4,3,875072799,875072876,77,240,176,3.967032967032967
188,4,3,-1,875072876,875072972,96,176,28,3.923076923076923
188,3,3,0,875072972,875073048,76,28,161,3.5844155844155843
188,3,3,0,875073048,875073128,80,161,191,4.168674698795181
188,3,3,0,875073128,875073179,51,191,195,3.9072164948453607
188,3,4,1,875073179,875073246,67,195,462,3.7954545454545454
188,4,5,1,875073246,875073477,231,462,7,3.76056338028169
188,5,5,0,875073477,875073647,170,7,470,3.72
188,5,2,-3,875073647,875073712,65,470,202,3.730337078651685
188,2,5,3,875073712,875073909,197,202,742,3.5555555555555554
188,5,5,0,875073909,875074200,291,742,628,3.573529411764706
188,5,3,-2,875074200,875074266,66,628,233,3.323529411764706
188,3,4,1,875074266,875074329,63,233,443,3.8421052631578947
188,4,4,0,875074329,875074667,338,443,148,3.2131147540983607
188,4,3,-1,875074667,875074772,105,148,281,3.2
188,3,2,-1,875074772,875074847,75,281,1213,2.0
188,2,5,3,875074847,875075062,215,1213,153,3.7865168539325844
188,5,3,-2,875075062,875075118,56,153,66,3.4705882352941178
188,3,5,2,875075118,875075300,182,66,216,3.8454545454545452
48,3,3,0,879434132,879434181,49,309,323,3.0
48,3,4,1,879434181,879434211,30,323,690,3.260869565217391
48,4,3,-1,879434211,879434212,1,690,294,3.1052631578947367
48,3,1,-2,879434212,879434252,40,294,289,2.988888888888889
48,1,4,3,879434252,879434270,18,289,259,2.492063492063492
48,4,5,1,879434270,879434292,22,259,308,3.6153846153846154
48,5,3,-2,879434292,879434330,38,308,680,2.8333333333333335
48,3,3,0,879434330,879434387,57,680,266,2.6666666666666665
48,3,4,1,879434387,879434608,221,266,428,3.744186046511628
48,4,2,-2,879434608,879434653,45,428,28,3.923076923076923
48,2,4,2,879434653,879434688,35,28,1064,4.0
48,4,4,0,879434688,879434751,63,1064,215,3.662921348314607
48,4,4,0,879434751,879434752,1,215,423,3.7016129032258065
48,4,5,1,879434752,879434791,39,423,496,4.094594594594595
48,5,3,-2,879434791,879434792,1,496,228,3.7246376811594204
48,3,4,1,879434792,879434819,27,228,647,4.142857142857143
48,4,3,-1,879434819,879434850,31,647,425,3.7027027027027026
48,3,5,2,879434850,879434954,104,425,528,4.241379310344827
311,3,4,1,884363758,884363791,33,751,306,4.033333333333333
311,4,4,0,884363791,884363831,40,306,300,3.6861313868613137
311,4,4,0,884363831,884363904,73,300,329,3.25
311,4,3,-1,884363904,884363948,44,329,321,3.0172413793103448
311,3,4,1,884363948,884364071,123,321,748,3.1043478260869564
311,4,4,0,884364071,884364108,37,748,348,3.2
311,4,3,-1,884364108,884364139,31,348,323,3.0
311,3,4,1,884364139,884364268,129,323,539,2.6666666666666665
311,4,4,0,884364268,884364436,168,539,12,4.358974358974359
311,4,5,1,884364436,884364437,1,12,178,4.378378378378378
311,5,3,-2,884364437,884364464,27,178,186,3.905263157894737
311,3,4,1,884364464,884364465,1,186,493,3.909090909090909
311,4,5,1,884364465,884364502,37,493,64,4.373737373737374
311,5,5,0,884364502,884364538,36,64,174,4.253521126760563
311,5,5,0,884364538,884364569,31,174,318,4.5046728971962615
311,5,3,-2,884364569,884364570,1,318,58,3.543859649122807
311,3,3,0,884364570,884364623,53,58,1116,3.5714285714285716
311,3,3,0,884364623,884364652,29,1116,133,3.7777777777777777
311,3,2,-1,884364652,884364694,42,133,939,3.6333333333333333
311,2,5,3,884364694,884364763,69,939,172,4.225225225225225
311,5,4,-1,884364763,884364764,1,172,191,4.168674698795181
311,4,3,-1,884364764,884364812,48,191,232,3.0789473684210527
311,3,5,2,884364812,884364845,33,232,592,4.333333333333333
311,5,3,-2,884364845,884364846,1,592,650,3.1363636363636362
311,3,5,2,884364846,884364873,27,650,526,3.909090909090909
311,5,4,-1,884364873,884364931,58,526,498,4.290909090909091
311,4,5,1,884364931,884364999,68,498,170,4.242424242424242
311,5,4,-1,884364999,884365018,19,170,662,3.4583333333333335
311,4,3,-1,884365018,884365075,57,662,661,4.133333333333334
311,3,4,1,884365075,884365104,29,661,208,3.8125
311,4,3,-1,884365104,884365168,64,208,44,3.1333333333333333
311,3,4,1,884365168,884365202,34,44,511,4.096153846153846
311,4,5,1,884365202,884365251,49,511,520,4.136363636363637
311,5,5,0,884365251,884365252,1,520,86,3.869565217391304
311,5,3,-2,884365252,884365284,32,86,702,2.764705882352941
311,3,4,1,884365284,884365325,41,702,66,3.4705882352941178
311,4,4,0,884365325,884365357,32,66,238,3.888888888888889
311,4,3,-1,884365357,884365406,49,238,404,3.6578947368421053
311,3,4,1,884365406,884365450,44,404,88,3.433734939759036
311,4,3,-1,884365450,884365451,1,88,81,3.2857142857142856
311,3,4,1,884365451,884365485,34,81,515,4.202898550724638
311,4,4,0,884365485,884365580,95,515,679,3.2432432432432434
311,4,4,0,884365580,884365617,37,679,966,4.7
311,4,4,0,884365617,884365653,36,966,356,3.2
311,4,4,0,884365653,884365686,33,356,639,4.083333333333333
311,4,4,0,884365686,884365718,32,639,200,3.8157894736842106
311,4,3,-1,884365718,884365746,28,200,562,3.2941176470588234
311,3,3,0,884365746,884365747,1,562,386,2.769230769230769
311,3,3,0,884365747,884365780,33,386,367,3.4242424242424243
311,3,4,1,884365780,884365823,43,367,642,3.4285714285714284
311,4,3,-1,884365823,884365824,1,642,1479,3.5
311,3,3,0,884365824,884365852,28,1479,700,2.7142857142857144
311,3,3,0,884365852,884365853,1,700,5,3.1481481481481484
311,3,3,0,884365853,884365889,36,5,796,2.923076923076923
311,3,4,1,884365889,884365890,1,796,570,3.526315789473684
311,4,4,0,884365890,884365929,39,570,941,3.5
311,4,3,-1,884365929,884365954,25,941,671,3.4285714285714284
311,3,3,0,884365954,884366010,56,671,1222,2.6363636363636362
311,3,2,-1,884366010,884366112,102,1222,623,3.0454545454545454
311,2,5,3,884366112,884366137,25,623,371,3.0
311,5,4,-1,884366137,884366187,50,371,73,3.588235294117647
311,4,4,0,884366187,884366269,82,73,399,3.317073170731707
311,4,4,0,884366269,884366270,1,399,794,3.6
311,4,3,-1,884366270,884366307,37,794,720,3.2
311,3,1,-2,884366307,884366334,27,720,420,3.5652173913043477
311,1,4,3,884366334,884366363,29,420,218,3.5555555555555554
311,4,4,0,884366363,884366397,34,218,101,3.4827586206896552
311,4,3,-1,884366397,884366528,131,101,192,4.090909090909091
311,3,4,1,884366528,884366545,17,192,510,3.823529411764706
311,4,4,0,884366545,884366590,45,510,484,4.116279069767442
311,4,2,-2,884366590,884366617,27,484,185,3.9726027397260273
311,2,4,2,884366617,884366637,20,185,735,3.58
311,4,4,0,884366637,884366686,49,735,521,3.787878787878788
311,4,4,0,884366686,884366703,17,521,1119,3.5185185185185186
311,4,4,0,884366703,884366824,121,1119,845,3.661290322580645
311,4,4,0,884366824,884963179,596355,845,125,3.5555555555555554
311,4,5,1,884963179,884963180,1,125,1093,3.0
311,5,4,-1,884963180,884963202,22,1093,1,3.902439024390244
311,4,5,1,884963202,884963228,26,1,282,3.610526315789474
311,5,4,-1,884963228,884963365,137,282,9,3.8878504672897196
165,3,4,1,879525673,879525706,33,260,419,3.8208955223880596
165,4,5,1,879525706,879525738,32,419,181,3.98974358974359
165,5,4,-1,879525738,879525756,18,181,91,3.6
165,4,4,0,879525756,879525778,22,91,216,3.8454545454545452
165,4,5,1,879525778,879525832,54,216,169,4.548387096774194
165,5,4,-1,879525832,879525855,23,169,202,3.730337078651685
165,4,3,-1,879525855,879525894,39,202,156,4.017857142857143
165,3,5,2,879525894,879525961,67,156,318,4.5046728971962615
165,5,5,0,879525961,879525987,26,318,222,3.578125
208,2,3,1,883108324,883108360,36,367,204,3.6744186046511627
208,3,4,1,883108360,883108398,38,204,393,3.5125
208,4,5,1,883108398,883108430,32,393,435,3.8933333333333335
208,5,5,0,883108430,883108476,46,435,663,3.948717948717949
208,5,4,-1,883108476,883108477,1,663,66,3.4705882352941178
208,4,3,-1,883108477,883108498,21,66,781,3.4166666666666665
208,3,4,1,883108498,883108518,20,781,186,3.905263157894737
208,4,3,-1,883108518,883108684,166,186,996,2.1666666666666665
208,3,4,1,883108684,883108745,61,996,524,4.166666666666667
208,4,5,1,883108745,883108797,52,524,197,4.112676056338028
2,3,4,1,888550066,888550939,873,307,293,3.630434782608696
2,4,4,0,888550939,888551062,123,293,257,3.7154471544715446
2,4,4,0,888551062,888551164,102,257,295,3.769230769230769
2,4,4,0,888551164,888551174,10,295,277,3.6
2,4,3,-1,888551174,888551235,61,277,287,3.4516129032258065
2,3,4,1,888551235,888551341,106,287,255,3.2027027027027026
2,4,3,-1,888551341,888551441,100,255,290,3.108108108108108
2,3,4,1,888551441,888551552,111,290,276,3.6036036036036037
2,4,3,-1,888551552,888551647,95,276,278,3.0357142857142856
2,3,4,1,888551647,888551648,1,278,25,3.3185840707964602
2,4,4,0,888551648,888551853,205,25,14,4.101694915254237
2,4,4,0,888551853,888552017,164,14,284,3.1547619047619047
2,4,3,-1,888552017,888979353,427336,284,289,2.988888888888889
2,3,1,-2,888979353,888980029,676,289,309,2.3333333333333335
2,1,1,0,888980029,888980085,56,309,314,1.0
2,1,3,2,888980085,888980240,155,314,281,3.2
205,4,3,-1,888284313,888284347,34,242,269,4.085106382978723
205,3,3,0,888284347,888284402,55,269,294,3.1052631578947367
205,3,2,-1,888284402,888284532,130,294,875,2.736842105263158
205,2,3,1,888284532,888284577,45,875,322,3.0476190476190474
205,3,2,-1,888284577,888284618,41,322,268,3.9838709677419355
205,2,1,-1,888284618,888284710,92,268,984,2.6666666666666665
205,1,2,1,888284710,888284758,48,984,243,2.357142857142857
248,3,4,1,884534419,884534436,17,678,343,3.0
248,4,1,-3,884534436,884534472,36,343,323,3.0
248,1,4,3,884534472,884534506,34,323,324,3.2291666666666665
248,4,3,-1,884534506,884534649,143,324,179,3.8823529411764706
248,3,2,-1,884534649,884534672,23,179,474,4.172413793103448
248,2,5,3,884534672,884534673,1,474,98,4.240875912408759
248,5,5,0,884534673,884534695,22,98,186,3.905263157894737
248,5,4,-1,884534695,884534716,21,186,100,4.0162162162162165
248,4,5,1,884534716,884534735,19,100,64,4.373737373737374
248,5,2,-3,884534735,884534752,17,64,22,4.215909090909091
248,2,3,1,884534752,884534772,20,22,185,3.9726027397260273
248,3,4,1,884534772,884534793,21,185,55,4.051282051282051
248,4,5,1,884534793,884534808,15,55,176,3.967032967032967
248,5,5,0,884534808,884534901,93,176,114,4.3478260869565215
248,5,5,0,884534901,884534945,44,114,156,4.017857142857143
248,5,4,-1,884534945,884534968,23,156,96,3.9130434782608696
248,4,5,1,884534968,884534992,24,96,11,3.8904109589041096
248,5,2,-3,884534992,884535013,21,11,196,3.9404761904761907
248,2,5,3,884535013,884535046,33,196,89,3.9615384615384617
248,5,5,0,884535046,884535084,38,89,127,4.162790697674419
248,5,5,0,884535084,884535085,1,127,515,4.202898550724638
248,5,5,0,884535085,884535433,348,515,117,3.689189189189189
248,5,3,-2,884535433,884535532,99,117,250,3.4698795180722892
248,3,2,-1,884535532,884535582,50,250,282,3.610526315789474
248,2,3,1,884535582,884535744,162,282,1,3.902439024390244
248,3,3,0,884535744,884535840,96,1,257,3.7154471544715446
248,3,3,0,884535840,884536150,310,257,235,3.106382978723404
248,3,2,-1,884536150,884536206,56,235,121,3.521212121212121
93,4,4,0,888705146,888705200,54,283,14,4.101694915254237
93,4,4,0,888705200,888705224,24,14,275,4.087912087912088
93,4,2,-2,888705224,888705257,33,275,276,3.6036036036036037
93,2,4,2,888705257,888705295,38,276,222,3.578125
93,4,5,1,888705295,888705321,26,222,1,3.902439024390244
93,5,1,-4,888705321,888705360,39,1,151,3.6544117647058822
93,1,5,4,888705360,888705388,28,151,15,3.725663716814159
93,5,3,-2,888705388,888705416,28,15,118,3.2764227642276422
93,3,2,-1,888705416,888705780,364,118,866,3.3962264150943398
93,2,4,2,888705780,888705879,99,866,476,3.1216216216216215
93,4,4,0,888705879,888705939,60,476,235,3.106382978723404
93,4,3,-1,888705939,888705966,27,235,820,3.0444444444444443
93,3,3,0,888705966,888705988,22,820,934,3.0294117647058822
159,1,2,1,880485290,880485344,54,319,948,2.2962962962962963
159,2,3,1,880485344,880485345,1,948,326,3.262295081967213
159,3,2,-1,880485345,880485415,70,326,289,2.988888888888889
159,2,5,3,880485415,880485443,28,289,322,3.0476190476190474
159,5,3,-2,880485443,880485488,45,322,748,3.1043478260869564
159,3,3,0,880485488,880485529,41,748,988,2.5555555555555554
159,3,5,2,880485529,880485530,1,988,678,2.8181818181818183
159,5,5,0,880485530,880485824,294,678,276,3.6036036036036037
159,5,5,0,880485824,880485861,37,276,7,3.76056338028169
159,5,4,-1,880485861,880485879,18,7,293,3.630434782608696
159,4,4,0,880485879,880485972,93,293,1049,2.5714285714285716
159,4,5,1,880485972,880486009,37,1049,595,2.9166666666666665
159,5,3,-2,880486009,880486071,62,595,121,3.521212121212121
159,3,4,1,880486071,880557003,70932,121,871,2.3823529411764706
159,4,5,1,880557003,880557038,35,871,126,3.8620689655172415
159,5,4,-1,880557038,880557060,22,126,591,3.7169811320754715
159,4,5,1,880557060,880557080,20,591,1012,3.2916666666666665
159,5,5,0,880557080,880557112,32,1012,25,3.3185840707964602
159,5,1,-4,880557112,880557130,18,25,845,3.661290322580645
159,1,4,3,880557130,880557170,40,845,1013,2.388888888888889
159,4,5,1,880557170,880557192,22,1013,125,3.5555555555555554
159,5,1,-4,880557192,880557322,130,125,130,1.8461538461538463
159,1,4,3,880557322,880557347,25,130,685,3.2666666666666666
159,4,5,1,880557347,880557386,39,685,298,3.779220779220779
159,5,3,-2,880557386,880557387,1,298,274,3.5609756097560976
159,3,4,1,880557387,880557464,77,274,118,3.2764227642276422
159,4,5,1,880557464,880557539,75,118,1028,2.857142857142857
159,5,5,0,880557539,880557564,25,1028,405,3.25
159,5,3,-2,880557564,880557584,20,405,1048,2.857142857142857
159,3,4,1,880557584,880557621,37,1048,546,2.9789473684210526
159,4,3,-1,880557621,880557677,56,546,411,2.911764705882353
159,3,4,1,880557677,880557824,147,411,930,2.793103448275862
159,4,3,-1,880557824,880557848,24,930,456,2.2
159,3,3,0,880557848,880557864,16,456,832,2.7142857142857144
159,3,5,2,880557864,880989838,431974,832,597,3.2771084337349397
159,5,5,0,880989838,880989865,27,597,310,3.6666666666666665
159,5,4,-1,880989865,884026788,3036923,310,294,3.1052631578947367
159,4,1,-3,884026788,884026823,35,294,1258,2.3333333333333335
159,1,3,2,884026823,884026901,78,1258,288,3.5214285714285714
159,3,3,0,884026901,884026946,45,288,72,3.175438596491228
159,3,3,0,884026946,884027027,81,72,1002,2.0
159,3,5,2,884027027,884027141,114,1002,1221,3.4285714285714284
159,5,4,-1,884027141,884027269,128,1221,249,3.3275862068965516
159,4,2,-2,884027269,884027316,47,249,588,3.8358208955223883
159,2,3,1,884027316,884360539,333223,588,195,3.9072164948453607
159,3,3,0,884360539,885501660,1141121,195,255,3.2027027027027026
159,3,5,2,885501660,893255761,7754101,255,333,3.546666666666667
159,5,4,-1,893255761,893255798,37,333,918,3.3333333333333335
159,4,2,-2,893255798,893255905,107,918,876,3.0
159,2,1,-1,893255905,893255969,64,876,358,2.6551724137931036
159,1,3,2,893255969,893255993,24,358,328,3.4895833333333335
159,3,3,0,893255993,893256013,20,328,299,3.0
159,3,2,-1,893256013,893256062,49,299,873,2.7586206896551726
159,2,1,-1,893256062,893256084,22,873,880,2.8421052631578947
146,4,4,0,891457538,891457714,176,319,262,3.5217391304347827
146,4,3,-1,891457714,891457905,191,262,307,3.6031746031746033
146,3,3,0,891457905,891457943,38,307,300,3.6861313868613137
146,3,1,-2,891457943,891457978,35,300,342,2.64
146,1,3,2,891457978,891458079,101,342,328,3.4895833333333335
146,3,5,2,891458079,891458080,1,328,1293,5.0
29,5,4,-1,882820686,882820730,44,268,306,4.033333333333333
29,4,4,0,882820730,882820803,73,306,270,3.7804878048780486
29,4,4,0,882820803,882820869,66,270,332,3.6511627906976742
29,4,4,0,882820869,882820897,28,332,269,4.085106382978723
29,4,4,0,882820897,882821020,123,269,874,3.230769230769231
29,4,4,0,882821020,882821044,24,874,259,2.492063492063492
29,4,3,-1,882821044,882821161,117,259,879,3.2291666666666665
29,3,3,0,882821161,882821582,421,879,678,2.8181818181818183
29,3,3,0,882821582,882821673,91,678,343,3.0
29,3,4,1,882821673,882821705,32,343,312,3.0
29,4,5,1,882821705,882821989,284,312,12,4.358974358974359
156,5,4,-1,888185606,888185677,71,480,357,4.063291139240507
156,4,4,0,888185677,888185735,58,357,9,3.8878504672897196
156,4,4,0,888185735,888185777,42,9,48,4.055555555555555
156,4,5,1,888185777,888185778,1,48,187,4.215189873417722
156,5,4,-1,888185778,888185854,76,187,86,3.869565217391304
156,4,4,0,888185854,888185947,93,86,661,4.133333333333334
156,4,3,-1,888185947,888186093,146,661,22,4.215909090909091
37,4,3,-1,880915407,880915528,121,948,273,3.5238095238095237
37,3,4,1,880915528,880915565,37,273,405,3.25
37,4,2,-2,880915565,880915607,42,405,831,2.6097560975609757
37,2,2,0,880915607,880915633,26,831,118,3.2764227642276422
37,2,4,2,880915633,880915674,41,118,24,3.3728813559322033
37,4,2,-2,880915674,880915711,37,24,472,2.984375
37,2,5,3,880915711,880915838,127,472,50,4.306532663316583
37,5,5,0,880915838,880915874,36,50,195,3.9072164948453607
37,5,4,-1,880915874,880915902,28,195,385,3.6129032258064515
37,4,4,0,880915902,880915942,40,385,230,3.3518518518518516
37,4,4,0,880915942,880916010,68,230,566,3.543859649122807
37,4,3,-1,880916010,880916046,36,566,665,2.72972972972973
37,3,5,2,880916046,880916070,24,665,62,3.048780487804878
37,5,4,-1,880916070,880930071,14001,62,127,4.162790697674419
37,4,4,0,880930071,880930072,1,127,172,4.225225225225225
141,5,5,0,884584271,884584338,67,313,258,3.7547169811320753
141,5,3,-2,884584338,884584386,48,258,288,3.5214285714285714
141,3,4,1,884584386,884584480,94,288,323,3.0
141,4,4,0,884584480,884584688,208,323,100,4.0162162162162165
141,4,4,0,884584688,884584709,21,100,181,3.98974358974359
141,4,2,-2,884584709,884584735,26,181,127,4.162790697674419
141,2,3,1,884584735,884584753,18,127,1,3.902439024390244
141,3,3,0,884584753,884584773,20,1,257,3.7154471544715446
141,3,5,2,884584773,884584790,17,257,298,3.779220779220779
141,5,1,-4,884584790,884584817,27,298,279,2.75
141,1,4,3,884584817,884584865,48,279,281,3.2
141,4,1,-3,884584865,884584886,21,281,1059,2.764705882352941
141,1,4,3,884584886,884584906,20,1059,147,3.3142857142857145
141,4,4,0,884584906,884584929,23,147,117,3.689189189189189
141,4,4,0,884584929,884584930,1,117,742,3.5555555555555554
141,4,5,1,884584930,884584981,51,742,744,3.5714285714285716
141,5,5,0,884584981,884585001,20,744,676,3.3142857142857145
141,5,4,-1,884585001,884585039,38,676,619,3.4782608695652173
141,4,4,0,884585039,884585070,31,619,815,3.135135135135135
141,4,4,0,884585070,884585071,1,815,597,3.2771084337349397
141,4,3,-1,884585071,884585105,34,597,405,3.25
141,3,3,0,884585105,884585128,23,405,864,3.2142857142857144
141,3,3,0,884585128,884585148,20,864,871,2.3823529411764706
141,3,3,0,884585148,884585168,20,871,1283,2.9
141,3,5,2,884585168,884585195,27,1283,535,3.380952380952381
141,5,5,0,884585195,884585220,25,535,274,3.5609756097560976
141,5,4,-1,884585220,884585247,27,274,930,2.793103448275862
141,4,4,0,884585247,884585274,27,930,1023,2.5714285714285716
141,4,4,0,884585274,884585300,26,1023,926,2.7857142857142856
141,4,3,-1,884585300,884585320,20,926,1282,3.3333333333333335
141,3,4,1,884585320,884585363,43,1282,985,2.9
141,4,3,-1,884585363,884585364,1,985,1244,2.7777777777777777
141,3,2,-1,884585364,884585386,22,1244,249,3.3275862068965516
141,2,2,0,884585386,884585437,51,249,826,2.5555555555555554
141,2,2,0,884585437,884585470,33,826,831,2.6097560975609757
141,2,3,1,884585470,884585498,28,831,476,3.1216216216216215
141,3,2,-1,884585498,884585523,25,476,407,2.611111111111111
141,2,3,1,884585523,884585547,24,407,1040,2.2666666666666666
141,3,3,0,884585547,884585572,25,1040,1014,3.1
141,3,1,-2,884585572,886447613,1862041,1014,346,3.5128205128205128
141,1,4,3,886447613,886447679,66,346,328,3.4895833333333335
141,4,1,-3,886447679,886447698,19,328,872,3.0
141,1,1,0,886447698,886447847,149,872,880,2.8421052631578947
141,1,4,3,886447847,886447880,33,880,984,2.6666666666666665
141,4,1,-3,886447880,886447904,24,984,259,2.492063492063492
141,1,5,4,886447904,887424721,976817,259,300,3.6861313868613137
195,1,5,4,874825827,875436683,610856,1415,651,3.8627450980392157
195,5,5,0,875436683,875771441,334758,651,451,3.207792207792208
195,5,5,0,875771441,876632643,861202,451,47,3.5869565217391304
195,5,1,-4,876632643,877835102,1202459,47,1052,2.4545454545454546
195,1,3,2,877835102,877835268,166,1052,797,3.1538461538461537
195,3,2,-1,877835268,877835302,34,797,407,2.611111111111111
195,2,2,0,877835302,877835350,48,407,982,3.2
195,2,2,0,877835350,877835451,101,982,1030,2.3636363636363638
195,2,3,1,877835451,877835548,97,1030,809,2.7058823529411766
195,3,4,1,877835548,880710086,2874538,809,276,3.6036036036036037
195,4,4,0,880710086,883295540,2585454,276,1089,2.1363636363636362
195,4,3,-1,883295540,883295570,30,1089,678,2.8181818181818183
195,3,3,0,883295570,883934716,639146,678,921,3.611111111111111
195,3,4,1,883934716,884420059,485343,921,328,3.4895833333333335
195,4,3,-1,884420059,885110899,690840,328,366,3.4285714285714284
195,3,2,-1,885110899,885110922,23,366,477,3.1666666666666665
195,2,4,2,885110922,888737345,3626423,477,1084,4.0
195,4,4,0,888737345,888737346,1,1084,265,3.710144927536232
195,4,3,-1,888737346,888737525,179,265,154,3.6031746031746033
195,3,4,1,888737525,888737703,178,154,298,3.779220779220779
195,4,3,-1,888737703,890589490,1851787,298,152,3.6785714285714284
195,3,4,1,890589490,891762491,1173001,152,387,3.5357142857142856
195,4,3,-1,891762491,891762536,45,387,93,3.5641025641025643
195,3,4,1,891762536,891762646,110,93,1418,3.6666666666666665
108,4,4,0,879879720,879879739,19,100,50,4.306532663316583
108,4,4,0,879879739,879879757,18,50,124,4.052631578947368
108,4,3,-1,879879757,879879796,39,124,237,3.7315436241610738
108,3,5,2,879879796,879879834,38,237,10,3.85
108,5,3,-2,879879834,879879864,30,10,125,3.5555555555555554
108,3,3,0,879879864,879879911,47,125,284,3.1547619047619047
108,3,5,2,879879911,879879941,30,284,515,4.202898550724638
108,5,3,-2,879879941,879879961,20,515,252,2.911392405063291
108,3,4,1,879879961,879879985,24,252,281,3.2
108,4,3,-1,879879985,879880055,70,281,740,3.423076923076923
108,3,4,1,879880055,879880076,21,740,290,3.108108108108108
108,4,2,-2,879880076,879880094,18,290,255,3.2027027027027026
108,2,3,1,879880094,879880141,47,255,21,2.9210526315789473
108,3,3,0,879880141,879880190,49,21,121,3.521212121212121
47,4,3,-1,879439040,879439078,38,321,324,3.2291666666666665
47,3,4,1,879439078,879439113,35,324,306,4.033333333333333
47,4,3,-1,879439113,879439143,30,306,683,2.176470588235294
47,3,3,0,879439143,879439144,1,683,304,3.5306122448979593
47,3,2,-1,879439144,879440360,1216,304,323,3.0
255,2,5,3,883215406,883215586,180,294,324,3.2291666666666665
255,5,2,-3,883215586,883215630,44,324,328,3.4895833333333335
255,2,3,1,883215630,883215660,30,328,879,3.2291666666666665
255,3,5,2,883215660,883215759,99,879,682,3.0476190476190474
255,5,2,-3,883215759,883215795,36,682,678,2.8181818181818183
255,2,2,0,883215795,883215867,72,678,343,3.0
255,2,5,3,883215867,883216245,378,343,249,3.3275862068965516
255,5,2,-3,883216245,883216358,113,249,413,2.5652173913043477
255,2,5,3,883216358,883216448,90,413,56,4.051724137931035
255,5,5,0,883216448,883216449,1,56,98,4.240875912408759
255,5,2,-3,883216449,883216544,95,98,441,2.4
255,2,3,1,883216544,883216599,55,441,444,2.6842105263157894
255,3,1,-2,883216599,883216672,73,444,551,1.6666666666666667
255,1,1,0,883216672,883216903,231,551,829,2.4615384615384617
255,1,1,0,883216903,883216958,55,829,825,2.914285714285714
255,1,1,0,883216958,883217030,72,825,743,1.9545454545454546
255,1,5,4,883217030,883217072,42,743,763,3.347826086956522
89,3,5,2,879441160,879441271,111,875,100,4.0162162162162165
89,5,2,-3,879441271,879441307,36,100,93,3.5641025641025643
89,2,5,3,879441307,879441357,50,93,117,3.689189189189189
89,5,4,-1,879441357,879441381,24,117,237,3.7315436241610738
89,4,2,-2,879441381,879441400,19,237,952,3.3529411764705883
89,2,5,3,879441400,879441422,22,952,7,3.76056338028169
89,5,4,-1,879441422,879441452,30,7,111,3.5106382978723403
89,4,5,1,879441452,879441491,39,111,222,3.578125
89,5,5,0,879441491,879441507,16,222,151,3.6544117647058822
89,5,4,-1,879441507,879441557,50,151,283,3.901639344262295
89,4,4,0,879441557,879441571,14,283,240,3.0350877192982457
89,4,3,-1,879441571,879441586,15,240,405,3.25
89,3,5,2,879441586,879441637,51,405,25,3.3185840707964602
89,5,5,0,879441637,879441657,20,25,121,3.521212121212121
89,5,2,-3,879441657,879441672,15,121,13,3.5454545454545454
89,2,5,3,879441672,879441780,108,13,107,3.45
89,5,3,-2,879441780,879459884,18104,107,1119,3.5185185185185186
89,3,5,2,879459884,879459909,25,1119,1074,2.857142857142857
89,5,4,-1,879459909,879460027,118,1074,724,3.64
89,4,2,-2,879460027,879460376,349,724,739,3.391304347826087
140,3,5,2,879013651,879013684,33,294,303,3.75
140,5,4,-1,879013684,879013719,35,303,289,2.988888888888889
140,4,3,-1,879013719,879013720,1,289,245,3.056179775280899
140,3,3,0,879013720,879013747,27,245,301,3.2465753424657535
140,3,4,1,879013747,879013832,85,301,880,2.8421052631578947
190,3,3,0,891033183,891033327,144,258,895,3.142857142857143
190,3,2,-1,891033327,891033349,22,895,898,3.0869565217391304
190,2,2,0,891033349,891033370,21,898,539,2.6666666666666665
190,2,2,0,891033370,891033445,75,539,1313,3.142857142857143
190,2,5,3,891033445,891033606,161,1313,313,4.323076923076923
190,5,4,-1,891033606,891033607,1,313,310,3.6666666666666665
190,4,4,0,891033607,891033632,25,310,276,3.6036036036036037
190,4,4,0,891033632,891033653,21,276,100,4.0162162162162165
190,4,4,0,891033653,891033697,44,100,117,3.689189189189189
190,4,3,-1,891033697,891033725,28,117,685,3.2666666666666666
190,3,3,0,891033725,891033773,48,685,282,3.610526315789474
190,3,4,1,891033773,891033806,33,282,544,3.185185185185185
190,4,3,-1,891033806,891033841,35,544,742,3.5555555555555554
190,3,4,1,891033841,891033863,22,742,147,3.3142857142857145
190,4,3,-1,891033863,891033906,43,147,118,3.2764227642276422
190,3,2,-1,891033906,891042916,9010,118,930,2.793103448275862
190,2,3,1,891042916,891042938,22,930,717,2.9696969696969697
190,3,4,1,891042938,891626000,583062,717,405,3.25
190,4,3,-1,891626000,891626040,40,405,826,2.5555555555555554
24,3,3,0,875246012,875246037,25,358,294,3.1052631578947367
24,3,3,0,875246037,875246185,148,294,129,3.744186046511628
24,3,4,1,875246185,875246216,31,129,249,3.3275862068965516
24,4,4,0,875246216,875246258,42,249,25,3.3185840707964602
24,4,5,1,875246258,875322758,76500,25,64,4.373737373737374
24,5,4,-1,875322758,875322796,38,64,79,3.956989247311828
24,4,5,1,875322796,875322847,51,79,180,3.9473684210526314
24,5,5,0,875322847,875322848,1,180,151,3.6544117647058822
24,5,5,0,875322848,875322875,27,151,763,3.347826086956522
24,5,5,0,875322875,875322951,76,763,276,3.6036036036036037
24,5,5,0,875322951,875323002,51,276,427,4.2025316455696204
24,5,5,0,875323002,875323051,49,427,69,3.8015873015873014
24,5,4,-1,875323051,875323193,142,69,97,3.7282608695652173
24,4,2,-2,875323193,875323241,48,97,367,3.4242424242424243
24,2,3,1,875323241,875323274,33,367,132,3.929411764705882
24,3,4,1,875323274,875323308,34,132,402,3.3076923076923075
24,4,4,0,875323308,875323368,60,402,153,3.7865168539325844
24,4,5,1,875323368,875323401,33,153,98,4.240875912408759
24,5,5,0,875323401,875323475,74,98,729,3.3793103448275863
24,5,5,0,875323475,875323507,32,729,275,4.087912087912088
24,5,4,-1,875323507,875323553,46,275,372,3.6666666666666665
24,4,5,1,875323553,875323594,41,372,41,3.0625
24,5,5,0,875323594,875323637,43,41,100,4.0162162162162165
24,5,5,0,875323637,875323676,39,100,178,4.378378378378378
24,5,5,0,875323676,875323711,35,178,12,4.358974358974359
24,5,5,0,875323711,875323712,1,12,421,3.462962962962963
24,5,5,0,875323712,875323745,33,421,9,3.8878504672897196
24,5,5,0,875323745,875323773,28,9,286,3.442857142857143
24,5,5,0,875323773,875323833,60,286,71,3.6575342465753424
24,5,5,0,875323833,875323879,46,71,127,4.162790697674419
24,5,5,0,875323879,875323915,36,127,655,3.7857142857142856
17,1,4,3,885166256,885272520,106264,323,100,4.0162162162162165
17,4,1,-3,885272520,885272538,18,100,125,3.5555555555555554
17,1,4,3,885272538,885272579,41,125,1,3.902439024390244
17,4,3,-1,885272579,885272606,27,1,744,3.5714285714285716
17,3,2,-1,885272606,885272628,22,744,237,3.7315436241610738
17,2,3,1,885272628,885272654,26,237,13,3.5454545454545454
17,3,4,1,885272654,885272696,42,13,919,4.0
17,4,3,-1,885272696,885272724,28,919,117,3.689189189189189
17,3,4,1,885272724,885272751,27,117,151,3.6544117647058822
313,4,4,0,891012877,891012907,30,333,300,3.6861313868613137
313,4,3,-1,891012907,891012934,27,300,748,3.1043478260869564
313,3,3,0,891012934,891013013,79,748,331,3.5517241379310347
313,3,4,1,891013013,891013059,46,331,892,2.9615384615384617
313,4,3,-1,891013059,891013144,85,892,245,3.056179775280899
313,3,5,2,891013144,891013496,352,245,488,4.277777777777778
313,5,4,-1,891013496,891013525,29,488,216,3.8454545454545452
313,4,5,1,891013525,891013554,29,216,183,3.951219512195122
313,5,5,0,891013554,891013620,66,183,430,4.136363636363637
313,5,5,0,891013620,891013652,32,430,663,3.948717948717949
313,5,5,0,891013652,891013681,29,663,603,4.315789473684211
313,5,4,-1,891013681,891013712,31,603,318,4.5046728971962615
313,4,4,0,891013712,891013713,1,318,176,3.967032967032967
313,4,4,0,891013713,891013742,29,176,511,4.096153846153846
313,4,4,0,891013742,891013773,31,511,182,3.842857142857143
313,4,5,1,891013773,891013803,30,182,515,4.202898550724638
313,5,4,-1,891013803,891013829,26,515,650,3.1363636363636362
313,4,4,0,891013829,891013830,1,650,657,4.341463414634147
313,4,5,1,891013830,891013859,29,657,211,3.958904109589041
313,5,4,-1,891013859,891013887,28,211,521,3.787878787878788
313,4,5,1,891013887,891013910,23,521,197,4.112676056338028
313,5,5,0,891013910,891013939,29,197,520,4.136363636363637
313,5,5,0,891013939,891013971,32,520,443,3.8421052631578947
313,5,4,-1,891013971,891014000,29,443,481,3.8421052631578947
313,4,4,0,891014000,891014335,335,481,172,4.225225225225225
313,4,5,1,891014335,891014373,38,172,89,3.9615384615384617
313,5,5,0,891014373,891014401,28,89,523,4.159090909090909
313,5,4,-1,891014401,891014444,43,523,98,4.240875912408759
313,4,4,0,891014444,891014474,30,98,655,3.7857142857142856
313,4,4,0,891014474,891014499,25,655,194,4.029411764705882
313,4,5,1,891014499,891014524,25,194,505,4.0625
313,5,3,-2,891014524,891014551,27,505,8,3.903225806451613
313,3,3,0,891014551,891014552,1,8,651,3.8627450980392157
313,3,5,2,891014552,891014597,45,651,633,3.9
313,5,3,-2,891014597,891014649,52,633,428,3.744186046511628
313,3,2,-1,891014649,891014753,104,428,154,3.6031746031746033
313,2,4,2,891014753,891014782,29,154,181,3.98974358974359
313,4,3,-1,891014782,891014870,88,181,164,3.6140350877192984
313,3,4,1,891014870,891014898,28,164,210,3.921259842519685
313,4,3,-1,891014898,891014925,27,210,461,3.3333333333333335
313,3,3,0,891014925,891014956,31,461,448,3.466666666666667
313,3,3,0,891014956,891015011,55,448,192,4.090909090909091
313,3,3,0,891015011,891015049,38,192,230,3.3518518518518516
313,3,5,2,891015049,891015144,95,230,498,4.290909090909091
313,5,3,-2,891015144,891015167,23,498,208,3.8125
313,3,4,1,891015167,891015196,29,208,471,3.5714285714285716
313,4,3,-1,891015196,891015219,23,471,486,3.9565217391304346
313,3,4,1,891015219,891015268,49,486,393,3.5125
313,4,4,0,891015268,891015296,28,393,497,3.35
313,4,4,0,891015296,891015319,23,497,117,3.689189189189189
313,4,3,-1,891015319,891015387,68,117,58,3.543859649122807
313,3,4,1,891015387,891015486,99,58,31,3.642857142857143
313,4,4,0,891015486,891016220,734,31,566,3.543859649122807
313,4,4,0,891016220,891016280,60,566,490,3.5454545454545454
313,4,3,-1,891016280,891016325,45,490,649,3.625
313,3,4,1,891016325,891016354,29,649,588,3.8358208955223883
313,4,3,-1,891016354,891016378,24,588,487,4.043478260869565
313,3,3,0,891016378,891016425,47,487,414,3.3076923076923075
313,3,3,0,891016425,891016452,27,414,499,4.0
313,3,2,-1,891016452,891016540,88,499,740,3.423076923076923
313,2,4,2,891016540,891016583,43,740,147,3.3142857142857145
313,4,2,-2,891016583,891016757,174,147,25,3.3185840707964602
313,2,4,2,891016757,891016826,69,25,1050,3.6153846153846154
313,4,4,0,891016826,891016853,27,1050,265,3.710144927536232
313,4,3,-1,891016853,891016878,25,265,152,3.6785714285714284
313,3,3,0,891016878,891016932,54,152,742,3.5555555555555554
313,3,2,-1,891016932,891016962,30,742,15,3.725663716814159
313,2,3,1,891016962,891016986,24,15,228,3.7246376811594204
313,3,3,0,891016986,891017011,25,228,186,3.905263157894737
313,3,4,1,891017011,891017088,77,186,684,3.847826086956522
313,4,3,-1,891017088,891017270,182,684,162,3.4651162790697674
313,3,1,-2,891017270,891017319,49,162,1470,1.0
313,1,3,2,891017319,891017372,53,1470,157,3.5714285714285716
313,3,3,0,891017372,891017395,23,157,502,3.272727272727273
313,3,3,0,891017395,891017585,190,502,542,2.888888888888889
313,3,3,0,891017585,891017708,123,542,222,3.578125
313,3,3,0,891017708,891017736,28,222,200,3.8157894736842106
313,3,4,1,891017736,891028241,10505,200,226,3.378787878787879
313,4,3,-1,891028241,891028285,44,226,403,3.298507462686567
313,3,4,1,891028285,891028323,38,403,550,3.272727272727273
313,4,2,-2,891028323,891028360,37,550,840,3.090909090909091
313,2,3,1,891028360,891028426,66,840,831,2.6097560975609757
313,3,2,-1,891028426,891028472,46,831,29,2.5714285714285716
313,2,3,1,891028472,891028873,401,29,239,3.423076923076923
313,3,2,-1,891028873,891028904,31,239,778,3.5925925925925926
313,2,2,0,891028904,891028956,52,778,88,3.433734939759036
313,2,3,1,891028956,891029076,120,88,167,2.8181818181818183
313,3,1,-2,891029076,891029117,41,167,67,3.106382978723404
313,1,3,2,891029117,891029148,31,67,235,3.106382978723404
313,3,3,0,891029148,891029877,729,235,670,2.9375
313,3,2,-1,891029877,891029918,41,670,674,2.6875
313,2,3,1,891029918,891029993,75,674,452,2.6129032258064515
313,3,1,-2,891029993,891030027,34,452,565,2.4285714285714284
313,1,3,2,891030027,891030096,69,565,465,3.75
313,3,4,1,891030096,891030144,48,465,71,3.6575342465753424
313,4,3,-1,891030144,891030189,45,71,102,3.3684210526315788
313,3,3,0,891030189,891030228,39,102,473,2.9166666666666665
313,3,3,0,891030228,891030334,106,473,843,2.933333333333333
313,3,4,1,891030334,891030490,156,843,63,3.125
313,4,3,-1,891030490,891031747,1257,63,402,3.3076923076923075
53,4,4,0,879442514,879442538,24,96,568,3.5853658536585367
53,4,4,0,879442538,879442978,440,568,50,4.306532663316583
53,4,4,0,879442978,879443011,33,50,151,3.6544117647058822
53,4,5,1,879443011,879443027,16,151,15,3.725663716814159
53,5,4,-1,879443027,879443046,19,15,181,3.98974358974359
53,4,3,-1,879443046,879443083,37,181,845,3.661290322580645
53,3,4,1,879443083,879443188,105,845,257,3.7154471544715446
53,4,3,-1,879443188,879443303,115,257,924,3.3703703703703702
124,3,3,0,890287221,890287317,96,474,174,4.253521126760563
124,3,3,0,890287317,890287395,78,174,79,3.956989247311828
124,3,3,0,890287395,890287508,113,79,50,4.306532663316583
124,3,4,1,890287508,890287645,137,50,7,3.76056338028169
124,4,2,-2,890287645,890287687,42,7,173,4.1441441441441444
124,2,3,1,890287687,890287733,46,173,1,3.902439024390244
124,3,4,1,890287733,890287822,89,1,98,4.240875912408759
124,4,2,-2,890287822,890287936,114,98,157,3.5714285714285716
124,2,3,1,890287936,890399902,111966,157,209,3.8275862068965516
149,4,4,0,883512623,883512689,66,345,896,3.6666666666666665
149,4,3,-1,883512689,883512715,26,896,300,3.6861313868613137
149,3,3,0,883512715,883512752,37,300,874,3.230769230769231
149,3,4,1,883512752,883512775,23,874,340,3.7419354838709675
149,4,3,-1,883512775,883512813,38,340,1295,3.0
149,3,2,-1,883512813,883512834,21,1295,325,2.625
149,2,2,0,883512834,883512856,22,325,321,3.0172413793103448
149,2,2,0,883512856,883512928,72,321,323,3.0
149,2,1,-1,883512928,883512950,22,323,312,3.0
176,4,5,1,886047026,886047068,42,258,272,4.2
176,5,4,-1,886047068,886047069,1,272,270,3.7804878048780486
176,4,3,-1,886047069,886047118,49,270,303,3.75
176,3,4,1,886047118,886047176,58,303,750,4.027777777777778
176,4,5,1,886047176,886047292,116,750,324,3.2291666666666665
176,5,3,-2,886047292,886047375,83,324,325,2.625
176,3,3,0,886047375,886047531,156,325,881,2.769230769230769
176,3,4,1,886047531,886047595,64,881,948,2.2962962962962963
176,4,5,1,886047595,886047918,323,948,475,3.956043956043956
176,5,4,-1,886047918,886047994,76,475,13,3.5454545454545454
176,4,4,0,886047994,886048040,46,13,1008,3.5
176,4,5,1,886048040,886048188,148,1008,7,3.76056338028169
176,5,4,-1,886048188,886048230,42,7,240,3.0350877192982457
176,4,2,-2,886048230,886048262,32,240,405,3.25
176,2,3,1,886048262,886048305,43,405,927,3.0
106,4,4,0,881449487,881449886,399,1,69,3.8015873015873014
106,4,5,1,881449886,881450536,650,69,165,3.9130434782608696
106,5,5,0,881450536,881450578,42,165,196,3.9404761904761907
106,5,5,0,881450578,881450758,180,196,194,4.029411764705882
106,5,4,-1,881450758,881450810,52,194,210,3.921259842519685
106,4,4,0,881450810,881451144,334,210,28,3.923076923076923
106,4,4,0,881451144,881451234,90,28,12,4.358974358974359
106,4,3,-1,881451234,881451355,121,12,86,3.869565217391304
106,3,4,1,881451355,881451421,66,86,699,3.736842105263158
106,4,5,1,881451421,881451453,32,699,191,4.168674698795181
106,5,4,-1,881451453,881451631,178,191,660,3.71875
106,4,4,0,881451631,881451716,85,660,77,3.3857142857142857
106,4,4,0,881451716,881452405,689,77,8,3.903225806451613
106,4,4,0,881452405,881452532,127,8,211,3.958904109589041
106,4,3,-1,881452532,881452599,67,211,712,3.0434782608695654
106,3,4,1,881452599,881452685,86,712,526,3.909090909090909
106,4,4,0,881452685,881452711,26,526,566,3.543859649122807
106,4,4,0,881452711,881452763,52,566,684,3.847826086956522
106,4,3,-1,881452763,881452816,53,684,161,3.5844155844155843
106,3,5,2,881452816,881452998,182,161,216,3.8454545454545452
106,5,4,-1,881452998,881453065,67,216,213,3.943396226415094
106,4,3,-1,881453065,881453097,32,213,88,3.433734939759036
106,3,3,0,881453097,881453290,193,88,692,3.56
106,3,4,1,881453290,881453318,28,692,59,4.0
106,4,4,0,881453318,881453355,37,59,923,4.142857142857143
106,4,3,-1,881453355,881453413,58,923,463,3.6818181818181817
106,3,4,1,881453413,881453481,68,463,584,3.5238095238095237
106,4,3,-1,881453481,883876146,2422665,584,274,3.5609756097560976
106,3,4,1,883876146,883876206,60,274,285,4.181818181818182
106,4,4,0,883876206,883876572,366,285,9,3.8878504672897196
106,4,2,-2,883876572,883876680,108,9,280,3.103448275862069
106,2,4,2,883876680,883876833,153,280,1115,3.3846153846153846
106,4,2,-2,883876833,883876872,39,1115,828,3.0
106,2,4,2,883876872,883876961,89,828,107,3.45
106,4,4,0,883876961,883877094,133,107,244,2.9411764705882355
106,4,4,0,883877094,883877219,125,244,275,4.087912087912088
312,5,5,0,891698174,891698254,80,484,520,4.136363636363637
312,5,5,0,891698254,891698300,46,520,641,4.5
312,5,5,0,891698300,891698334,34,641,488,4.277777777777778
312,5,3,-2,891698334,891698365,31,488,1021,3.8666666666666667
312,3,5,2,891698365,891698391,26,1021,166,4.0
312,5,5,0,891698391,891698424,33,166,543,4.166666666666667
312,5,5,0,891698424,891698454,30,543,613,4.1
312,5,5,0,891698454,891698485,31,613,657,4.341463414634147
312,5,5,0,891698485,891698516,31,657,537,3.5
312,5,4,-1,891698516,891698553,37,537,1124,3.75
312,4,5,1,891698553,891698580,27,1124,638,3.923076923076923
312,5,4,-1,891698580,891698613,33,638,100,4.0162162162162165
312,4,1,-3,891698613,891698696,83,100,265,3.710144927536232
312,1,5,4,891698696,891698726,30,265,519,4.291666666666667
312,5,5,0,891698726,891698764,38,519,611,4.384615384615385
312,5,3,-2,891698764,891698793,29,611,188,3.625
312,3,4,1,891698793,891698865,72,188,614,3.727272727272727
312,4,5,1,891698865,891698921,56,614,836,4.142857142857143
312,5,5,0,891698921,891698987,66,836,521,3.787878787878788
312,5,4,-1,891698987,891699010,23,521,276,3.6036036036036037
312,4,5,1,891699010,891699068,58,276,648,3.9545454545454546
312,5,5,0,891699068,891699121,53,648,529,4.142857142857143
312,5,5,0,891699121,891699182,61,529,671,3.4285714285714284
312,5,3,-2,891699182,891699295,113,671,676,3.3142857142857145
312,3,4,1,891699295,891699296,1,676,499,4.0
312,4,3,-1,891699296,891699345,49,499,173,4.1441441441441444
312,3,5,2,891699345,891699372,27,173,608,4.285714285714286
312,5,5,0,891699372,891699398,26,608,70,3.5833333333333335
312,5,4,-1,891699398,891699426,28,70,692,3.56
312,4,5,1,891699426,891699455,29,692,10,3.85
312,5,5,0,891699455,891699490,35,10,509,3.7058823529411766
312,5,3,-2,891699490,891699491,1,509,186,3.905263157894737
312,3,3,0,891699491,891699510,19,186,238,3.888888888888889
312,3,5,2,891699510,891699538,28,238,855,3.590909090909091
312,5,5,0,891699538,891699568,30,855,498,4.290909090909091
312,5,4,-1,891699568,891699599,31,498,71,3.6575342465753424
312,4,5,1,891699599,891699655,56,71,487,4.043478260869565
312,5,4,-1,891699655,891699677,22,487,172,4.225225225225225
312,4,5,1,891699677,891699702,25,172,131,3.731707317073171
175,3,4,1,877107255,877107338,83,176,187,4.215189873417722
175,4,5,1,877107338,877107390,52,187,98,4.240875912408759
175,5,3,-2,877107390,877107500,110,98,869,3.0
175,3,5,2,877107500,877107552,52,869,64,4.373737373737374
175,5,3,-2,877107552,877107712,160,64,132,3.929411764705882
175,3,3,0,877107712,877107836,124,132,660,3.71875
175,3,4,1,877107836,877107942,106,660,71,3.6575342465753424
175,4,3,-1,877107942,877108015,73,71,566,3.543859649122807
175,3,4,1,877108015,877108051,36,566,136,3.764705882352941
175,4,5,1,877108051,877108098,47,136,496,4.094594594594595
175,5,4,-1,877108098,877108146,48,496,12,4.358974358974359
153,2,2,0,881370900,881370935,35,323,325,2.625
153,2,2,0,881370935,881371032,97,325,216,3.8454545454545452
153,2,5,3,881371032,881371059,27,216,357,4.063291139240507
153,5,5,0,881371059,881371140,81,357,56,4.051724137931035
153,5,5,0,881371140,881371336,196,56,258,3.7547169811320753
220,3,3,0,881197771,881197948,177,258,995,3.0
220,3,4,1,881197948,881198014,66,995,682,3.0476190476190474
220,4,3,-1,881198014,881198246,232,682,332,3.6511627906976742
220,3,1,-2,881198246,881198435,189,332,325,2.625
143,2,4,2,888407586,888407622,36,286,307,3.6031746031746033
143,4,3,-1,888407622,888407656,34,307,1038,2.6
143,3,5,2,888407656,888407708,52,1038,333,3.546666666666667
143,5,5,0,888407708,888407741,33,333,325,2.625
199,1,1,0,883782485,883782509,24,892,324,3.2291666666666665
199,1,4,3,883782509,883782557,48,324,313,4.323076923076923
199,4,1,-3,883782557,883782583,26,313,259,2.492063492063492
199,1,2,1,883782583,883782636,53,259,322,3.0476190476190474
199,2,1,-1,883782636,883782655,19,322,988,2.5555555555555554
199,1,5,4,883782655,883782716,61,988,408,4.4772727272727275
199,5,3,-2,883782716,883782807,91,408,813,4.055555555555555
199,3,5,2,883782807,883782853,46,813,9,3.8878504672897196
199,5,4,-1,883782853,883782854,1,9,221,3.6923076923076925
199,4,4,0,883782854,883782879,25,221,276,3.6036036036036037
199,4,4,0,883782879,883782899,20,276,508,3.6923076923076925
199,4,5,1,883782899,883782918,19,508,475,3.956043956043956
199,5,3,-2,883782918,883782934,16,475,1326,3.6666666666666665
199,3,1,-2,883782934,883782952,18,1326,1354,1.0
199,1,2,1,883782952,883783005,53,1354,405,3.25
202,3,4,1,879727058,879727059,1,204,96,3.9130434782608696
202,4,3,-1,879727059,879727153,94,96,283,3.901639344262295
277,3,3,0,879543377,879543421,44,471,1129,3.4444444444444446
277,3,3,0,879543421,879543454,33,1129,1012,3.2916666666666665
277,3,4,1,879543454,879543487,33,1012,508,3.6923076923076925
277,4,4,0,879543487,879543528,41,508,844,3.8333333333333335
277,4,3,-1,879543528,879543621,93,844,1008,3.5
277,3,3,0,879543621,879543652,31,1008,50,4.306532663316583
277,3,4,1,879543652,879543653,1,50,129,3.744186046511628
277,4,4,0,879543653,879543697,44,129,628,3.573529411764706
277,4,3,-1,879543697,879543768,71,628,151,3.6544117647058822
277,3,4,1,879543768,879543801,33,151,619,3.4782608695652173
277,4,4,0,879543801,879543845,44,619,742,3.5555555555555554
277,4,2,-2,879543845,879543879,34,742,473,2.9166666666666665
277,2,4,2,879543879,879543902,23,473,274,3.5609756097560976
277,4,3,-1,879543902,879543931,29,274,762,3.3962264150943398
277,3,4,1,879543931,879543972,41,762,93,3.5641025641025643
277,4,5,1,879543972,879544145,173,93,286,3.442857142857143
277,5,4,-1,879544145,879544146,1,286,221,3.6923076923076925
277,4,4,0,879544146,879544201,55,221,302,4.133333333333334
206,4,2,-2,888179602,888179647,45,258,309,2.3333333333333335
206,2,2,0,888179647,888179694,47,309,690,3.260869565217391
206,2,1,-1,888179694,888179772,78,690,245,3.056179775280899
206,1,1,0,888179772,888179788,16,245,343,3.0
206,1,1,0,888179788,888179913,125,343,990,2.769230769230769
206,1,1,0,888179913,888179928,15,990,336,2.4
206,1,1,0,888179928,888179948,20,336,314,1.0
206,1,1,0,888179948,888179980,32,314,1430,1.0
206,1,5,4,888179980,888179981,1,1430,346,3.5128205128205128
206,5,2,-3,888179981,888180049,68,346,891,2.0
206,2,3,1,888180049,888180082,33,891,340,3.7419354838709675
206,3,5,2,888180082,888180227,145,340,302,4.133333333333334
76,3,5,2,875027292,875027355,63,264,23,3.9047619047619047
76,5,5,0,875027355,875027442,87,23,192,4.090909090909091
76,5,4,-1,875027442,875027507,65,192,89,3.9615384615384617
76,4,5,1,875027507,875027601,94,89,276,3.6036036036036037
76,5,3,-2,875027601,875027907,306,276,1006,2.7777777777777777
76,3,3,0,875027907,875027945,38,1006,919,4.0
76,3,4,1,875027945,875027981,36,919,70,3.5833333333333335
76,4,4,0,875027981,875028123,142,70,61,4.190476190476191
76,4,3,-1,875028123,875028143,20,61,960,3.0
76,3,5,2,875028143,875028165,22,960,6,4.333333333333333
76,5,5,0,875028165,875028563,398,6,197,4.112676056338028
76,5,3,-2,875028563,875028682,119,197,421,3.462962962962963
76,3,5,2,875028682,875028792,110,421,135,3.7974683544303796
76,5,4,-1,875028792,875028853,61,135,175,3.8354430379746836
76,4,5,1,875028853,875028880,27,175,150,3.803921568627451
76,5,4,-1,875028880,875312109,283229,150,1007,4.117647058823529
76,4,4,0,875312109,875312133,24,1007,7,3.76056338028169
76,4,4,0,875312133,879117673,3805540,7,293,3.630434782608696
76,4,3,-1,879117673,879576256,458583,293,1019,3.7777777777777777
76,3,5,2,879576256,882129432,2553176,1019,517,3.625
76,5,4,-1,882129432,882129456,24,517,514,4.033333333333333
76,4,3,-1,882129456,882606060,476604,514,12,4.358974358974359
76,3,5,2,882606060,882606080,20,12,172,4.225225225225225
76,5,3,-2,882606080,882606108,28,172,156,4.017857142857143
76,3,3,0,882606108,882606147,39,156,603,4.315789473684211
76,3,3,0,882606147,882606166,19,603,318,4.5046728971962615
76,3,5,2,882606166,882606216,50,318,200,3.8157894736842106
76,5,3,-2,882606216,882606243,27,200,42,3.893617021276596
76,3,5,2,882606243,882606305,62,42,513,4.526315789473684
76,5,4,-1,882606305,882606323,18,513,811,4.166666666666667
76,4,4,0,882606323,882606392,69,811,182,3.842857142857143
76,4,4,0,882606392,882606471,79,182,806,3.6666666666666665
76,4,4,0,882606471,882606572,101,806,93,3.5641025641025643
76,4,3,-1,882606572,882606623,51,93,1159,4.0
76,3,2,-1,882606623,882606768,145,1159,628,3.573529411764706
76,2,4,2,882606768,882606789,21,628,955,3.2666666666666666
76,4,1,-3,882606789,882607018,229,955,1157,3.142857142857143
76,1,2,1,882607018,882607536,518,1157,24,3.3728813559322033
314,5,5,0,877885887,877886029,142,294,332,3.6511627906976742
314,5,3,-2,877886029,877886099,70,332,938,2.5555555555555554
314,3,4,1,877886099,877886221,122,938,1048,2.857142857142857
314,4,4,0,877886221,877886279,58,1048,220,3.433333333333333
314,4,5,1,877886279,877886317,38,220,1,3.902439024390244
314,5,3,-2,877886317,877886375,58,1,477,3.1666666666666665
314,3,5,2,877886375,877886412,37,477,125,3.5555555555555554
314,5,5,0,877886412,877886413,1,125,257,3.7154471544715446
314,5,1,-4,877886413,877886443,30,257,743,1.9545454545454546
314,1,5,4,877886443,877886483,40,743,15,3.725663716814159
314,5,4,-1,877886483,877886584,101,15,147,3.3142857142857145
314,4,3,-1,877886584,877886641,57,147,756,2.6885245901639343
314,3,3,0,877886641,877886753,112,756,25,3.3185840707964602
314,3,4,1,877886753,877886788,35,25,546,2.9789473684210526
314,4,3,-1,877886788,877886816,28,546,764,3.1176470588235294
314,3,5,2,877886816,877886862,46,764,282,3.610526315789474
314,5,5,0,877886862,877886921,59,282,476,3.1216216216216215
314,5,1,-4,877886921,877886944,23,476,1054,2.5454545454545454
314,1,3,2,877886944,877886971,27,1054,846,3.1052631578947367
314,3,5,2,877886971,877887002,31,846,591,3.7169811320754715
314,5,2,-3,877887002,877887035,33,591,1057,2.7142857142857144
314,2,4,2,877887035,877887065,30,1057,597,3.2771084337349397
314,4,3,-1,877887065,877887094,29,597,120,2.3421052631578947
314,3,4,1,877887094,877887155,61,120,934,3.0294117647058822
314,4,3,-1,877887155,877887212,57,934,620,3.0
314,3,4,1,877887212,877887292,80,620,105,2.6176470588235294
314,4,4,0,877887292,877887316,24,105,932,2.5
314,4,3,-1,877887316,877887388,72,932,406,2.5294117647058822
314,3,4,1,877887388,877887469,81,406,1152,3.4375
314,4,4,0,877887469,877887605,136,1152,655,3.7857142857142856
314,4,3,-1,877887605,877887642,37,655,433,3.8035714285714284
314,3,4,1,877887642,877887763,121,433,578,3.066666666666667
314,4,5,1,877887763,877887837,74,578,11,3.8904109589041096
314,5,4,-1,877887837,877888060,223,11,496,4.094594594594595
314,4,2,-2,877888060,877888117,57,496,724,3.64
314,2,5,3,877888117,877888168,51,724,378,3.6904761904761907
314,5,1,-4,877888168,877888212,44,378,772,3.3333333333333335
314,1,5,4,877888212,877888391,179,772,568,3.5853658536585367
314,5,4,-1,877888391,877888445,54,568,1041,3.3333333333333335
314,4,5,1,877888445,877888527,82,1041,946,3.1153846153846154
314,5,4,-1,877888527,877888610,83,946,501,3.289473684210526
314,4,3,-1,877888610,877888645,35,501,775,2.4285714285714284
314,3,3,0,877888645,877888722,77,775,216,3.8454545454545452
314,3,5,2,877888722,877888723,1,216,672,2.7222222222222223
314,5,3,-2,877888723,877888796,73,672,710,3.41025641025641
314,3,5,2,877888796,877888855,59,710,735,3.58
314,5,4,-1,877888855,877888892,37,735,54,3.3714285714285714
314,4,4,0,877888892,877889103,211,54,1469,3.4
314,4,4,0,877889103,877889133,30,1469,393,3.5125
314,4,4,0,877889133,877889163,30,393,812,3.375
314,4,4,0,877889163,877889205,42,812,73,3.588235294117647
314,4,3,-1,877889205,877889275,70,73,144,3.9545454545454546
314,3,4,1,877889275,877889311,36,144,609,3.7058823529411766
314,4,1,-3,877889311,877889359,48,609,173,4.1441441441441444
314,1,4,3,877889359,877889398,39,173,791,3.0
314,4,4,0,877889398,877889480,82,791,409,2.9615384615384617
314,4,4,0,877889480,877889724,244,409,5,3.1481481481481484
314,4,4,0,877889724,877889770,46,5,367,3.4242424242424243
314,4,4,0,877889770,877889834,64,367,795,2.4
314,4,5,1,877889834,877889861,27,795,739,3.391304347826087
314,5,3,-2,877889861,877889971,110,739,941,3.5
314,3,5,2,877889971,877890261,290,941,768,3.238095238095238
314,5,4,-1,877890261,877890300,39,768,542,2.888888888888889
314,4,2,-2,877890300,877890381,81,542,585,2.5384615384615383
314,2,3,1,877890381,877890407,26,585,540,2.4615384615384617
314,3,4,1,877890407,877890428,21,540,949,3.392857142857143
314,4,1,-3,877890428,877890531,103,949,70,3.5833333333333335
314,1,4,3,877890531,877890644,113,70,132,3.929411764705882
314,4,4,0,877890644,877890734,90,132,1297,3.0
314,4,3,-1,877890734,877890769,35,1297,401,2.6774193548387095
314,3,3,0,877890769,877890857,88,401,1074,2.857142857142857
314,3,3,0,877890857,877890891,34,1074,1503,3.25
314,3,5,2,877890891,877890927,36,1503,623,3.0454545454545454
314,5,4,-1,877890927,877890960,33,623,562,3.2941176470588234
314,4,3,-1,877890960,877890982,22,562,377,1.75
314,3,4,1,877890982,877891386,404,377,94,2.8823529411764706
314,4,4,0,877891386,877891426,40,94,1518,3.142857142857143
314,4,3,-1,877891426,877891465,39,1518,365,2.95
314,3,5,2,877891465,877891490,25,365,1053,3.3846153846153846
314,5,2,-3,877891490,877891518,28,1053,796,2.923076923076923
314,2,3,1,877891518,877891575,57,796,693,3.6285714285714286
314,3,2,-1,877891575,877891603,28,693,1029,1.5
314,2,4,2,877891603,877891637,34,1029,68,3.5714285714285716
314,4,3,-1,877891637,877892052,415,68,412,2.272727272727273
314,3,4,1,877892052,877892181,129,412,1519,4.0
314,4,4,0,877892181,877892214,33,1519,468,3.380952380952381
314,4,4,0,877892214,877892430,216,468,1471,2.75
314,4,5,1,877892430,877892461,31,1471,820,3.0444444444444443
314,5,4,-1,877892461,877892488,27,820,983,2.5
314,4,2,-2,877892488,877892566,78,983,1165,1.8
136,5,4,-1,882693338,882693339,1,100,475,3.956043956043956
136,4,4,0,882693339,882693371,32,475,847,3.7333333333333334
136,4,5,1,882693371,882693404,33,847,127,4.162790697674419
136,5,5,0,882693404,882693429,25,127,9,3.8878504672897196
136,5,5,0,882693429,882693489,60,9,276,3.6036036036036037
136,5,4,-1,882693489,882693529,40,276,19,3.9615384615384617
136,4,4,0,882693529,882693569,40,19,298,3.779220779220779
136,4,4,0,882693569,882693597,28,298,237,3.7315436241610738
136,4,5,1,882693597,882693723,126,237,116,3.6666666666666665
136,5,4,-1,882693723,882848820,155097,116,223,4.108695652173913
136,4,4,0,882848820,882848866,46,223,747,3.5526315789473686
136,4,5,1,882848866,882848925,59,747,525,4.0
179,5,5,0,892151174,892151202,28,914,315,4.15
179,5,1,-4,892151202,892151331,129,315,321,3.0172413793103448
179,1,1,0,892151331,892151366,35,321,339,2.7058823529411766
179,1,1,0,892151366,892151459,93,339,1234,1.6666666666666667
179,1,3,2,892151459,892151489,30,1234,346,3.5128205128205128
179,3,1,-2,892151489,892151565,76,346,345,3.4782608695652173
4,5,3,-2,892001445,892001537,92,300,328,3.4895833333333335
4,3,5,2,892001537,892002353,816,328,354,3.6923076923076925
4,5,3,-2,892002353,892003459,1106,354,356,3.2
4,3,4,1,892003459,892003525,66,356,357,4.063291139240507
4,4,5,1,892003525,892003526,1,357,50,4.306532663316583
4,5,5,0,892003526,892004409,883,50,294,3.1052631578947367
4,5,4,-1,892004409,892004520,111,294,11,3.8904109589041096
304,3,3,0,884966697,884967017,320,310,895,3.142857142857143
304,3,1,-2,884967017,884967253,236,895,259,2.492063492063492
304,1,3,2,884967253,884967391,138,259,243,2.357142857142857
304,3,3,0,884967391,884967520,129,243,893,2.625
304,3,3,0,884967520,884968078,558,893,742,3.5555555555555554
304,3,3,0,884968078,884968264,186,742,111,3.5106382978723403
304,3,4,1,884968264,884968415,151,111,294,3.1052631578947367
3,3,3,0,889236961,889236983,22,268,303,3.75
3,3,3,0,889236983,889237004,21,303,354,3.6923076923076925
3,3,2,-1,889237004,889237026,22,354,319,3.0408163265306123
3,2,2,0,889237026,889237055,29,319,352,1.8333333333333333
3,2,3,1,889237055,889237076,21,352,350,3.2
3,3,3,0,889237076,889237122,46,350,334,3.4210526315789473
3,3,3,0,889237122,889237141,19,334,339,2.7058823529411766
3,3,4,1,889237141,889237174,33,339,342,2.64
3,4,1,-3,889237174,889237198,24,342,336,2.4
3,1,3,2,889237198,889237199,1,336,299,3.0
3,3,2,-1,889237199,889237224,25,299,326,3.262295081967213
3,2,2,0,889237224,889237247,23,326,324,3.2291666666666665
3,2,1,-1,889237247,889237269,22,324,335,2.5
3,1,1,0,889237269,889237297,28,335,325,2.625
3,1,3,2,889237297,889237315,18,325,351,2.4444444444444446
3,3,4,1,889237315,889237455,140,351,260,2.4716981132075473
227,4,5,1,879035158,879035205,47,126,13,3.5454545454545454
227,5,3,-2,879035205,879035206,1,13,273,3.5238095238095237
227,3,5,2,879035206,879035251,45,273,7,3.76056338028169
227,5,5,0,879035251,879035289,38,7,137,3.9545454545454546
227,5,4,-1,879035289,879035347,58,137,285,4.181818181818182
227,4,1,-3,879035347,879035387,40,285,748,3.1043478260869564
227,1,3,2,879035387,879035431,44,748,9,3.8878504672897196
227,3,4,1,879035431,879035463,32,9,14,4.101694915254237
227,4,4,0,879035463,879035464,1,14,1017,3.0
227,4,2,-2,879035464,879035493,29,1017,117,3.689189189189189
227,2,4,2,879035493,879035535,42,117,221,3.6923076923076925
227,4,2,-2,879035535,879035599,64,221,823,2.75
227,2,3,1,879035599,879035658,59,823,756,2.6885245901639343
227,3,4,1,879035658,879035704,46,756,287,3.4516129032258065
227,4,4,0,879035704,879035725,21,287,15,3.725663716814159
227,4,3,-1,879035725,879035775,50,15,106,2.8125
227,3,2,-1,879035775,879035874,99,106,934,3.0294117647058822
227,2,4,2,879035874,879035897,23,934,411,2.911764705882353
227,4,1,-3,879035897,879035934,37,411,240,3.0350877192982457
227,1,2,1,879035934,879035963,29,240,460,3.0
227,2,4,2,879035963,879036009,46,460,1008,3.5
227,4,3,-1,879036009,881518461,2482452,1008,322,3.0476190476190474
252,5,4,-1,891455329,891456797,1468,268,277,3.6
252,4,4,0,891456797,891456876,79,277,129,3.744186046511628
252,4,3,-1,891456876,891456877,1,129,290,3.108108108108108
212,5,4,-1,879303638,879303795,157,317,427,4.2025316455696204
212,4,4,0,879303795,879303830,35,427,86,3.869565217391304
212,4,5,1,879303830,879303831,1,86,199,4.191489361702128
212,5,2,-3,879303831,879303863,32,199,863,3.727272727272727
212,2,5,3,879303863,879303892,29,863,527,3.823529411764706
212,5,5,0,879303892,879303928,36,527,318,4.5046728971962615
212,5,5,0,879303928,879303929,1,318,382,3.764705882352941
212,5,5,0,879303929,879303950,21,382,528,4.241379310344827
212,5,1,-4,879303950,879303974,24,528,180,3.9473684210526314
212,1,4,3,879303974,879304010,36,180,423,3.7016129032258065
212,4,4,0,879304010,879304051,41,423,511,4.096153846153846
310,5,5,0,879435664,879435764,100,304,1022,3.727272727272727
310,5,3,-2,879435764,879436062,298,1022,222,3.578125
310,3,4,1,879436062,879436104,42,222,181,3.98974358974359
310,4,4,0,879436104,879436137,33,181,536,3.3333333333333335
310,4,5,1,879436137,879436177,40,536,50,4.306532663316583
310,5,4,-1,879436177,879436242,65,50,24,3.3728813559322033
310,4,5,1,879436242,879436268,26,24,14,4.101694915254237
310,5,4,-1,879436268,879436292,24,14,740,3.423076923076923
310,4,5,1,879436292,879436467,175,740,1142,4.0476190476190474
310,5,3,-2,879436467,879436534,67,1142,274,3.5609756097560976
310,3,5,2,879436534,879436576,42,274,257,3.7154471544715446
310,5,1,-4,879436576,879436712,136,257,294,3.1052631578947367
35,5,3,-2,875458970,875459017,47,300,327,3.5076923076923077
35,3,3,0,875459017,875459046,29,327,328,3.4895833333333335
35,3,4,1,875459046,875459099,53,328,680,2.8333333333333335
35,4,2,-2,875459099,875459127,28,680,881,2.769230769230769
35,2,2,0,875459127,875459166,39,881,242,3.5217391304347827
147,4,5,1,885593845,885593942,97,302,304,3.5306122448979593
147,5,4,-1,885593942,885593965,23,304,340,3.7419354838709675
147,4,4,0,885593965,885593997,32,340,305,3.5789473684210527
147,4,5,1,885593997,885594015,18,305,904,4.125
147,5,4,-1,885594015,885594040,25,904,345,3.4782608695652173
147,4,5,1,885594040,885594204,164,345,301,3.2465753424657535
105,5,3,-2,889214245,889214268,23,270,333,3.546666666666667
105,3,4,1,889214268,889214284,16,333,272,4.2
105,4,3,-1,889214284,889214334,50,272,347,3.59375
105,3,2,-1,889214334,889214381,47,347,751,3.3896103896103895
105,2,2,0,889214381,889214491,110,751,264,2.65
105,2,2,0,889214491,889214524,33,264,343,3.0
34,4,5,1,888602618,888602742,124,991,332,3.6511627906976742
34,5,5,0,888602742,888602808,66,332,329,3.25
34,5,5,0,888602808,888602842,34,329,898,3.0869565217391304
34,5,4,-1,888602842,888602923,81,898,245,3.056179775280899
34,4,1,-3,888602923,888602950,27,245,289,2.988888888888889
34,1,5,4,888602950,888603123,173,289,899,5.0
71,2,4,2,877319117,877319197,80,289,100,4.0162162162162165
71,4,4,0,877319197,877319375,178,100,276,3.6036036036036037
71,4,3,-1,877319375,877319414,39,276,285,4.181818181818182
71,3,1,-2,877319414,877319446,32,285,151,3.6544117647058822
71,1,3,2,877319446,877319610,164,151,154,3.6031746031746033
71,3,3,0,877319610,880864124,3544514,154,6,4.333333333333333
71,3,4,1,880864124,885016536,4152412,6,64,4.373737373737374
71,4,3,-1,885016536,885016614,78,64,134,4.174603174603175
71,3,3,0,885016614,885016784,170,134,50,4.306532663316583
71,3,4,1,885016784,885016882,98,50,175,3.8354430379746836
71,4,5,1,885016882,885016961,79,175,65,3.511111111111111
71,5,3,-2,885016961,885016990,29,65,282,3.610526315789474
51,4,3,-1,883498655,883498685,30,132,184,3.393939393939394
51,3,3,0,883498685,883498728,43,184,603,4.315789473684211
51,3,1,-2,883498728,883498756,28,603,705,3.7857142857142856
51,1,1,0,883498756,883498790,34,705,485,3.717948717948718
51,1,4,3,883498790,883498844,54,485,210,3.921259842519685
51,4,5,1,883498844,883498894,50,210,144,3.9545454545454546
51,5,5,0,883498894,883498936,42,144,172,4.225225225225225
51,5,3,-2,883498936,883498937,1,172,679,3.2432432432432434
204,3,4,1,892388900,892388935,35,300,316,4.285714285714286
204,4,2,-2,892388935,892388976,41,316,258,3.7547169811320753
204,2,3,1,892388976,892389046,70,258,286,3.442857142857143
204,3,1,-2,892389046,892389073,27,286,310,3.6666666666666665
204,1,4,3,892389073,892389137,64,310,262,3.5217391304347827
204,4,5,1,892389137,892389195,58,262,340,3.7419354838709675
204,5,4,-1,892389195,892389328,133,340,301,3.2465753424657535
204,4,3,-1,892389328,892391947,2619,301,322,3.0476190476190474
204,3,3,0,892391947,892391980,33,322,245,3.056179775280899
204,3,1,-2,892391980,892392030,50,245,748,3.1043478260869564
204,1,5,4,892392030,892392078,48,748,1296,3.2222222222222223
204,5,4,-1,892392078,892513906,121828,1296,191,4.168674698795181
204,4,5,1,892513906,892514010,104,191,297,4.142857142857143
315,2,4,2,879799327,879799390,63,301,523,4.159090909090909
315,4,3,-1,879799390,879799457,67,523,651,3.8627450980392157
315,3,4,1,879799457,879799486,29,651,178,4.378378378378378
315,4,4,0,879799486,879799526,40,178,46,3.6666666666666665
315,4,3,-1,879799526,879799546,20,46,271,3.3134328358208953
315,3,4,1,879799546,879799583,37,271,327,3.5076923076923077
315,4,1,-3,879799583,879821003,21420,327,17,3.032258064516129
315,1,4,3,879821003,879821036,33,17,475,3.956043956043956
315,4,4,0,879821036,879821037,1,475,211,3.958904109589041
315,4,4,0,879821037,879821120,83,211,428,3.744186046511628
315,4,4,0,879821120,879821158,38,428,13,3.5454545454545454
315,4,4,0,879821158,879821193,35,13,98,4.240875912408759
315,4,3,-1,879821193,879821194,1,98,203,3.826923076923077
315,3,4,1,879821194,879821267,73,203,673,3.393939393939394
315,4,3,-1,879821267,879821300,33,673,31,3.642857142857143
315,3,3,0,879821300,879821348,48,31,770,3.25
315,3,1,-2,879821348,879821349,1,770,466,3.5
31,5,4,-1,881547766,881547788,22,262,319,3.0408163265306123
31,4,4,0,881547788,881547814,26,319,299,3.0
31,4,2,-2,881547814,881547834,20,299,682,3.0476190476190474
31,2,4,2,881547834,881547854,20,682,271,3.3134328358208953
31,4,2,-2,881547854,881547877,23,271,886,2.857142857142857
31,2,4,2,881547877,881547938,61,886,875,2.736842105263158
31,4,5,1,881547938,881548030,92,875,32,3.7222222222222223
31,5,4,-1,881548030,881548054,24,32,192,4.090909090909091
31,4,2,-2,881548054,881548082,28,192,79,3.956989247311828
31,2,5,3,881548082,881548110,28,79,705,3.7857142857142856
316,4,1,-3,880853072,880853152,80,306,988,2.5555555555555554
316,1,3,2,880853152,880853193,41,988,304,3.5306122448979593
316,3,2,-1,880853193,880853219,26,304,289,2.988888888888889
316,2,1,-1,880853219,880853310,91,289,678,2.8181818181818183
316,1,4,3,880853310,880853485,175,678,707,3.909090909090909
316,4,5,1,880853485,880853516,31,707,213,3.943396226415094
316,5,2,-3,880853516,880853548,32,213,187,4.215189873417722
316,2,3,1,880853548,880853598,50,187,199,4.191489361702128
316,3,3,0,880853598,880853599,1,199,168,4.0476190476190474
316,3,4,1,880853599,880853654,55,168,515,4.202898550724638
316,4,5,1,880853654,880853743,89,515,98,4.240875912408759
316,5,5,0,880853743,880853774,31,98,190,4.233333333333333
316,5,4,-1,880853774,880853775,1,190,730,3.8
316,4,4,0,880853775,880853810,35,730,483,4.475609756097561
316,4,4,0,880853810,880853849,39,483,223,4.108695652173913
316,4,3,-1,880853849,880853881,32,223,69,3.8015873015873014
316,3,4,1,880853881,880853953,72,69,1084,4.0
316,4,4,0,880853953,880853992,39,1084,83,4.204081632653061
316,4,5,1,880853992,880854022,30,83,923,4.142857142857143
316,5,4,-1,880854022,880854049,27,923,357,4.063291139240507
316,4,2,-2,880854049,880854083,34,357,673,3.393939393939394
316,2,1,-1,880854083,880854197,114,673,89,3.9615384615384617
316,1,4,3,880854197,880854227,30,89,197,4.112676056338028
316,4,5,1,880854227,880854267,40,197,463,3.6818181818181817
316,5,3,-2,880854267,880854395,128,463,265,3.710144927536232
316,3,1,-2,880854395,880854472,77,265,71,3.6575342465753424
316,1,1,0,880854472,880854473,1,71,234,3.7674418604651163
316,1,5,4,880854473,880854500,27,234,1039,3.9583333333333335
316,5,5,0,880854500,880854539,39,1039,19,3.9615384615384617
103,4,3,-1,880415847,880415892,45,24,257,3.7154471544715446
103,3,4,1,880415892,880415918,26,257,250,3.4698795180722892
103,4,4,0,880415918,880416313,395,250,117,3.689189189189189
103,4,4,0,880416313,880416331,18,117,127,4.162790697674419
103,4,5,1,880416331,880416423,92,127,255,3.2027027027027026
103,5,3,-2,880416423,880416424,1,255,405,3.25
103,3,4,1,880416424,880416515,91,405,294,3.1052631578947367
103,4,5,1,880416515,880416602,87,294,56,4.051724137931035
103,5,4,-1,880416602,880416704,102,56,301,3.2465753424657535
103,4,5,1,880416704,880416864,160,301,50,4.306532663316583
103,5,4,-1,880416864,880416921,57,50,471,3.5714285714285716
103,4,2,-2,880416921,880420020,3099,471,252,2.911392405063291
103,2,1,-1,880420020,880420178,158,252,1089,2.1363636363636362
103,1,3,2,880420178,880420353,175,1089,234,3.7674418604651163
103,3,3,0,880420353,880420585,232,234,69,3.8015873015873014
318,4,4,0,884469971,884470034,63,750,301,3.2465753424657535
318,4,4,0,884470034,884470115,81,301,340,3.7419354838709675
318,4,4,0,884470115,884470149,34,340,326,3.262295081967213
318,4,4,0,884470149,884470193,44,326,312,3.0
318,4,4,0,884470193,884470237,44,312,898,3.0869565217391304
318,4,5,1,884470237,884470294,57,898,315,4.15
318,5,3,-2,884470294,884470391,97,315,892,2.9615384615384617
318,3,3,0,884470391,884470682,291,892,289,2.988888888888889
318,3,4,1,884470682,884470718,36,289,275,4.087912087912088
318,4,3,-1,884470718,884470775,57,275,284,3.1547619047619047
318,3,5,2,884470775,884470896,121,284,100,4.0162162162162165
318,5,4,-1,884470896,884470944,48,100,285,4.181818181818182
318,4,4,0,884470944,884471030,86,285,14,4.101694915254237
318,4,4,0,884471030,884471076,46,14,1012,3.2916666666666665
318,4,2,-2,884471076,884494797,23721,1012,405,3.25
318,2,4,2,884494797,884494861,64,405,458,3.0588235294117645
318,4,3,-1,884494861,884494897,36,458,763,3.347826086956522
318,3,2,-1,884494897,884494919,22,763,1014,3.1
318,2,4,2,884494919,884494976,57,1014,866,3.3962264150943398
318,4,4,0,884494976,884495001,25,866,1048,2.857142857142857
318,4,2,-2,884495001,884495032,31,1048,864,3.2142857142857144
318,2,1,-1,884495032,884495052,20,864,121,3.521212121212121
318,1,2,1,884495052,884495091,39,121,1023,2.5714285714285716
318,2,4,2,884495091,884495132,41,1023,24,3.3728813559322033
318,4,4,0,884495132,884495164,32,24,476,3.1216216216216215
318,4,4,0,884495164,884495382,218,476,934,3.0294117647058822
318,4,5,1,884495382,884495534,152,934,648,3.9545454545454546
318,5,3,-2,884495534,884495561,27,648,56,4.051724137931035
318,3,4,1,884495561,884495590,29,56,174,4.253521126760563
318,4,4,0,884495590,884495616,26,174,8,3.903225806451613
318,4,5,1,884495616,884495639,23,8,134,4.174603174603175
318,5,4,-1,884495639,884495664,25,134,208,3.8125
318,4,2,-2,884495664,884495696,32,208,50,4.306532663316583
318,2,4,2,884495696,884495742,46,50,187,4.215189873417722
318,4,4,0,884495742,884495795,53,187,480,4.283018867924528
318,4,5,1,884495795,884495817,22,480,509,3.7058823529411766
318,5,4,-1,884495817,884495868,51,509,132,3.929411764705882
318,4,5,1,884495868,884495890,22,132,419,3.8208955223880596
318,5,5,0,884495890,884495921,31,419,485,3.717948717948718
318,5,5,0,884495921,884495944,23,485,143,3.56
318,5,3,-2,884495944,884495973,29,143,1063,3.642857142857143
318,3,4,1,884495973,884496008,35,1063,414,3.3076923076923075
318,4,5,1,884496008,884496030,22,414,197,4.112676056338028
318,5,2,-3,884496030,884496099,69,197,865,2.6666666666666665
318,2,5,3,884496099,884496123,24,865,162,3.4651162790697674
318,5,4,-1,884496123,884496156,33,162,481,3.8421052631578947
318,4,4,0,884496156,884496219,63,481,142,3.1481481481481484
318,4,4,0,884496219,884496243,24,142,58,3.543859649122807
318,4,5,1,884496243,884496267,24,58,732,3.6266666666666665
318,5,3,-2,884496267,884496334,67,732,205,3.717391304347826
318,3,3,0,884496334,884496367,33,205,193,3.883720930232558
318,3,4,1,884496367,884496398,31,193,385,3.6129032258064515
318,4,4,0,884496398,884496432,34,385,133,3.7777777777777777
318,4,4,0,884496432,884496472,40,133,566,3.543859649122807
318,4,3,-1,884496472,884496500,28,566,796,2.923076923076923
318,3,2,-1,884496500,884496524,24,796,514,4.033333333333333
318,2,5,3,884496524,884496525,1,514,610,3.1818181818181817
318,5,4,-1,884496525,884496549,24,610,182,3.842857142857143
318,4,5,1,884496549,884496572,23,182,69,3.8015873015873014
318,5,5,0,884496572,884496596,24,69,527,3.823529411764706
318,5,3,-2,884496596,884496639,43,527,404,3.6578947368421053
318,3,4,1,884496639,884496671,32,404,356,3.2
318,4,4,0,884496671,884496738,67,356,1050,3.6153846153846154
318,4,2,-2,884496738,884496759,21,1050,403,3.298507462686567
318,2,4,2,884496759,884496855,96,403,631,3.581818181818182
318,4,3,-1,884496855,884496984,129,631,618,3.5
318,3,4,1,884496984,884496985,1,618,1044,3.2777777777777777
318,4,4,0,884496985,884497031,46,1044,213,3.943396226415094
318,4,3,-1,884497031,884497078,47,213,77,3.3857142857142857
318,3,3,0,884497078,884497207,129,77,660,3.71875
318,3,2,-1,884497207,884497208,1,660,944,2.75
318,2,4,2,884497208,884497235,27,944,239,3.423076923076923
318,4,4,0,884497235,884497236,1,239,629,3.3333333333333335
318,4,3,-1,884497236,884497257,21,629,49,3.3
318,3,1,-2,884497257,884497318,61,49,229,3.185185185185185
318,1,3,2,884497318,884497359,41,229,238,3.888888888888889
318,3,4,1,884497359,884497402,43,238,503,3.6363636363636362
318,4,4,0,884497402,884497425,23,503,605,3.3333333333333335
318,4,5,1,884497425,884497449,24,605,393,3.5125
318,5,1,-4,884497449,884497516,67,393,381,3.2758620689655173
318,1,4,3,884497516,884497546,30,381,722,2.9642857142857144
318,4,4,0,884497546,884497611,65,722,167,2.8181818181818183
318,4,4,0,884497611,884497632,21,167,378,3.6904761904761907
318,4,3,-1,884497632,884497824,192,378,1521,3.0
318,3,4,1,884497824,884497882,58,1521,40,2.7037037037037037
318,4,2,-2,884497882,884497924,42,40,575,2.619047619047619
318,2,4,2,884497924,884497994,70,575,708,3.3157894736842106
318,4,2,-2,884497994,884498022,28,708,768,3.238095238095238
318,2,4,2,884498022,884498115,93,768,138,2.6
318,4,4,0,884498115,884498141,26,138,540,2.4615384615384617
318,4,4,0,884498141,884498210,69,540,809,2.7058823529411766
318,4,3,-1,884498210,884498314,104,809,376,2.9166666666666665
318,3,3,0,884498314,884498461,147,376,869,3.0
318,3,4,1,884498461,884498540,79,869,72,3.175438596491228
318,4,1,-3,884498540,884498684,144,72,396,2.84
318,1,5,4,884498684,884498709,25,396,158,2.7027027027027026
318,5,2,-3,884498709,884498766,57,158,795,2.4
30,3,4,1,875060334,875060883,549,1013,161,3.5844155844155843
30,4,1,-3,875060883,875061066,183,161,873,2.7586206896551726
30,1,3,2,875061066,875140740,79674,873,252,2.911392405063291
30,3,4,1,875140740,875988548,847808,252,304,3.5306122448979593
30,4,4,0,875988548,875988577,29,304,301,3.2465753424657535
30,4,3,-1,875988577,884310551,8321974,301,751,3.3896103896103895
30,3,4,1,884310551,885941257,1630706,751,257,3.7154471544715446
30,4,4,0,885941257,885941321,64,257,28,3.923076923076923
30,4,4,0,885941321,885941412,91,28,315,4.15
30,4,3,-1,885941412,885941454,42,315,539,2.6666666666666665
30,3,3,0,885941454,885941492,38,539,688,2.111111111111111
120,5,4,-1,889489943,889489973,30,286,50,4.306532663316583
120,4,5,1,889489973,889490124,151,50,258,3.7547169811320753
120,5,3,-2,889490124,889490172,48,258,237,3.7315436241610738
120,3,4,1,889490172,889490244,72,237,15,3.725663716814159
120,4,4,0,889490244,889490290,46,15,924,3.3703703703703702
120,4,4,0,889490290,889490447,157,924,125,3.5555555555555554
120,4,4,0,889490447,889490522,75,125,744,3.5714285714285716
120,4,4,0,889490522,889490549,27,744,742,3.5555555555555554
120,4,4,0,889490549,889490580,31,742,405,3.25
46,3,5,2,883611307,883611352,45,300,286,3.442857142857143
46,5,5,0,883611352,883611374,22,286,333,3.546666666666667
46,5,3,-2,883611374,883611430,56,333,307,3.6031746031746033
46,3,4,1,883611430,883611456,26,307,327,3.5076923076923077
46,4,3,-1,883611456,883611513,57,327,538,3.25
46,3,5,2,883611513,883614645,3132,538,748,3.1043478260869564
46,5,4,-1,883614645,883616134,1489,748,100,4.0162162162162165
46,4,4,0,883616134,883616218,84,100,151,3.6544117647058822
46,4,4,0,883616218,883616254,36,151,50,4.306532663316583
46,4,4,0,883616254,883616284,30,50,125,3.5555555555555554
289,4,4,0,876789373,876789463,90,685,742,3.5555555555555554
289,4,4,0,876789463,876789514,51,742,117,3.689189189189189
289,4,3,-1,876789514,876789581,67,117,15,3.725663716814159
289,3,5,2,876789581,876789843,262,15,1016,3.559322033898305
289,5,4,-1,876789843,876789943,100,1016,849,2.5625
289,4,2,-2,876789943,876790323,380,849,477,3.1666666666666665
289,2,2,0,876790323,876790361,38,477,410,3.0434782608695654
289,2,4,2,876790361,876790464,103,410,455,3.1702127659574466
289,4,2,-2,876790464,876790499,35,455,151,3.6544117647058822
289,2,2,0,876790499,876790576,77,151,405,3.25
289,2,3,1,876790576,876790653,77,405,363,3.0
289,3,1,-2,876790653,876790734,81,363,254,2.7419354838709675
209,4,3,-1,883417491,883417547,56,1137,9,3.8878504672897196
209,3,5,2,883417547,883417589,42,9,50,4.306532663316583
209,5,5,0,883417589,883417613,24,50,285,4.181818181818182
209,5,2,-3,883417613,883417667,54,285,129,3.744186046511628
209,2,4,2,883417667,883417796,129,129,293,3.630434782608696
209,4,5,1,883417796,883417810,14,293,813,4.055555555555555
209,5,2,-3,883417810,883460468,42658,813,304,3.5306122448979593
209,2,5,3,883460468,883460644,176,304,1,3.902439024390244
209,5,4,-1,883460644,883589606,128962,1,242,3.5217391304347827
261,4,4,0,890454087,890454190,103,288,245,3.056179775280899
261,4,4,0,890454190,890454246,56,245,301,3.2465753424657535
261,4,4,0,890454246,890454279,33,301,326,3.262295081967213
261,4,5,1,890454279,890454310,31,326,300,3.6861313868613137
261,5,5,0,890454310,890454351,41,300,875,2.736842105263158
261,5,3,-2,890454351,890454941,590,875,304,3.5306122448979593
261,3,3,0,890454941,890454974,33,304,342,2.64
261,3,5,2,890454974,890455020,46,342,687,2.1481481481481484
261,5,5,0,890455020,890455190,170,687,892,2.9615384615384617
261,5,5,0,890455190,890456142,952,892,410,3.0434782608695654
88,3,5,2,891037201,891037336,135,313,311,3.761904761904762
88,5,4,-1,891037336,891037396,60,311,308,3.6153846153846154
88,4,3,-1,891037396,891037466,70,308,880,2.8421052631578947
88,3,4,1,891037466,891037618,152,880,301,3.2465753424657535
88,4,5,1,891037618,891037708,90,301,354,3.6923076923076925
9,4,4,0,886959344,886959423,79,615,276,3.6036036036036037
9,4,4,0,886959423,886959453,30,276,294,3.1052631578947367
9,4,5,1,886959453,886960055,602,294,298,3.779220779220779
9,5,5,0,886960055,886960056,1,298,483,4.475609756097561
247,4,2,-2,893081395,893081411,16,251,271,3.3134328358208953
321,3,3,0,879438651,879438699,48,127,647,4.142857142857143
321,3,4,1,879438699,879438825,126,647,19,3.9615384615384617
321,4,3,-1,879438825,879438857,32,19,124,4.052631578947368
321,3,4,1,879438857,879438882,25,124,100,4.0162162162162165
321,4,4,0,879438882,879438932,50,100,286,3.442857142857143
321,4,4,0,879438932,879439017,85,286,1331,3.5
321,4,3,-1,879439017,879439179,162,1331,730,3.8
321,3,4,1,879439179,879439562,383,730,190,4.233333333333333
321,4,4,0,879439562,879439620,58,190,419,3.8208955223880596
321,4,3,-1,879439620,879439621,1,419,143,3.56
321,3,4,1,879439621,879439658,37,143,30,3.8181818181818183
321,4,3,-1,879439658,879439679,21,30,182,3.842857142857143
321,3,4,1,879439679,879439706,27,182,514,4.033333333333333
321,4,3,-1,879439706,879439734,28,514,430,4.136363636363637
321,3,4,1,879439734,879439787,53,430,485,3.717948717948718
321,4,3,-1,879439787,879439812,25,485,705,3.7857142857142856
321,3,4,1,879439812,879439832,20,705,357,4.063291139240507
321,4,5,1,879439832,879439860,28,357,435,3.8933333333333335
321,5,4,-1,879439860,879439883,23,435,131,3.731707317073171
321,4,4,0,879439883,879439926,43,131,198,4.04
321,4,4,0,879439926,879440109,183,198,211,3.958904109589041
321,4,3,-1,879440109,879440160,51,211,20,3.375
321,3,3,0,879440160,879440244,84,20,207,3.4761904761904763
321,3,4,1,879440244,879440245,1,207,186,3.905263157894737
321,4,4,0,879440245,879440264,19,186,631,3.581818181818182
321,4,4,0,879440264,879440294,30,631,513,4.526315789473684
321,4,5,1,879440294,879440317,23,513,510,3.823529411764706
321,5,3,-2,879440317,879440342,25,510,212,3.230769230769231
321,3,3,0,879440342,879440365,23,212,191,4.168674698795181
321,3,3,0,879440365,879440423,58,191,704,3.125
321,3,4,1,879440423,879440451,28,704,8,3.903225806451613
321,4,4,0,879440451,879440472,21,8,9,3.8878504672897196
321,4,4,0,879440472,879440636,164,9,173,4.1441441441441444
321,4,4,0,879440636,879440660,24,173,657,4.341463414634147
321,4,3,-1,879440660,879440687,27,657,523,4.159090909090909
321,3,3,0,879440687,879440716,29,523,32,3.7222222222222223
321,3,3,0,879440716,879440746,30,32,491,3.55
321,3,4,1,879440746,879440980,234,491,659,4.027777777777778
321,4,2,-2,879440980,879441064,84,659,1028,2.857142857142857
321,2,4,2,879441064,879441110,46,1028,493,3.909090909090909
321,4,3,-1,879441110,879441111,1,493,174,4.253521126760563
321,3,5,2,879441111,879441128,17,174,61,4.190476190476191
321,5,3,-2,879441128,879441178,50,61,651,3.8627450980392157
321,3,2,-1,879441178,879441201,23,651,521,3.787878787878788
321,2,4,2,879441201,879441308,107,521,216,3.8454545454545452
321,4,3,-1,879441308,879441336,28,216,1050,3.6153846153846154
266,4,2,-2,892256705,892256765,60,313,319,3.0408163265306123
266,2,4,2,892256765,892256828,63,319,268,3.9838709677419355
266,4,3,-1,892256828,892256967,139,268,289,2.988888888888889
266,3,2,-1,892256967,892257101,134,289,874,3.230769230769231
266,2,1,-1,892257101,892257446,345,874,245,3.056179775280899
266,1,5,4,892257446,892257865,419,245,100,4.0162162162162165
266,5,3,-2,892257865,892257897,32,100,676,3.3142857142857145
266,3,4,1,892257897,892258004,107,676,124,4.052631578947368
266,4,2,-2,892258004,892258038,34,124,924,3.3703703703703702
74,4,4,0,888333219,888333238,19,302,333,3.546666666666667
74,4,4,0,888333238,888333280,42,333,328,3.4895833333333335
74,4,4,0,888333280,888333329,49,328,307,3.6031746031746033
74,4,4,0,888333329,888333352,23,307,331,3.5517241379310347
74,4,3,-1,888333352,888333372,20,331,301,3.2465753424657535
74,3,4,1,888333372,888333428,56,301,100,4.0162162162162165
74,4,3,-1,888333428,888333458,30,100,137,3.9545454545454546
238,3,4,1,883575728,883575749,21,258,538,3.25
238,4,4,0,883575749,883575836,87,538,300,3.6861313868613137
238,4,3,-1,883575836,883575855,19,300,301,3.2465753424657535
238,3,4,1,883575855,883576359,504,301,471,3.5714285714285716
238,4,2,-2,883576359,883576398,39,471,815,3.135135135135135
238,2,3,1,883576398,883576424,26,815,845,3.661290322580645
238,3,4,1,883576424,883576443,19,845,121,3.521212121212121
238,4,3,-1,883576443,883576476,33,121,756,2.6885245901639343
238,3,3,0,883576476,883576509,33,756,118,3.2764227642276422
238,3,3,0,883576509,883576543,34,118,926,2.7857142857142856
238,3,3,0,883576543,883576560,17,926,220,3.433333333333333
238,3,3,0,883576560,883576574,14,220,546,2.9789473684210526
238,3,3,0,883576574,883576603,29,546,1190,3.4285714285714284
238,3,4,1,883576603,883576622,19,1190,458,3.0588235294117645
238,4,1,-3,883576622,883576666,44,458,1258,2.3333333333333335
319,4,4,0,875707746,876280289,572543,333,332,3.6511627906976742
319,4,4,0,876280289,879975504,3695215,332,306,4.033333333333333
319,4,2,-2,879975504,879977242,1738,306,338,2.75
319,2,2,0,879977242,889816172,9838930,338,259,2.492063492063492
319,2,3,1,889816172,889816233,61,259,358,2.6551724137931036
319,3,3,0,889816233,889816267,34,358,261,2.7333333333333334
323,2,4,2,878738827,878738910,83,319,327,3.5076923076923077
323,4,3,-1,878738910,878738949,39,327,873,2.7586206896551726
323,3,1,-2,878738949,878738997,48,873,243,2.357142857142857
323,1,3,2,878738997,878739029,32,243,328,3.4895833333333335
323,3,2,-1,878739029,878739084,55,328,245,3.056179775280899
323,2,5,3,878739084,878739137,53,245,127,4.162790697674419
323,5,4,-1,878739137,878739177,40,127,246,4.0
323,4,3,-1,878739177,878739225,48,246,847,3.7333333333333334
323,3,3,0,878739225,878739251,26,847,222,3.578125
323,3,4,1,878739251,878739275,24,222,255,3.2027027027027026
323,4,4,0,878739275,878739299,24,255,713,3.5
323,4,2,-2,878739299,878739355,56,713,7,3.76056338028169
323,2,3,1,878739355,878739394,39,7,1017,3.0
323,3,3,0,878739394,878739415,21,1017,764,3.1176470588235294
323,3,5,2,878739415,878739436,21,764,744,3.5714285714285716
323,5,4,-1,878739436,878739459,23,744,544,3.185185185185185
323,4,4,0,878739459,878739488,29,544,993,3.4838709677419355
323,4,3,-1,878739488,878739519,31,993,248,3.746268656716418
323,3,3,0,878739519,878739543,24,248,282,3.610526315789474
323,3,4,1,878739543,878739568,25,282,151,3.6544117647058822
323,4,4,0,878739568,878739594,26,151,1012,3.2916666666666665
323,4,3,-1,878739594,878739618,24,1012,121,3.521212121212121
323,3,4,1,878739618,878739643,25,121,508,3.6923076923076925
323,4,4,0,878739643,878739699,56,508,223,4.108695652173913
323,4,5,1,878739699,878739743,44,223,22,4.215909090909091
323,5,5,0,878739743,878739771,28,22,56,4.051724137931035
323,5,4,-1,878739771,878739801,30,56,479,4.25
323,4,5,1,878739801,878739829,28,479,651,3.8627450980392157
323,5,4,-1,878739829,878739857,28,651,1073,3.6315789473684212
323,4,4,0,878739857,878739878,21,1073,210,3.921259842519685
323,4,4,0,878739878,878739904,26,210,179,3.8823529411764706
323,4,5,1,878739904,878739925,21,179,23,3.9047619047619047
323,5,5,0,878739925,878739953,28,23,11,3.8904109589041096
323,5,5,0,878739953,878739988,35,11,215,3.662921348314607
323,5,5,0,878739988,878740017,29,215,467,4.071428571428571
67,4,4,0,875379287,875379288,1,1095,273,3.5238095238095237
67,4,4,0,875379288,875379322,34,273,123,3.297872340425532
67,4,3,-1,875379322,875379357,35,123,147,3.3142857142857145
67,3,3,0,875379357,875379445,88,147,1,3.902439024390244
67,3,4,1,875379445,875379515,70,1,276,3.6036036036036037
67,4,1,-3,875379515,875379540,25,276,412,2.272727272727273
67,1,3,2,875379540,875379566,26,412,122,2.282608695652174
67,3,3,0,875379566,875379594,28,122,871,2.3823529411764706
67,3,4,1,875379594,875379619,25,871,151,3.6544117647058822
67,4,3,-1,875379619,875379643,24,151,235,3.106382978723404
67,3,4,1,875379643,875379683,40,235,105,2.6176470588235294
67,4,4,0,875379683,875379706,23,105,472,2.984375
67,4,4,0,875379706,875379729,23,472,24,3.3728813559322033
67,4,3,-1,875379729,875379750,21,24,1047,2.6923076923076925
67,3,5,2,875379750,875379794,44,1047,7,3.76056338028169
211,3,3,0,879459876,879460172,296,491,9,3.8878504672897196
211,3,3,0,879460172,879460213,41,9,64,4.373737373737374
211,3,5,2,879460213,879460294,81,64,215,3.662921348314607
211,5,2,-3,879460294,879461395,1101,215,876,3.0
211,2,3,1,879461395,879461498,103,876,455,3.1702127659574466
98,3,4,1,880498624,880498797,173,938,211,3.958904109589041
98,4,2,-2,880498797,880498935,138,211,209,3.8275862068965516
98,2,5,3,880498935,880498967,32,209,435,3.8933333333333335
98,5,5,0,880498967,880498990,23,435,517,3.625
98,5,3,-2,880498990,880499018,28,517,70,3.5833333333333335
98,3,2,-1,880499018,880499053,35,70,502,3.272727272727273
98,2,3,1,880499053,880499087,34,502,88,3.433734939759036
98,3,5,2,880499087,880499111,24,88,25,3.3185840707964602
12,4,5,1,879958902,879958969,67,381,28,3.923076923076923
12,5,4,-1,879958969,879959025,56,28,392,3.5555555555555554
12,4,5,1,879959025,879959068,43,392,98,4.240875912408759
12,5,4,-1,879959068,879959088,20,98,172,4.225225225225225
12,4,5,1,879959088,879959105,17,172,684,3.847826086956522
12,5,5,0,879959105,879959138,33,684,157,3.5714285714285716
12,5,4,-1,879959138,879959161,23,157,480,4.283018867924528
12,4,5,1,879959161,879959212,51,480,591,3.7169811320754715
12,5,4,-1,879959212,879959306,94,591,159,3.3902439024390243
12,4,3,-1,879959306,879959394,88,159,708,3.3157894736842106
12,3,5,2,879959394,879959465,71,708,132,3.929411764705882
12,5,4,-1,879959465,879959553,88,132,215,3.662921348314607
12,4,4,0,879959553,879959583,30,215,96,3.9130434782608696
12,4,1,-3,879959583,879959610,27,96,200,3.8157894736842106
12,1,4,3,879959610,879959635,25,200,71,3.6575342465753424
12,4,4,0,879959635,879959670,35,71,195,3.9072164948453607
12,4,5,1,879959670,879960826,1156,195,88,3.433734939759036
40,4,2,-2,889041330,889041358,28,242,346,3.5128205128205128
40,2,4,2,889041358,889041402,44,346,333,3.546666666666667
40,4,2,-2,889041402,889041430,28,333,286,3.442857142857143
40,2,2,0,889041430,889041454,24,286,340,3.7419354838709675
40,2,3,1,889041454,889041477,23,340,270,3.7804878048780486
40,3,3,0,889041477,889041523,46,270,750,4.027777777777778
40,3,2,-1,889041523,889041595,72,750,879,3.2291666666666665
40,2,4,2,889041595,889041670,75,879,345,3.4782608695652173
40,4,4,0,889041670,889041671,1,345,294,3.1052631578947367
40,4,3,-1,889041671,889041741,70,294,358,2.6551724137931036
40,3,1,-2,889041741,889041790,49,358,343,3.0
40,1,3,2,889041790,889041981,191,343,258,3.7547169811320753
258,4,1,-3,885700811,885700919,108,690,288,3.5214285714285714
258,1,5,4,885700919,885700946,27,288,751,3.3896103896103895
258,5,2,-3,885700946,885701004,58,751,289,2.988888888888889
258,2,5,3,885701004,885701024,20,289,332,3.6511627906976742
258,5,3,-2,885701024,885701044,20,332,877,2.619047619047619
258,3,4,1,885701044,885701062,18,877,323,3.0
258,4,1,-3,885701062,885701099,37,323,893,2.625
228,4,1,-3,889387173,889387216,43,288,327,3.5076923076923077
228,1,3,2,889387216,889388521,1305,327,475,3.956043956043956
228,3,5,2,889388521,889388547,26,475,812,3.375
228,5,3,-2,889388547,889388607,60,812,98,4.240875912408759
228,3,3,0,889388607,889388662,55,98,650,3.1363636363636362
325,2,4,2,891477489,891477567,78,313,269,4.085106382978723
325,4,4,0,891477567,891477597,30,269,286,3.442857142857143
325,4,2,-2,891477597,891477638,41,286,305,3.5789473684210527
325,2,3,1,891477638,891477660,22,305,345,3.4782608695652173
325,3,3,0,891477660,891477759,99,345,271,3.3134328358208953
325,3,4,1,891477759,891477905,146,271,152,3.6785714285714284
325,4,4,0,891477905,891477957,52,152,357,4.063291139240507
325,4,5,1,891477957,891477980,23,357,137,3.9545454545454546
325,5,4,-1,891477980,891478006,26,137,514,4.033333333333333
325,4,5,1,891478006,891478028,22,514,430,4.136363636363637
325,5,4,-1,891478028,891478047,19,430,511,4.096153846153846
325,4,4,0,891478047,891478079,32,511,98,4.240875912408759
325,4,5,1,891478079,891478099,20,98,835,4.0
325,5,2,-3,891478099,891478120,21,835,200,3.8157894736842106
325,2,5,3,891478120,891478140,20,200,185,3.9726027397260273
325,5,5,0,891478140,891478159,19,185,1203,4.0
325,5,4,-1,891478159,891478160,1,1203,181,3.98974358974359
325,4,5,1,891478160,891478180,20,181,506,3.566666666666667
325,5,4,-1,891478180,891478219,39,506,517,3.625
325,4,3,-1,891478219,891478239,20,517,526,3.909090909090909
325,3,5,2,891478239,891478276,37,526,23,3.9047619047619047
325,5,4,-1,891478276,891478376,100,23,530,4.125
325,4,5,1,891478376,891478392,16,530,474,4.172413793103448
325,5,3,-2,891478392,891478408,16,474,191,4.168674698795181
325,3,3,0,891478408,891478455,47,191,176,3.967032967032967
325,3,3,0,891478455,891478480,25,176,154,3.6031746031746033
325,3,4,1,891478480,891478528,48,154,529,4.142857142857143
325,4,5,1,891478528,891478529,1,529,179,3.8823529411764706
325,5,3,-2,891478529,891478557,28,179,115,3.6666666666666665
325,3,3,0,891478557,891478578,21,115,86,3.869565217391304
325,3,3,0,891478578,891478599,21,86,485,3.717948717948718
325,3,4,1,891478599,891478627,28,485,193,3.883720930232558
325,4,5,1,891478627,891478643,16,193,484,4.116279069767442
325,5,3,-2,891478643,891478695,52,484,236,3.2666666666666666
325,3,3,0,891478695,891478712,17,236,47,3.5869565217391304
325,3,1,-2,891478712,891478772,60,47,2,3.0851063829787235
325,1,3,2,891478772,891478796,24,2,28,3.923076923076923
325,3,4,1,891478796,891478817,21,28,443,3.8421052631578947
325,4,3,-1,891478817,891478835,18,443,182,3.842857142857143
325,3,4,1,891478835,891478851,16,182,172,4.225225225225225
325,4,3,-1,891478851,891478877,26,172,458,3.0588235294117645
325,3,2,-1,891478877,891478895,18,458,95,3.8194444444444446
325,2,2,0,891478895,891478944,49,95,188,3.625
325,2,1,-1,891478944,891479017,73,188,164,3.6140350877192984
325,1,4,3,891479017,891479038,21,164,614,3.727272727272727
325,4,4,0,891479038,891479058,20,614,502,3.272727272727273
325,4,2,-2,891479058,891479102,44,502,107,3.45
325,2,4,2,891479102,891479228,126,107,1149,3.857142857142857
325,4,5,1,891479228,891479244,16,1149,99,3.8392857142857144
325,5,1,-4,891479244,891479292,48,99,235,3.106382978723404
325,1,4,3,891479292,891479312,20,235,655,3.7857142857142856
325,4,1,-3,891479312,891479592,280,655,240,3.0350877192982457
325,1,3,2,891479592,891479665,73,240,1118,3.533333333333333
325,3,2,-1,891479665,891479706,41,1118,402,3.3076923076923075
325,2,3,1,891479706,891479737,31,402,1230,1.8888888888888888
325,3,4,1,891479737,891479846,109,1230,737,3.12
325,4,1,-3,891479846,891479912,66,737,554,2.9555555555555557
325,1,2,1,891479912,891479962,50,554,542,2.888888888888889
325,2,3,1,891479962,891480086,124,542,548,2.0
325,3,1,-2,891480086,891480115,29,548,771,2.5714285714285716
325,1,3,2,891480115,891480133,18,771,1003,2.8
325,3,3,0,891480133,891480175,42,1003,105,2.6176470588235294
320,3,4,1,884748299,884748346,47,292,895,3.142857142857143
320,4,4,0,884748346,884748470,124,895,751,3.3896103896103895
320,4,4,0,884748470,884748485,15,751,358,2.6551724137931036
320,4,4,0,884748485,884748579,94,358,100,4.0162162162162165
320,4,3,-1,884748579,884748604,25,100,1,3.902439024390244
320,3,4,1,884748604,884748641,37,1,147,3.3142857142857145
320,4,4,0,884748641,884748661,20,147,129,3.744186046511628
320,4,4,0,884748661,884748683,22,129,274,3.5609756097560976
320,4,4,0,884748683,884748708,25,274,7,3.76056338028169
320,4,5,1,884748708,884748733,25,7,121,3.521212121212121
320,5,4,-1,884748733,884748750,17,121,123,3.297872340425532
320,4,3,-1,884748750,884748774,24,123,597,3.2771084337349397
320,3,4,1,884748774,884748800,26,597,742,3.5555555555555554
320,4,4,0,884748800,884748868,68,742,458,3.0588235294117645
320,4,3,-1,884748868,884748886,18,458,278,3.0357142857142856
320,3,1,-2,884748886,884748904,18,278,833,2.9444444444444446
320,1,3,2,884748904,884748929,25,833,235,3.106382978723404
320,3,3,0,884748929,884748946,17,235,368,1.8823529411764706
320,3,4,1,884748946,884748997,51,368,1081,2.6666666666666665
320,4,4,0,884748997,884749014,17,1081,291,3.2
320,4,3,-1,884749014,884749097,83,291,974,3.125
320,3,3,0,884749097,884749172,75,974,1291,2.125
320,3,4,1,884749172,884749306,134,1291,62,3.048780487804878
320,4,3,-1,884749306,884749359,53,62,82,3.6741573033707864
320,3,4,1,884749359,884749360,1,82,161,3.5844155844155843
320,4,3,-1,884749360,884749384,24,161,566,3.543859649122807
320,3,4,1,884749384,884749385,1,566,33,3.2941176470588234
320,4,3,-1,884749385,884749411,26,33,576,3.125
320,3,3,0,884749411,884749412,1,576,586,2.875
320,3,5,2,884749412,884749452,40,586,22,4.215909090909091
320,5,4,-1,884749452,884749499,47,22,257,3.7154471544715446
320,4,2,-2,884749499,884749567,68,257,976,1.6666666666666667
320,2,5,3,884749567,884750644,1077,976,248,3.746268656716418
320,5,5,0,884750644,884750717,73,248,204,3.6744186046511627
320,5,3,-2,884750717,884750766,49,204,588,3.8358208955223883
320,3,5,2,884750766,884750946,180,588,173,4.1441441441441444
320,5,4,-1,884750946,884750968,22,173,421,3.462962962962963
320,4,1,-3,884750968,884750992,24,421,716,3.1904761904761907
320,1,4,3,884750992,884751034,42,716,90,3.0
320,4,4,0,884751034,884751068,34,90,869,3.0
320,4,3,-1,884751068,884751084,16,869,1041,3.3333333333333335
320,3,4,1,884751084,884751190,106,1041,159,3.3902439024390243
320,4,3,-1,884751190,884751246,56,159,77,3.3857142857142857
320,3,5,2,884751246,884751263,17,77,470,3.72
320,5,4,-1,884751263,884751288,25,470,38,2.784313725490196
320,4,4,0,884751288,884751316,28,38,1210,2.7142857142857144
320,4,4,0,884751316,884751336,20,1210,552,2.8095238095238093
320,4,3,-1,884751336,884751376,40,552,1090,2.3529411764705883
320,3,4,1,884751376,884751418,42,1090,627,3.3823529411764706
320,4,3,-1,884751418,884751439,21,627,71,3.6575342465753424
320,3,4,1,884751439,884751440,1,71,99,3.8392857142857144
320,4,3,-1,884751440,884751610,170,99,453,2.0
320,3,4,1,884751610,884751672,62,453,238,3.888888888888889
320,4,4,0,884751672,884751712,40,238,42,3.893617021276596
320,4,4,0,884751712,884751730,18,42,433,3.8035714285714284
326,3,5,2,879874859,879874897,38,168,515,4.202898550724638
326,5,1,-4,879874897,879874933,36,515,175,3.8354430379746836
326,1,5,4,879874933,879874963,30,175,483,4.475609756097561
326,5,4,-1,879874963,879874989,26,483,22,4.215909090909091
326,4,5,1,879874989,879875025,36,22,474,4.172413793103448
326,5,4,-1,879875025,879875057,32,474,523,4.159090909090909
326,4,3,-1,879875057,879875083,26,523,478,4.161290322580645
326,3,5,2,879875083,879875112,29,478,98,4.240875912408759
326,5,3,-2,879875112,879875243,131,98,317,3.774193548387097
326,3,2,-1,879875243,879875271,28,317,154,3.6031746031746033
326,2,4,2,879875271,879875397,126,154,659,4.027777777777778
326,4,4,0,879875397,879875398,1,659,132,3.929411764705882
326,4,3,-1,879875398,879875399,1,132,705,3.7857142857142856
326,3,5,2,879875399,879875431,32,705,657,4.341463414634147
326,5,2,-3,879875431,879875457,26,657,131,3.731707317073171
326,2,4,2,879875457,879875483,26,131,427,4.2025316455696204
326,4,1,-3,879875483,879875507,24,427,127,4.162790697674419
326,1,5,4,879875507,879875533,26,127,519,4.291666666666667
326,5,3,-2,879875533,879875534,1,519,208,3.8125
326,3,5,2,879875534,879875552,18,208,199,4.191489361702128
326,5,4,-1,879875552,879875592,40,199,181,3.98974358974359
326,4,4,0,879875592,879875593,1,181,511,4.096153846153846
326,4,3,-1,879875593,879875612,19,511,239,3.423076923076923
326,3,2,-1,879875612,879875644,32,239,433,3.8035714285714284
326,2,4,2,879875644,879875663,19,433,651,3.8627450980392157
326,4,2,-2,879875663,879875691,28,651,56,4.051724137931035
326,2,5,3,879875691,879875724,33,56,616,3.1052631578947367
326,5,4,-1,879875724,879875752,28,616,195,3.9072164948453607
326,4,4,0,879875752,879875822,70,195,196,3.9404761904761907
326,4,5,1,879875822,879875851,29,196,183,3.951219512195122
326,5,4,-1,879875851,879875852,1,183,633,3.9
326,4,3,-1,879875852,879875873,21,633,161,3.5844155844155843
326,3,4,1,879875873,879875930,57,161,608,4.285714285714286
326,4,2,-2,879875930,879875964,34,608,282,3.610526315789474
326,2,2,0,879875964,879876184,220,282,176,3.967032967032967
326,2,4,2,879876184,879876235,51,176,491,3.55
326,4,3,-1,879876235,879876300,65,491,54,3.3714285714285714
326,3,3,0,879876300,879876327,27,54,671,3.4285714285714284
326,3,4,1,879876327,879876489,162,671,265,3.710144927536232
326,4,5,1,879876489,879876505,16,265,550,3.272727272727273
326,5,3,-2,879876505,879876542,37,550,503,3.6363636363636362
326,3,3,0,879876542,879876861,319,503,82,3.6741573033707864
326,3,3,0,879876861,879876882,21,82,385,3.6129032258064515
326,3,2,-1,879876882,879876941,59,385,232,3.0789473684210527
326,2,1,-1,879876941,879876975,34,232,665,2.72972972972973
326,1,3,2,879876975,879876976,1,665,403,3.298507462686567
326,3,4,1,879876976,879877004,28,403,399,3.317073170731707
326,4,3,-1,879877004,879877005,1,399,554,2.9555555555555557
326,3,3,0,879877005,879877039,34,554,449,2.9069767441860463
326,3,4,1,879877039,879877073,34,449,566,3.543859649122807
326,4,5,1,879877073,879877143,70,566,732,3.6266666666666665
326,5,2,-3,879877143,879877234,91,732,451,3.207792207792208
326,2,2,0,879877234,879877264,30,451,72,3.175438596491228
326,2,4,2,879877264,879877304,40,72,94,2.8823529411764706
326,4,2,-2,879877304,879877326,22,94,780,3.08
326,2,3,1,879877326,879877387,61,780,670,2.9375
326,3,4,1,879877387,879877388,1,670,447,3.46875
326,4,4,0,879877388,879877413,25,447,445,3.727272727272727
326,4,2,-2,879877413,879877433,20,445,441,2.4
327,2,3,1,887737493,887737629,136,886,311,3.761904761904762
327,3,4,1,887737629,887743600,5971,311,288,3.5214285714285714
327,4,3,-1,887743600,887743644,44,288,294,3.1052631578947367
327,3,3,0,887743644,887743725,81,294,301,3.2465753424657535
327,3,3,0,887743725,887743986,261,301,474,4.172413793103448
327,3,2,-1,887743986,887744064,78,474,186,3.905263157894737
327,2,3,1,887744064,887744065,1,186,183,3.951219512195122
327,3,2,-1,887744065,887744101,36,183,83,4.204081632653061
327,2,4,2,887744101,887744167,66,83,856,4.142857142857143
327,4,4,0,887744167,887744205,38,856,507,3.6285714285714286
327,4,4,0,887744205,887744240,35,507,176,3.967032967032967
327,4,4,0,887744240,887744277,37,176,195,3.9072164948453607
327,4,4,0,887744277,887744356,79,195,150,3.803921568627451
327,4,4,0,887744356,887744405,49,150,475,3.956043956043956
327,4,4,0,887744405,887744432,27,475,93,3.5641025641025643
327,4,4,0,887744432,887744459,27,93,285,4.181818181818182
327,4,4,0,887744459,887744513,54,285,174,4.253521126760563
327,4,3,-1,887744513,887745303,790,174,484,4.116279069767442
327,3,4,1,887745303,887745319,16,484,527,3.823529411764706
327,4,2,-2,887745319,887745589,270,527,405,3.25
327,2,4,2,887745589,887745622,33,405,1,3.902439024390244
327,4,4,0,887745622,887745661,39,1,603,4.315789473684211
327,4,4,0,887745661,887745699,38,603,650,3.1363636363636362
327,4,4,0,887745699,887745744,45,650,651,3.8627450980392157
327,4,5,1,887745744,887745774,30,651,960,3.0
327,5,2,-3,887745774,887745805,31,960,56,4.051724137931035
327,2,2,0,887745805,887745840,35,56,421,3.462962962962963
327,2,4,2,887745840,887745871,31,421,151,3.6544117647058822
327,4,2,-2,887745871,887745891,20,151,1012,3.2916666666666665
327,2,2,0,887745891,887745910,19,1012,408,4.4772727272727275
327,2,3,1,887745910,887745911,1,408,255,3.2027027027027026
327,3,3,0,887745911,887746219,308,255,164,3.6140350877192984
327,3,3,0,887746219,887746328,109,164,218,3.5555555555555554
327,3,3,0,887746328,887746686,358,218,676,3.3142857142857145
327,3,2,-1,887746686,887746728,42,676,25,3.3185840707964602
327,2,4,2,887746728,887747266,538,25,32,3.7222222222222223
327,4,3,-1,887747266,887747299,33,32,26,3.36
327,3,4,1,887747299,887747338,39,26,514,4.033333333333333
327,4,4,0,887747338,887747410,72,514,710,3.41025641025641
327,4,4,0,887747410,887748028,618,710,921,3.611111111111111
327,4,2,-2,887748028,887818540,70512,921,735,3.58
327,2,4,2,887818540,887818596,56,735,153,3.7865168539325844
327,4,3,-1,887818596,887818682,86,153,211,3.958904109589041
327,3,3,0,887818682,887818992,310,211,746,3.7560975609756095
327,3,4,1,887818992,887819021,29,746,659,4.027777777777778
327,4,4,0,887819021,887819136,115,659,1069,3.6
327,4,5,1,887819136,887819161,25,1069,959,3.4583333333333335
327,5,2,-3,887819161,887819316,155,959,455,3.1702127659574466
327,2,2,0,887819316,887819354,38,455,952,3.3529411764705883
327,2,4,2,887819354,887819355,1,952,367,3.4242424242424243
327,4,4,0,887819355,887819411,56,367,709,4.171428571428572
327,4,4,0,887819411,887819462,51,709,111,3.5106382978723403
327,4,3,-1,887819462,887819507,45,111,393,3.5125
327,3,4,1,887819507,887819538,31,393,232,3.0789473684210527
327,4,2,-2,887819538,887819582,44,232,72,3.175438596491228
327,2,4,2,887819582,887819614,32,72,1103,3.5555555555555554
327,4,2,-2,887819614,887820226,612,1103,628,3.573529411764706
327,2,3,1,887820226,887820341,115,628,281,3.2
327,3,3,0,887820341,887820384,43,281,431,3.422222222222222
327,3,3,0,887820384,887820385,1,431,117,3.689189189189189
327,3,2,-1,887820385,887820417,32,117,147,3.3142857142857145
327,2,5,3,887820417,887820493,76,147,634,3.6
327,5,2,-3,887820493,887820531,38,634,31,3.642857142857143
327,2,3,1,887820531,887820545,14,31,962,3.142857142857143
327,3,4,1,887820545,887820695,150,962,215,3.662921348314607
327,4,5,1,887820695,887820828,133,215,201,3.75
327,5,4,-1,887820828,887822400,1572,201,1218,3.2
327,4,4,0,887822400,887822433,33,1218,86,3.869565217391304
327,4,2,-2,887822433,887822530,97,86,121,3.521212121212121
327,2,4,2,887822530,887822623,93,121,469,3.6842105263157894
327,4,3,-1,887822623,887822646,23,469,772,3.3333333333333335
327,3,3,0,887822646,887822681,35,772,425,3.7027027027027026
327,3,2,-1,887822681,887822711,30,425,69,3.8015873015873014
327,2,3,1,887822711,887822752,41,69,423,3.7016129032258065
327,3,3,0,887822752,887822770,18,423,529,4.142857142857143
327,3,4,1,887822770,887822785,15,529,464,3.8
327,4,4,0,887822785,888251464,428679,464,1100,3.0
327,4,4,0,888251464,888251521,57,1100,435,3.8933333333333335
183,4,3,-1,891463592,891463617,25,227,96,3.9130434782608696
183,3,3,0,891463617,891463809,192,96,121,3.521212121212121
183,3,2,-1,891463809,891463937,128,121,181,3.98974358974359
183,2,4,2,891463937,891464079,142,181,649,3.625
183,4,4,0,891464079,891464393,314,649,405,3.25
183,4,2,-2,891464393,891464558,165,405,257,3.7154471544715446
183,2,3,1,891464558,891466405,1847,257,1217,3.4166666666666665
183,3,3,0,891466405,891466863,458,1217,94,2.8823529411764706
183,3,3,0,891466863,891467003,140,94,562,3.2941176470588234
183,3,2,-1,891467003,891467545,542,562,375,2.076923076923077
183,2,1,-1,891467545,891467546,1,375,1215,2.0714285714285716
183,1,3,2,891467546,891479783,12237,1215,144,3.9545454545454546
183,3,4,1,891479783,892323453,843670,144,720,3.2
328,3,3,0,885044418,885044452,34,690,343,3.0
328,3,5,2,885044452,885044482,30,343,258,3.7547169811320753
328,5,4,-1,885044482,885044519,37,258,750,4.027777777777778
328,4,2,-2,885044519,885044607,88,750,301,3.2465753424657535
328,2,5,3,885044607,885044640,33,301,300,3.6861313868613137
328,5,2,-3,885044640,885044641,1,300,270,3.7804878048780486
328,2,4,2,885044641,885044703,62,270,245,3.056179775280899
328,4,5,1,885044703,885044733,30,245,689,3.1538461538461537
328,5,2,-3,885044733,885044904,171,689,299,3.0
328,2,3,1,885044904,885044940,36,299,984,2.6666666666666665
328,3,4,1,885044940,885045085,145,984,331,3.5517241379310347
328,4,3,-1,885045085,885045245,160,331,748,3.1043478260869564
328,3,4,1,885045245,885045645,400,748,223,4.108695652173913
328,4,4,0,885045645,885045678,33,223,511,4.096153846153846
328,4,4,0,885045678,885045702,24,511,50,4.306532663316583
328,4,4,0,885045702,885045768,66,50,205,3.717391304347826
328,4,5,1,885045768,885045805,37,205,22,4.215909090909091
328,5,3,-2,885045805,885045844,39,22,198,4.04
328,3,3,0,885045844,885045899,55,198,195,3.9072164948453607
328,3,5,2,885045899,885045931,32,195,28,3.923076923076923
328,5,4,-1,885045931,885045993,62,28,56,4.051724137931035
328,4,3,-1,885045993,885046027,34,56,385,3.6129032258064515
328,3,5,2,885046027,885046052,25,385,176,3.967032967032967
328,5,4,-1,885046052,885046079,27,176,7,3.76056338028169
328,4,4,0,885046079,885046134,55,7,180,3.9473684210526314
328,4,3,-1,885046134,885046174,40,180,646,3.9285714285714284
328,3,4,1,885046174,885046244,70,646,589,4.384615384615385
328,4,4,0,885046244,885046305,61,589,423,3.7016129032258065
328,4,4,0,885046305,885046344,39,423,645,3.5714285714285716
328,4,4,0,885046344,885046420,76,645,200,3.8157894736842106
328,4,4,0,885046420,885046455,35,200,531,3.7435897435897436
328,4,5,1,885046455,885046537,82,531,684,3.847826086956522
328,5,3,-2,885046537,885046580,43,684,76,3.1875
328,3,5,2,885046580,885046654,74,76,498,4.290909090909091
328,5,4,-1,885046654,885046655,1,498,939,3.6333333333333333
328,4,3,-1,885046655,885046686,31,939,72,3.175438596491228
328,3,4,1,885046686,885046718,32,72,699,3.736842105263158
328,4,3,-1,885046718,885046744,26,699,448,3.466666666666667
328,3,4,1,885046744,885046773,29,448,371,3.0
328,4,2,-2,885046773,885046853,80,371,715,3.257142857142857
328,2,4,2,885046853,885046878,25,715,744,3.5714285714285716
328,4,4,0,885046878,885046912,34,744,956,3.5714285714285716
328,4,3,-1,885046912,885046976,64,956,228,3.7246376811594204
328,3,3,0,885046976,885046977,1,228,229,3.185185185185185
328,3,3,0,885046977,885047018,41,229,8,3.903225806451613
328,3,3,0,885047018,885047099,81,8,177,3.875
328,3,3,0,885047099,885047100,1,177,1109,3.4545454545454546
328,3,3,0,885047100,885047129,29,1109,227,3.169811320754717
328,3,4,1,885047129,885047194,65,227,79,3.956989247311828
328,4,5,1,885047194,885047252,58,79,241,3.5625
328,5,4,-1,885047252,885047309,57,241,742,3.5555555555555554
328,4,3,-1,885047309,885047336,27,742,550,3.272727272727273
328,3,4,1,885047336,885047373,37,550,237,3.7315436241610738
328,4,3,-1,885047373,885047417,44,237,51,3.5277777777777777
328,3,3,0,885047417,885047450,33,51,11,3.8904109589041096
328,3,4,1,885047450,885047484,34,11,521,3.787878787878788
328,4,1,-3,885047484,885047511,27,521,432,3.719298245614035
328,1,3,2,885047511,885047556,45,432,636,3.4146341463414633
328,3,3,0,885047556,885047593,37,636,284,3.1547619047619047
328,3,3,0,885047593,885047627,34,284,402,3.3076923076923075
328,3,3,0,885047627,885047670,43,402,232,3.0789473684210527
328,3,3,0,885047670,885047696,26,232,503,3.6363636363636362
328,3,3,0,885047696,885047737,41,503,380,3.4878048780487805
328,3,3,0,885047737,885047763,26,380,356,3.2
328,3,3,0,885047763,885047864,101,356,44,3.1333333333333333
328,3,3,0,885047864,885047895,31,44,4,3.5538461538461537
328,3,3,0,885047895,885047896,1,4,568,3.5853658536585367
328,3,4,1,885047896,885048004,108,568,601,3.857142857142857
328,4,4,0,885048004,885048062,58,601,73,3.588235294117647
328,4,2,-2,885048062,885048101,39,73,708,3.3157894736842106
328,2,4,2,885048101,885048159,58,708,451,3.207792207792208
328,4,2,-2,885048159,885048198,39,451,518,3.5833333333333335
328,2,3,1,885048198,885048235,37,518,553,3.5
328,3,3,0,885048235,885048333,98,553,849,2.5625
328,3,3,0,885048333,885048365,32,849,627,3.3823529411764706
328,3,3,0,885048365,885048396,31,627,118,3.2764227642276422
328,3,3,0,885048396,885048464,68,118,235,3.106382978723404
328,3,3,0,885048464,885048465,1,235,597,3.2771084337349397
328,3,3,0,885048465,885048532,67,597,1107,2.9
328,3,3,0,885048532,885048611,79,1107,739,3.391304347826087
328,3,1,-2,885048611,885048666,55,739,586,2.875
328,1,2,1,885048666,885048730,64,586,149,2.4
328,2,3,1,885048730,885048762,32,149,1041,3.3333333333333335
328,3,3,0,885048762,885048801,39,1041,755,3.085714285714286
328,3,3,0,885048801,885048827,26,755,1439,3.0
328,3,2,-1,885048827,885048895,68,1439,578,3.066666666666667
328,2,4,2,885048895,885048930,35,578,281,3.2
328,4,4,0,885048930,885049112,182,281,726,2.8
328,4,4,0,885049112,885049199,87,726,569,2.4285714285714284
328,4,3,-1,885049199,885049234,35,569,983,2.5
328,3,3,0,885049234,885049275,41,983,62,3.048780487804878
328,3,3,0,885049275,885049431,156,62,561,3.1515151515151514
328,3,4,1,885049431,885049459,28,561,1112,2.9
328,4,3,-1,885049459,885049503,44,1112,1518,3.142857142857143
328,3,3,0,885049503,885049535,32,1518,720,3.2
328,3,3,0,885049535,885049658,123,720,572,2.857142857142857
328,3,1,-2,885049658,885049756,98,572,1139,2.611111111111111
328,1,3,2,885049756,885049790,34,1139,1217,3.4166666666666665
328,3,3,0,885049790,885049836,46,1217,579,2.727272727272727
328,3,3,0,885049836,885049880,44,579,383,2.5
328,3,5,2,885049880,885596118,546238,383,347,3.59375
328,5,3,-2,885596118,886036967,440849,347,610,3.1818181818181817
328,3,4,1,886036967,886037065,98,610,186,3.905263157894737
328,4,2,-2,886037065,886037257,192,186,153,3.7865168539325844
328,2,4,2,886037257,886037429,172,153,655,3.7857142857142856
328,4,3,-1,886037429,886038224,795,655,43,3.1
328,3,4,1,886038224,888641949,2603725,43,1313,3.142857142857143
328,4,3,-1,888641949,888641999,50,1313,905,3.357142857142857
328,3,4,1,888641999,893195665,4553666,905,344,4.0
328,4,3,-1,893195665,893195755,90,344,903,2.6666666666666665
328,3,4,1,893195755,893195825,70,903,1483,3.25
328,4,3,-1,893195825,893195852,27,1483,912,3.0
328,3,3,0,893195852,893195879,27,912,911,2.5
322,4,4,0,887313698,887313801,103,272,127,4.162790697674419
322,4,3,-1,887313801,887313850,49,127,216,3.8454545454545452
322,3,3,0,887313850,887313892,42,216,489,4.076923076923077
322,3,4,1,887313892,887313893,1,489,234,3.7674418604651163
322,4,4,0,887313893,887313946,53,234,48,4.055555555555555
322,4,5,1,887313946,887313983,37,48,197,4.112676056338028
322,5,5,0,887313983,887314027,44,197,656,3.75
322,5,4,-1,887314027,887314073,46,656,1019,3.7777777777777777
322,4,5,1,887314073,887314118,45,1019,654,4.119047619047619
322,5,4,-1,887314118,887314119,1,654,507,3.6285714285714286
322,4,3,-1,887314119,887314185,66,507,89,3.9615384615384617
322,3,4,1,887314185,887314212,27,89,9,3.8878504672897196
322,4,4,0,887314212,887314280,68,9,318,4.5046728971962615
322,4,4,0,887314280,887314352,72,318,196,3.9404761904761907
322,4,5,1,887314352,887314416,64,196,179,3.8823529411764706
322,5,5,0,887314416,887314417,1,179,603,4.315789473684211
322,5,5,0,887314417,887314418,1,603,528,4.241379310344827
330,4,5,1,876544278,876544337,59,864,763,3.347826086956522
330,5,5,0,876544337,876544366,29,763,15,3.725663716814159
330,5,5,0,876544366,876544432,66,15,283,3.901639344262295
330,5,3,-2,876544432,876544480,48,283,1016,3.559322033898305
330,3,4,1,876544480,876544507,27,1016,225,3.0714285714285716
330,4,5,1,876544507,876544609,102,225,257,3.7154471544715446
330,5,4,-1,876544609,876544632,23,257,993,3.4838709677419355
330,4,5,1,876544632,876544654,22,993,117,3.689189189189189
330,5,5,0,876544654,876544690,36,117,235,3.106382978723404
330,5,4,-1,876544690,876544734,44,235,252,2.911392405063291
330,4,4,0,876544734,876544781,47,252,148,3.2131147540983607
330,4,5,1,876544781,876544953,172,148,21,2.9210526315789473
330,5,5,0,876544953,876544998,45,21,866,3.3962264150943398
330,5,4,-1,876544998,876545058,60,866,370,2.8125
330,4,4,0,876545058,876545150,92,370,105,2.6176470588235294
330,4,5,1,876545150,876545417,267,105,403,3.298507462686567
330,5,5,0,876545417,876545418,1,403,231,2.938775510204082
330,5,5,0,876545418,876545479,61,231,627,3.3823529411764706
330,5,5,0,876545479,876545532,53,627,22,4.215909090909091
330,5,3,-2,876545532,876545598,66,22,708,3.3157894736842106
330,3,5,2,876545598,876545625,27,708,133,3.7777777777777777
330,5,5,0,876545625,876545971,346,133,423,3.7016129032258065
330,5,4,-1,876545971,876545999,28,423,161,3.5844155844155843
330,4,3,-1,876545999,876546105,106,161,205,3.717391304347826
330,3,5,2,876546105,876546132,27,205,58,3.543859649122807
330,5,4,-1,876546132,876546172,40,58,99,3.8392857142857144
330,4,5,1,876546172,876546236,64,99,8,3.903225806451613
330,5,4,-1,876546236,876546267,31,8,177,3.875
330,4,5,1,876546267,876546298,31,177,418,3.825
330,5,5,0,876546298,876546323,25,418,238,3.888888888888889
330,5,4,-1,876546323,876546377,54,238,443,3.8421052631578947
330,4,3,-1,876546377,876546439,62,443,168,4.0476190476190474
330,3,5,2,876546439,876546470,31,168,143,3.56
330,5,3,-2,876546470,876546498,28,143,747,3.5526315789473686
330,3,5,2,876546498,876546526,28,747,28,3.923076923076923
330,5,4,-1,876546526,876546561,35,28,11,3.8904109589041096
330,4,4,0,876546561,876546586,25,11,102,3.3684210526315788
330,4,5,1,876546586,876546619,33,102,172,4.225225225225225
330,5,5,0,876546619,876546668,49,172,200,3.8157894736842106
330,5,5,0,876546668,876546719,51,200,501,3.289473684210526
330,5,5,0,876546719,876546752,33,501,213,3.943396226415094
330,5,5,0,876546752,876546753,1,213,51,3.5277777777777777
330,5,5,0,876546753,876546782,29,51,73,3.588235294117647
330,5,5,0,876546782,876546812,30,73,31,3.642857142857143
330,5,5,0,876546812,876546866,54,31,210,3.921259842519685
330,5,5,0,876546866,876546890,24,210,69,3.8015873015873014
330,5,5,0,876546890,876546920,30,69,44,3.1333333333333333
330,5,5,0,876546920,876546948,28,44,88,3.433734939759036
330,5,5,0,876546948,876547032,84,88,692,3.56
330,5,5,0,876547032,876547087,55,692,72,3.175438596491228
330,5,4,-1,876547087,876547165,78,72,575,2.619047619047619
330,4,3,-1,876547165,876547220,55,575,584,3.5238095238095237
330,3,5,2,876547220,876547250,30,584,465,3.75
330,5,5,0,876547250,876547355,105,465,549,3.4871794871794872
330,5,4,-1,876547355,876547378,23,549,376,2.9166666666666665
330,4,4,0,876547378,876547426,48,376,91,3.6
330,4,4,0,876547426,876547470,44,91,1035,3.03125
330,4,3,-1,876547470,876547500,30,1035,559,3.477272727272727
330,3,5,2,876547500,876547533,33,559,963,3.9285714285714284
330,5,5,0,876547533,876547608,75,963,468,3.380952380952381
330,5,4,-1,876547608,876547674,66,468,570,3.526315789473684
330,4,2,-2,876547674,876547737,63,570,80,2.967741935483871
330,2,2,0,876547737,876547813,76,80,384,2.7941176470588234
330,2,4,2,876547813,876547853,40,384,422,3.25
330,4,5,1,876547853,876547925,72,422,215,3.662921348314607
27,4,2,-2,891542942,891542987,45,9,596,3.180327868852459
27,2,4,2,891542987,891543009,22,596,515,4.202898550724638
27,4,3,-1,891543009,891543129,120,515,742,3.5555555555555554
27,3,4,1,891543129,891543164,35,742,298,3.779220779220779
27,4,2,-2,891543164,891543191,27,298,325,2.625
27,2,2,0,891543191,891543222,31,325,978,2.357142857142857
27,2,4,2,891543222,891543245,23,978,370,2.8125
27,4,3,-1,891543245,891543393,148,370,286,3.442857142857143
331,3,3,0,877196173,877196174,1,178,132,3.929411764705882
331,3,2,-1,877196174,877196235,61,132,482,3.9444444444444446
331,2,3,1,877196235,877196308,73,482,486,3.9565217391304346
331,3,3,0,877196308,877196383,75,486,491,3.55
331,3,4,1,877196383,877196384,1,491,277,3.6
331,4,3,-1,877196384,877196443,59,277,702,2.764705882352941
331,3,3,0,877196443,877196444,1,702,1194,4.181818181818182
331,3,2,-1,877196444,877196504,60,1194,479,4.25
331,2,1,-1,877196504,877196567,63,479,1,3.902439024390244
331,1,4,3,877196567,877196633,66,1,32,3.7222222222222223
331,4,1,-3,877196633,877196634,1,32,1199,2.6666666666666665
331,1,4,3,877196634,877196702,68,1199,694,4.277777777777778
331,4,5,1,877196702,877196819,117,694,269,4.085106382978723
331,5,5,0,877196819,877196820,1,269,682,3.0476190476190474
332,5,5,0,887916151,887916188,37,288,300,3.6861313868613137
332,5,4,-1,887916188,887916217,29,300,271,3.3134328358208953
332,4,4,0,887916217,887916284,67,271,678,2.8181818181818183
332,4,5,1,887916284,887916324,40,678,294,3.1052631578947367
332,5,4,-1,887916324,887916365,41,294,322,3.0476190476190474
332,4,4,0,887916365,887916411,46,322,332,3.6511627906976742
332,4,5,1,887916411,887916529,118,332,181,3.98974358974359
332,5,4,-1,887916529,887916547,18,181,7,3.76056338028169
332,4,4,0,887916547,887916575,28,7,257,3.7154471544715446
332,4,2,-2,887916575,887916623,48,257,1315,3.4444444444444446
332,2,5,3,887916623,887916653,30,1315,127,4.162790697674419
332,5,5,0,887916653,887916675,22,127,50,4.306532663316583
332,5,5,0,887916675,887916692,17,50,282,3.610526315789474
332,5,4,-1,887916692,887938245,21553,282,1,3.902439024390244
332,4,4,0,887938245,887938277,32,1,685,3.2666666666666666
332,4,5,1,887938277,887938330,53,685,118,3.2764227642276422
332,5,4,-1,887938330,887938351,21,118,471,3.5714285714285716
332,4,4,0,887938351,887938403,52,471,1028,2.857142857142857
332,4,5,1,887938403,887938421,18,1028,763,3.347826086956522
332,5,4,-1,887938421,887938503,82,763,827,2.4375
332,4,4,0,887938503,887938524,21,827,820,3.0444444444444443
332,4,5,1,887938524,887938556,32,820,833,2.9444444444444446
332,5,4,-1,887938556,887938574,18,833,595,2.9166666666666665
332,4,3,-1,887938574,887938601,27,595,406,2.5294117647058822
332,3,3,0,887938601,887938652,51,406,1047,2.6923076923076925
332,3,4,1,887938652,887938669,17,1047,841,2.772727272727273
332,4,2,-2,887938669,887938687,18,841,756,2.6885245901639343
332,2,3,1,887938687,887938723,36,756,235,3.106382978723404
332,3,4,1,887938723,887938738,15,235,411,2.911764705882353
332,4,3,-1,887938738,887938760,22,411,831,2.6097560975609757
332,3,3,0,887938760,887938798,38,831,1013,2.388888888888889
332,3,4,1,887938798,887938818,20,1013,120,2.3421052631578947
332,4,2,-2,887938818,887938849,31,120,370,2.8125
332,2,2,0,887938849,887938886,37,370,983,2.5
332,2,5,3,887938886,887938934,48,983,22,4.215909090909091
332,5,5,0,887938934,887938981,47,22,210,3.921259842519685
332,5,5,0,887938981,887938997,16,210,41,3.0625
332,5,5,0,887938997,887939021,24,41,679,3.2432432432432434
332,5,5,0,887939021,887939051,30,679,96,3.9130434782608696
332,5,5,0,887939051,887939071,20,96,159,3.3902439024390243
332,5,5,0,887939071,887939092,21,159,226,3.378787878787879
332,5,5,0,887939092,887939157,65,226,470,3.72
332,5,3,-2,887939157,888098125,158968,470,660,3.71875
332,3,4,1,888098125,888098151,26,660,568,3.5853658536585367
332,4,5,1,888098151,888098170,19,568,307,3.6031746031746033
332,5,5,0,888098170,888098256,86,307,56,4.051724137931035
332,5,5,0,888098256,888098276,20,56,323,3.0
332,5,5,0,888098276,888098328,52,323,562,3.2941176470588234
332,5,5,0,888098328,888098373,45,562,232,3.0789473684210527
332,5,5,0,888098373,888098374,1,232,1188,2.45
332,5,4,-1,888098374,888098432,58,1188,546,2.9789473684210526
332,4,4,0,888098432,888098459,27,546,978,2.357142857142857
332,4,5,1,888098459,888098524,65,978,252,2.911392405063291
332,5,5,0,888098524,888098538,14,252,693,3.6285714285714286
332,5,5,0,888098538,888359882,261344,693,11,3.8904109589041096
332,5,5,0,888359882,888359903,21,11,97,3.7282608695652173
332,5,5,0,888359903,888359944,41,97,64,4.373737373737374
332,5,5,0,888359944,888359980,36,64,228,3.7246376811594204
332,5,5,0,888359980,888360060,80,228,95,3.8194444444444446
332,5,5,0,888360060,888360092,32,95,173,4.1441441441441444
332,5,5,0,888360092,888360129,37,173,746,3.7560975609756095
332,5,2,-3,888360129,888360179,50,746,70,3.5833333333333335
332,2,4,2,888360179,888360212,33,70,367,3.4242424242424243
332,4,4,0,888360212,888360229,17,367,73,3.588235294117647
332,4,5,1,888360229,888360248,19,73,655,3.7857142857142856
332,5,5,0,888360248,888360307,59,655,673,3.393939393939394
332,5,5,0,888360307,888360342,35,673,230,3.3518518518518516
332,5,4,-1,888360342,888360343,1,230,77,3.3857142857142857
332,4,4,0,888360343,888360370,27,77,233,3.323529411764706
332,4,5,1,888360370,888360371,1,233,227,3.169811320754717
332,5,5,0,888360371,888360396,25,227,218,3.5555555555555554
332,5,5,0,888360396,888360412,16,218,431,3.422222222222222
332,5,3,-2,888360412,888360438,26,431,53,2.9523809523809526
332,3,4,1,888360438,888360532,94,53,1157,3.142857142857143
332,4,4,0,888360532,889069561,709029,1157,682,3.0476190476190474
332,4,4,0,889069561,893027298,3957737,682,728,3.05
332,4,3,-1,893027298,893027312,14,728,264,2.65
329,4,4,0,891655291,891655322,31,286,333,3.546666666666667
329,4,4,0,891655322,891655350,28,333,303,3.75
329,4,2,-2,891655350,891655383,33,303,294,3.1052631578947367
329,2,2,0,891655383,891655515,132,294,879,3.2291666666666665
329,2,2,0,891655515,891655545,30,879,338,2.75
329,2,3,1,891655545,891655570,25,338,322,3.0476190476190474
329,3,2,-1,891655570,891655594,24,322,323,3.0
329,2,2,0,891655594,891655614,20,323,892,2.9615384615384617
329,2,4,2,891655614,891655741,127,892,181,3.98974358974359
329,4,4,0,891655741,891655812,71,181,100,4.0162162162162165
329,4,4,0,891655812,891655868,56,100,297,4.142857142857143
329,4,5,1,891655868,891655905,37,297,124,4.052631578947368
329,5,4,-1,891655905,891655932,27,124,515,4.202898550724638
329,4,3,-1,891655932,891655961,29,515,7,3.76056338028169
329,3,3,0,891655961,891655981,20,7,1011,3.1
329,3,4,1,891655981,891656012,31,1011,295,3.769230769230769
329,4,3,-1,891656012,891656072,60,295,147,3.3142857142857145
329,3,4,1,891656072,891656178,106,147,12,4.358974358974359
329,4,4,0,891656178,891656206,28,12,855,3.590909090909091
329,4,4,0,891656206,891656237,31,855,423,3.7016129032258065
329,4,4,0,891656237,891656300,63,423,98,4.240875912408759
329,4,4,0,891656300,891656347,47,98,483,4.475609756097561
329,4,3,-1,891656347,891656391,44,483,657,4.341463414634147
329,3,3,0,891656391,891656640,249,657,245,3.056179775280899
86,3,3,0,879570218,879570277,59,288,300,3.6861313868613137
86,3,3,0,879570277,879570366,89,300,872,3.0
86,3,3,0,879570366,879570423,57,872,326,3.262295081967213
86,3,5,2,879570423,879570974,551,326,270,3.7804878048780486
139,3,4,1,879537876,879537918,42,242,288,3.5214285714285714
139,4,5,1,879537918,879538021,103,288,303,3.75
139,5,4,-1,879538021,879538080,59,303,1176,4.0
139,4,5,1,879538080,879538169,89,1176,744,3.5714285714285716
139,5,3,-2,879538169,879538199,30,744,460,3.0
139,3,4,1,879538199,879538218,19,460,246,4.0
139,4,3,-1,879538218,879538254,36,246,237,3.7315436241610738
139,3,4,1,879538254,879538255,1,237,508,3.6923076923076925
139,4,5,1,879538255,879538275,20,508,297,4.142857142857143
139,5,4,-1,879538275,879538327,52,297,150,3.803921568627451
139,4,5,1,879538327,879538415,88,150,475,3.956043956043956
139,5,4,-1,879538415,879538578,163,475,458,3.0588235294117645
300,4,2,-2,875650018,875650042,24,948,687,2.1481481481481484
300,2,5,3,875650042,875650068,26,687,872,3.0
300,5,1,-4,875650068,875650132,64,872,264,2.65
300,1,5,4,875650132,875650298,166,264,1094,3.2
163,3,4,1,891220019,891220097,78,28,56,4.051724137931035
163,4,4,0,891220097,891220161,64,56,64,4.373737373737374
163,4,3,-1,891220161,891220196,35,64,216,3.8454545454545452
163,3,3,0,891220196,891220226,30,216,288,3.5214285714285714
333,5,5,0,891044659,891045082,423,316,174,4.253521126760563
333,5,4,-1,891045082,891045117,35,174,520,4.136363636363637
333,4,1,-3,891045117,891045191,74,520,180,3.9473684210526314
333,1,4,3,891045191,891045245,54,180,435,3.8933333333333335
333,4,4,0,891045245,891045335,90,435,186,3.905263157894737
333,4,5,1,891045335,891045410,75,186,739,3.391304347826087
333,5,3,-2,891045410,891045496,86,739,873,2.7586206896551726
333,3,5,2,891045496,891045551,55,873,88,3.433734939759036
333,5,3,-2,891045551,891045624,73,88,255,3.2027027027027026
333,3,4,1,891045624,891045666,42,255,100,4.0162162162162165
334,4,4,0,891544102,891544103,1,268,272,4.2
334,4,3,-1,891544103,891544135,32,272,307,3.6031746031746033
334,3,5,2,891544135,891544177,42,307,906,3.8333333333333335
334,5,5,0,891544177,891544209,32,906,346,3.5128205128205128
334,5,4,-1,891544209,891544233,24,346,886,2.857142857142857
334,4,3,-1,891544233,891544264,31,886,877,2.619047619047619
334,3,2,-1,891544264,891544286,22,877,312,3.0
334,2,3,1,891544286,891544311,25,312,328,3.4895833333333335
334,3,3,0,891544311,891544340,29,328,689,3.1538461538461537
334,3,3,0,891544340,891544367,27,689,937,3.5
334,3,4,1,891544367,891544407,40,937,1313,3.142857142857143
334,4,3,-1,891544407,891544491,84,1313,289,2.988888888888889
334,3,1,-2,891544491,891544524,33,289,338,2.75
334,1,3,2,891544524,891544584,60,338,322,3.0476190476190474
334,3,4,1,891544584,891544680,96,322,1202,3.6666666666666665
334,4,4,0,891544680,891544707,27,1202,285,4.181818181818182
334,4,3,-1,891544707,891544735,28,285,1198,3.0
334,3,4,1,891544735,891544765,30,1198,236,3.2666666666666666
334,4,4,0,891544765,891544810,45,236,922,4.0
334,4,3,-1,891544810,891544840,30,922,250,3.4698795180722892
334,3,3,0,891544840,891544867,27,250,508,3.6923076923076925
334,3,4,1,891544867,891544904,37,508,181,3.98974358974359
334,4,4,0,891544904,891544925,21,181,19,3.9615384615384617
334,4,2,-2,891544925,891544972,47,19,742,3.5555555555555554
334,2,4,2,891544972,891544997,25,742,248,3.746268656716418
334,4,4,0,891544997,891545044,47,248,116,3.6666666666666665
334,4,3,-1,891545044,891545067,23,116,121,3.521212121212121
334,3,4,1,891545067,891545089,22,121,276,3.6036036036036037
334,4,3,-1,891545089,891545108,19,276,744,3.5714285714285716
334,3,3,0,891545108,891545162,54,744,287,3.4516129032258065
334,3,4,1,891545162,891545185,23,287,1315,3.4444444444444446
334,4,3,-1,891545185,891545239,54,1315,866,3.3962264150943398
334,3,4,1,891545239,891545265,26,866,10,3.85
334,4,3,-1,891545265,891545293,28,10,235,3.106382978723404
334,3,3,0,891545293,891545318,25,235,846,3.1052631578947367
334,3,4,1,891545318,891545347,29,846,1051,3.625
334,4,4,0,891545347,891545480,133,1051,1048,2.857142857142857
334,4,3,-1,891545480,891545513,33,1048,870,2.75
334,3,3,0,891545513,891545540,27,870,815,3.135135135135135
334,3,2,-1,891545540,891545616,76,815,1132,2.588235294117647
334,2,3,1,891545616,891545645,29,1132,225,3.0714285714285716
334,3,4,1,891545645,891545674,29,225,840,3.090909090909091
334,4,4,0,891545674,891545741,67,840,42,3.893617021276596
334,4,4,0,891545741,891545793,52,42,98,4.240875912408759
334,4,4,0,891545793,891545821,28,98,427,4.2025316455696204
334,4,3,-1,891545821,891545852,31,427,1172,3.4
334,3,4,1,891545852,891545898,46,1172,89,3.9615384615384617
334,4,4,0,891545898,891545926,28,89,479,4.25
334,4,5,1,891545926,891545949,23,479,531,3.7435897435897436
334,5,5,0,891545949,891545973,24,531,223,4.108695652173913
334,5,4,-1,891545973,891546132,159,223,171,4.090909090909091
334,4,4,0,891546132,891546153,21,171,707,3.909090909090909
334,4,3,-1,891546153,891546181,28,707,170,4.242424242424242
334,3,3,0,891546181,891546206,25,170,607,4.136363636363637
334,3,3,0,891546206,891546231,25,607,527,3.823529411764706
334,3,3,0,891546231,891546299,68,527,71,3.6575342465753424
334,3,3,0,891546299,891546348,49,71,216,3.8454545454545452
334,3,3,0,891546348,891546373,25,216,28,3.923076923076923
334,3,5,2,891546373,891546992,619,28,652,3.9642857142857144
334,5,3,-2,891546992,891547040,48,652,176,3.967032967032967
334,3,1,-2,891547040,891547083,43,176,227,3.169811320754717
334,1,4,3,891547083,891547107,24,227,187,4.215189873417722
334,4,4,0,891547107,891547128,21,187,196,3.9404761904761907
334,4,3,-1,891547128,891547148,20,196,658,3.393939393939394
334,3,4,1,891547148,891547171,23,658,8,3.903225806451613
334,4,4,0,891547171,891547190,19,8,204,3.6744186046511627
334,4,4,0,891547190,891547235,45,204,154,3.6031746031746033
334,4,4,0,891547235,891547261,26,154,549,3.4871794871794872
334,4,2,-2,891547261,891547283,22,549,371,3.0
334,2,4,2,891547283,891547306,23,371,91,3.6
334,4,4,0,891547306,891547307,1,91,421,3.462962962962963
334,4,3,-1,891547307,891547334,27,421,500,4.285714285714286
334,3,3,0,891547334,891547445,111,500,111,3.5106382978723403
334,3,3,0,891547445,891547513,68,111,855,3.590909090909091
334,3,1,-2,891547513,891547563,50,855,955,3.2666666666666666
334,1,1,0,891547563,891547612,49,955,905,3.357142857142857
334,1,4,3,891547612,891547668,56,905,608,4.285714285714286
334,4,4,0,891547668,891547744,76,608,131,3.731707317073171
334,4,3,-1,891547744,891547763,19,131,506,3.566666666666667
334,3,5,2,891547763,891547894,131,506,228,3.7246376811594204
334,5,4,-1,891547894,891547912,18,228,408,4.4772727272727275
334,4,4,0,891547912,891547995,83,408,537,3.5
334,4,1,-3,891547995,891548032,37,537,69,3.8015873015873014
334,1,3,2,891548032,891548069,37,69,95,3.8194444444444446
334,3,2,-1,891548069,891548155,86,95,635,2.5
334,2,3,1,891548155,891548203,48,635,436,3.5
334,3,3,0,891548203,891548224,21,436,485,3.717948717948718
334,3,3,0,891548224,891548272,48,485,142,3.1481481481481484
334,3,4,1,891548272,891548295,23,142,86,3.869565217391304
334,4,3,-1,891548295,891548317,22,86,218,3.5555555555555554
334,3,3,0,891548317,891548345,28,218,4,3.5538461538461537
334,3,4,1,891548345,891548368,23,4,709,4.171428571428572
334,4,3,-1,891548368,891548387,19,709,68,3.5714285714285716
334,3,5,2,891548387,891548436,49,68,642,3.4285714285714284
334,5,4,-1,891548436,891548460,24,642,629,3.3333333333333335
334,4,4,0,891548460,891548533,73,629,99,3.8392857142857144
334,4,4,0,891548533,891548579,46,99,387,3.5357142857142856
334,4,4,0,891548579,891548602,23,387,163,3.53125
334,4,3,-1,891548602,891548622,20,163,746,3.7560975609756095
334,3,4,1,891548622,891548647,25,746,1426,4.0
334,4,3,-1,891548647,891548678,31,1426,740,3.423076923076923
334,3,3,0,891548678,891548695,17,740,73,3.588235294117647
334,3,4,1,891548695,891548729,34,73,1170,3.1666666666666665
334,4,3,-1,891548729,891548758,29,1170,716,3.1904761904761907
334,3,4,1,891548758,891548835,77,716,425,3.7027027027027026
334,4,3,-1,891548835,891548866,31,425,566,3.543859649122807
334,3,2,-1,891548866,891548920,54,566,569,2.4285714285714284
334,2,3,1,891548920,891548954,34,569,172,4.225225225225225
334,3,2,-1,891548954,891548979,25,172,1074,2.857142857142857
334,2,3,1,891548979,891549045,66,1074,214,3.272727272727273
334,3,4,1,891549045,891549068,23,214,1404,3.875
334,4,4,0,891549068,891549103,35,1404,396,2.84
334,4,4,0,891549103,891549192,89,396,1133,3.076923076923077
334,4,2,-2,891549192,891549246,54,1133,74,2.4
334,2,3,1,891549246,891549247,1,74,77,3.3857142857142857
334,3,3,0,891549247,891549267,20,77,810,2.9473684210526314
334,3,3,0,891549267,891549304,37,810,161,3.5844155844155843
334,3,2,-1,891549304,891549455,151,161,561,3.1515151515151514
334,2,1,-1,891549455,891549513,58,561,931,2.2758620689655173
334,1,3,2,891549513,891549539,26,931,449,2.9069767441860463
334,3,3,0,891549539,891549594,55,449,712,3.0434782608695654
334,3,2,-1,891549594,891549631,37,712,865,2.6666666666666665
334,2,4,2,891549631,891549632,1,865,1108,4.0
334,4,3,-1,891549632,891549667,35,1108,1041,3.3333333333333335
334,3,3,0,891549667,891549718,51,1041,1504,3.5
334,3,2,-1,891549718,891549751,33,1504,29,2.5714285714285716
334,2,2,0,891549751,891549777,26,29,229,3.185185185185185
334,2,3,1,891549777,891549860,83,229,1006,2.7777777777777777
334,3,4,1,891549860,891549926,66,1006,1263,3.1666666666666665
334,4,2,-2,891549926,891549927,1,1263,155,3.0588235294117645
334,2,2,0,891549927,891550121,194,155,1207,2.125
334,2,2,0,891550121,891550141,20,1207,38,2.784313725490196
334,2,1,-1,891550141,891550338,197,38,450,2.2758620689655173
334,1,2,1,891550338,891550372,34,450,577,1.7058823529411764
334,2,3,1,891550372,891550409,37,577,61,4.190476190476191
334,3,4,1,891550409,891550520,111,61,902,3.9444444444444446
334,4,4,0,891550520,891550535,15,902,315,4.15
334,4,3,-1,891550535,891550557,22,315,304,3.5306122448979593
334,3,4,1,891550557,891628228,77671,304,173,4.1441441441441444
334,4,5,1,891628228,891628849,621,173,603,4.315789473684211
39,4,5,1,891400159,891400188,29,313,302,4.133333333333334
39,5,3,-2,891400188,891400280,92,302,300,3.6861313868613137
39,3,3,0,891400280,891400342,62,300,306,4.033333333333333
39,3,5,2,891400342,891400704,362,306,352,1.8333333333333333
324,4,5,1,880574901,880575002,101,538,288,3.5214285714285714
324,5,5,0,880575002,880575107,105,288,259,2.492063492063492
324,5,4,-1,880575107,880575163,56,259,322,3.0476190476190474
324,4,4,0,880575163,880575234,71,322,879,3.2291666666666665
324,4,4,0,880575234,880575412,178,879,285,4.181818181818182
324,4,5,1,880575412,880575449,37,285,475,3.956043956043956
324,5,5,0,880575449,880575493,44,475,248,3.746268656716418
324,5,5,0,880575493,880575531,38,248,276,3.6036036036036037
324,5,4,-1,880575531,880575589,58,276,1033,3.0
324,4,5,1,880575589,880575619,30,1033,282,3.610526315789474
324,5,4,-1,880575619,880575658,39,282,127,4.162790697674419
324,4,4,0,880575658,880575714,56,127,123,3.297872340425532
132,4,3,-1,891278744,891278774,30,100,151,3.6544117647058822
132,3,4,1,891278774,891278807,33,151,484,4.116279069767442
132,4,4,0,891278807,891278867,60,484,12,4.358974358974359
132,4,3,-1,891278867,891278896,29,12,1154,3.6
132,3,4,1,891278896,891278937,41,1154,127,4.162790697674419
132,4,4,0,891278937,891278996,59,127,285,4.181818181818182
336,3,3,0,877756242,877756356,114,33,732,3.6266666666666665
336,3,1,-2,877756356,877756695,339,732,368,1.8823529411764706
336,1,2,1,877756695,877756890,195,368,1437,2.3333333333333335
336,2,3,1,877756890,877756934,44,1437,100,4.0162162162162165
336,3,4,1,877756934,877756966,32,100,67,3.106382978723404
336,4,1,-3,877756966,877757062,96,67,998,2.7777777777777777
336,1,3,2,877757062,877757063,1,998,399,3.317073170731707
336,3,1,-2,877757063,877757094,31,399,1079,2.1923076923076925
336,1,1,0,877757094,877757133,39,1079,401,2.6774193548387095
336,1,5,4,877757133,877757134,1,401,122,2.282608695652174
336,5,1,-4,877757134,877757268,134,122,1496,2.0
336,1,3,2,877757268,877757320,52,1496,108,3.107142857142857
336,3,3,0,877757320,877757477,157,108,41,3.0625
336,3,2,-1,877757477,877757516,39,41,999,2.75
336,2,2,0,877757516,877757550,34,999,871,2.3823529411764706
336,2,5,3,877757550,877757601,51,871,204,3.6744186046511627
336,5,5,0,877757601,877757637,36,204,173,4.1441441441441444
336,5,5,0,877757637,877757669,32,173,153,3.7865168539325844
336,5,4,-1,877757669,877757700,31,153,710,3.41025641025641
336,4,4,0,877757700,877757730,30,710,186,3.905263157894737
336,4,5,1,877757730,877757858,128,186,216,3.8454545454545452
336,5,5,0,877757858,877757877,19,216,26,3.36
336,5,1,-4,877757877,877757909,32,26,202,3.730337078651685
336,1,3,2,877757909,877757910,1,202,367,3.4242424242424243
336,3,2,-1,877757910,877757930,20,367,208,3.8125
336,2,4,2,877757930,877757952,22,208,949,3.392857142857143
336,4,1,-3,877757952,877757972,20,949,1183,2.5
336,1,2,1,877757972,877758001,29,1183,716,3.1904761904761907
336,2,3,1,877758001,877758035,34,716,796,2.923076923076923
336,3,4,1,877758035,877758055,20,796,1118,3.533333333333333
336,4,3,-1,877758055,877758078,23,1118,85,3.3157894736842106
336,3,3,0,877758078,877758103,25,85,746,3.7560975609756095
336,3,2,-1,877758103,877758187,84,746,790,2.8518518518518516
336,2,4,2,877758187,877759103,916,790,294,3.1052631578947367
336,4,4,0,877759103,877759224,121,294,50,4.306532663316583
336,4,1,-3,877759224,877759473,249,50,151,3.6544117647058822
336,1,4,3,877759473,877759730,257,151,275,4.087912087912088
336,4,4,0,877759730,877759833,103,275,284,3.1547619047619047
336,4,3,-1,877759833,877759928,95,284,742,3.5555555555555554
336,3,3,0,877759928,877760032,104,742,125,3.5555555555555554
336,3,1,-2,877760032,877760244,212,125,124,4.052631578947368
336,1,3,2,877760244,877760374,130,124,405,3.25
336,3,4,1,877760374,877760441,67,405,121,3.521212121212121
336,4,3,-1,877760441,877760521,80,121,288,3.5214285714285714
336,3,3,0,877760521,877760603,82,288,117,3.689189189189189
335,3,5,2,891566903,891567004,101,328,347,3.59375
335,5,3,-2,891567004,891567053,49,347,355,2.75
335,3,2,-1,891567053,891567098,45,355,748,3.1043478260869564
335,2,4,2,891567098,891567125,27,748,323,3.0
335,4,3,-1,891567125,891567159,34,323,260,2.4716981132075473
335,3,3,0,891567159,891567251,92,260,678,2.8181818181818183
169,5,4,-1,891268552,891268622,70,258,301,3.2465753424657535
169,4,3,-1,891268622,891268776,154,301,308,3.6153846153846154
169,3,3,0,891268776,891268777,1,308,321,3.0172413793103448
169,3,3,0,891268777,891268851,74,321,243,2.357142857142857
169,3,3,0,891268851,891359170,90319,243,498,4.290909090909091
169,3,3,0,891359170,891359250,80,498,429,3.742857142857143
169,3,3,0,891359250,891359276,26,429,495,3.65
169,3,5,2,891359276,891359317,41,495,172,4.225225225225225
169,5,4,-1,891359317,891359353,36,172,199,4.191489361702128
338,4,1,-3,879437523,879437576,53,269,294,3.1052631578947367
338,1,2,1,879437576,879438064,488,294,83,4.204081632653061
338,2,5,3,879438064,879438114,50,83,480,4.283018867924528
338,5,4,-1,879438114,879438143,29,480,133,3.7777777777777777
338,4,3,-1,879438143,879438165,22,133,497,3.35
338,3,4,1,879438165,879438196,31,497,100,4.0162162162162165
338,4,5,1,879438196,879438225,29,100,513,4.526315789473684
338,5,3,-2,879438225,879438275,50,513,606,4.294117647058823
338,3,4,1,879438275,879438326,51,606,604,3.8181818181818183
338,4,4,0,879438326,879438392,66,604,174,4.253521126760563
338,4,5,1,879438392,879438419,27,174,582,3.7457627118644066
338,5,4,-1,879438419,879438449,30,582,189,3.88
338,4,4,0,879438449,879438505,56,189,86,3.869565217391304
338,4,3,-1,879438505,879438535,30,86,56,4.051724137931035
338,3,3,0,879438535,879438570,35,56,494,3.8333333333333335
338,3,5,2,879438570,879438627,57,494,708,3.3157894736842106
338,5,2,-3,879438627,879438652,25,708,143,3.56
338,2,5,3,879438652,879438690,38,143,52,3.727272727272727
339,5,5,0,891032150,891032221,71,654,589,4.384615384615385
339,5,5,0,891032221,891032255,34,589,346,3.5128205128205128
339,5,4,-1,891032255,891032286,31,346,474,4.172413793103448
339,4,4,0,891032286,891032320,34,474,174,4.253521126760563
339,4,5,1,891032320,891032349,29,174,127,4.162790697674419
339,5,3,-2,891032349,891032379,30,127,58,3.543859649122807
339,3,5,2,891032379,891032413,34,58,530,4.125
339,5,5,0,891032413,891032438,25,530,192,4.090909090909091
339,5,4,-1,891032438,891032466,28,192,203,3.826923076923077
339,4,3,-1,891032466,891032576,110,203,195,3.9072164948453607
339,3,5,2,891032576,891032600,24,195,209,3.8275862068965516
339,5,4,-1,891032600,891032633,33,209,69,3.8015873015873014
339,4,5,1,891032633,891032659,26,69,12,4.358974358974359
339,5,5,0,891032659,891032700,41,12,187,4.215189873417722
339,5,4,-1,891032700,891032701,1,187,79,3.956989247311828
339,4,4,0,891032701,891032737,36,79,521,3.787878787878788
339,4,3,-1,891032737,891032765,28,521,55,4.051282051282051
339,3,5,2,891032765,891032793,28,55,179,3.8823529411764706
339,5,5,0,891032793,891032827,34,179,238,3.888888888888889
339,5,4,-1,891032827,891032828,1,238,183,3.951219512195122
339,4,5,1,891032828,891032856,28,183,475,3.956043956043956
339,5,5,0,891032856,891032885,29,475,480,4.283018867924528
339,5,5,0,891032885,891032952,67,480,663,3.948717948717949
339,5,5,0,891032952,891032953,1,663,642,3.4285714285714284
339,5,5,0,891032953,891032982,29,642,709,4.171428571428572
339,5,5,0,891032982,891033072,90,709,515,4.202898550724638
339,5,5,0,891033072,891033118,46,515,200,3.8157894736842106
339,5,4,-1,891033118,891033165,47,200,133,3.7777777777777777
339,4,5,1,891033165,891033200,35,133,693,3.6285714285714286
339,5,3,-2,891033200,891033226,26,693,214,3.272727272727273
339,3,5,2,891033226,891033256,30,214,631,3.581818181818182
339,5,5,0,891033256,891033282,26,631,293,3.630434782608696
339,5,5,0,891033282,891033310,28,293,182,3.842857142857143
339,5,4,-1,891033310,891033350,40,182,434,3.588235294117647
339,4,4,0,891033350,891033382,32,434,74,2.4
339,4,5,1,891033382,891033416,34,74,89,3.9615384615384617
339,5,5,0,891033416,891033481,65,89,23,3.9047619047619047
339,5,5,0,891033481,891033512,31,23,160,3.4
339,5,4,-1,891033512,891033542,30,160,433,3.8035714285714284
339,4,5,1,891033542,891033566,24,433,81,3.2857142857142856
339,5,5,0,891033566,891033567,1,81,1017,3.0
339,5,3,-2,891033567,891033602,35,1017,423,3.7016129032258065
339,3,5,2,891033602,891033629,27,423,205,3.717391304347826
339,5,5,0,891033629,891033653,24,205,197,4.112676056338028
339,5,4,-1,891033653,891033676,23,197,151,3.6544117647058822
339,4,4,0,891033676,891033710,34,151,257,3.7154471544715446
339,4,4,0,891033710,891033735,25,257,188,3.625
339,4,4,0,891033735,891033766,31,188,506,3.566666666666667
339,4,3,-1,891033766,891033794,28,506,144,3.9545454545454546
339,3,4,1,891033794,891033829,35,144,1113,3.0
339,4,5,1,891033829,891033830,1,1113,661,4.133333333333334
339,5,5,0,891033830,891033855,25,661,1240,3.5454545454545454
339,5,2,-3,891033855,891033898,43,1240,1135,3.0526315789473686
339,2,4,2,891033898,891033932,34,1135,153,3.7865168539325844
339,4,4,0,891033932,891033960,28,153,228,3.7246376811594204
339,4,5,1,891033960,891033984,24,228,518,3.5833333333333335
339,5,5,0,891033984,891034007,23,518,649,3.625
339,5,4,-1,891034007,891034040,33,649,130,1.8461538461538463
339,4,4,0,891034040,891034115,75,130,939,3.6333333333333333
339,4,3,-1,891034115,891034151,36,939,451,3.207792207792208
339,3,4,1,891034151,891034152,1,451,241,3.5625
339,4,5,1,891034152,891034215,63,241,211,3.958904109589041
339,5,5,0,891034215,891034254,39,211,173,4.1441441441441444
339,5,5,0,891034254,891034282,28,173,91,3.6
339,5,3,-2,891034282,891034510,228,91,403,3.298507462686567
339,3,5,2,891034510,891034592,82,403,1404,3.875
339,5,3,-2,891034592,891034626,34,1404,161,3.5844155844155843
339,3,4,1,891034626,891034657,31,161,1110,2.85
339,4,3,-1,891034657,891034681,24,1110,159,3.3902439024390243
339,3,3,0,891034681,891034717,36,159,566,3.543859649122807
339,3,4,1,891034717,891034718,1,566,845,3.661290322580645
339,4,2,-2,891034718,891034744,26,845,226,3.378787878787879
339,2,3,1,891034744,891034778,34,226,961,3.4545454545454546
339,3,3,0,891034778,891034779,1,961,265,3.710144927536232
339,3,4,1,891034779,891034810,31,265,675,3.625
339,4,3,-1,891034810,891034867,57,675,402,3.3076923076923075
339,3,5,2,891034867,891034922,55,402,856,4.142857142857143
339,5,3,-2,891034922,891034953,31,856,5,3.1481481481481484
339,3,3,0,891034953,891035003,50,5,73,3.588235294117647
339,3,5,2,891035003,891035035,32,73,640,2.75
339,5,4,-1,891035035,891035093,58,640,503,3.6363636363636362
339,4,4,0,891035093,891035116,23,503,1526,4.0
339,4,4,0,891035116,891035180,64,1526,99,3.8392857142857144
339,4,4,0,891035180,891035215,35,99,212,3.230769230769231
339,4,4,0,891035215,891035248,33,212,636,3.4146341463414633
339,4,3,-1,891035248,891035454,206,636,121,3.521212121212121
339,3,4,1,891035454,891035488,34,121,431,3.422222222222222
339,4,2,-2,891035488,891035523,35,431,550,3.272727272727273
339,2,2,0,891035523,891035524,1,550,227,3.169811320754717
339,2,3,1,891035524,891035553,29,227,415,2.6666666666666665
339,3,3,0,891035553,891035584,31,415,380,3.4878048780487805
339,3,4,1,891035584,891035647,63,380,637,2.888888888888889
339,4,3,-1,891035647,891035707,60,637,80,2.967741935483871
339,3,3,0,891035707,891035759,52,80,29,2.5714285714285716
339,3,4,1,891035759,891035850,91,29,82,3.6741573033707864
339,4,3,-1,891035850,891036016,166,82,573,2.909090909090909
339,3,4,1,891036016,891036058,42,573,167,2.8181818181818183
339,4,3,-1,891036058,891036199,141,167,139,2.7222222222222223
339,3,4,1,891036199,891036316,117,139,396,2.84
339,4,1,-3,891036316,891036503,187,396,233,3.323529411764706
339,1,3,2,891036503,891036557,54,233,1139,2.611111111111111
339,3,4,1,891036557,891036641,84,1139,240,3.0350877192982457
339,4,1,-3,891036641,891036707,66,240,1030,2.3636363636363638
339,1,3,2,891036707,891036753,46,1030,719,2.6666666666666665
339,3,2,-1,891036753,891036781,28,719,678,2.8181818181818183
339,2,3,1,891036781,891036899,118,678,288,3.5214285714285714
339,3,4,1,891036899,891037070,171,288,194,4.029411764705882
339,4,3,-1,891037070,891037119,49,194,514,4.033333333333333
309,2,3,1,877370319,877370383,64,1296,989,3.142857142857143
342,2,1,-1,874984025,874984045,20,262,875,2.736842105263158
342,1,4,3,874984045,874984128,83,875,156,4.017857142857143
342,4,5,1,874984128,874984154,26,156,23,3.9047619047619047
342,5,5,0,874984154,874984175,21,23,179,3.8823529411764706
342,5,5,0,874984175,874984207,32,179,32,3.7222222222222223
342,5,5,0,874984207,874984233,26,32,9,3.8878504672897196
342,5,3,-2,874984233,874984234,1,9,357,4.063291139240507
342,3,3,0,874984234,874984261,27,357,98,4.240875912408759
342,3,3,0,874984261,874984365,104,98,160,3.4
342,3,3,0,874984365,874984395,30,160,135,3.7974683544303796
342,3,4,1,874984395,874984430,35,135,584,3.5238095238095237
342,4,2,-2,874984430,874984455,25,584,137,3.9545454545454546
342,2,3,1,874984455,874984480,25,137,13,3.5454545454545454
342,3,4,1,874984480,874984507,27,13,1007,4.117647058823529
342,4,3,-1,874984507,874984531,24,1007,150,3.803921568627451
342,3,4,1,874984531,874984574,43,150,255,3.2027027027027026
342,4,1,-3,874984574,874984596,22,255,1009,3.2962962962962963
342,1,3,2,874984596,874984619,23,1009,287,3.4516129032258065
342,3,4,1,874984619,874984639,20,287,1012,3.2916666666666665
342,4,4,0,874984639,874984684,45,1012,93,3.5641025641025643
342,4,3,-1,874984684,874984727,43,93,535,3.380952380952381
342,3,5,2,874984727,874984788,61,535,149,2.4
342,5,2,-3,874984788,874984789,1,149,974,3.125
342,2,3,1,874984789,874984854,65,974,763,3.347826086956522
342,3,3,0,874984854,874984873,19,763,1094,3.2
342,3,2,-1,874984873,874984895,22,1094,274,3.5609756097560976
342,2,2,0,874984895,874984914,19,274,762,3.3962264150943398
342,2,2,0,874984914,875318267,333353,762,257,3.7154471544715446
342,2,2,0,875318267,875318328,61,257,25,3.3185840707964602
342,2,5,3,875318328,875318347,19,25,547,3.6666666666666665
342,5,1,-4,875318347,875318366,19,547,282,3.610526315789474
342,1,2,1,875318366,875318423,57,282,950,2.625
342,2,4,2,875318423,875318488,65,950,818,2.769230769230769
342,4,3,-1,875318488,875318509,21,818,928,3.142857142857143
342,3,5,2,875318509,875318536,27,928,1128,3.0
342,5,1,-4,875318536,875318585,49,1128,866,3.3962264150943398
342,1,1,0,875318585,875318606,21,866,544,3.185185185185185
342,1,3,2,875318606,875318629,23,544,240,3.0350877192982457
342,3,3,0,875318629,875318648,19,240,412,2.272727272727273
342,3,3,0,875318648,875318669,21,412,1008,3.5
342,3,1,-2,875318669,875318762,93,1008,764,3.1176470588235294
342,1,5,4,875318762,875318833,71,764,320,4.75
342,5,3,-2,875318833,875318858,25,320,194,4.029411764705882
342,3,3,0,875318858,875318882,24,194,792,3.793103448275862
342,3,5,2,875318882,875318962,80,792,114,4.3478260869565215
342,5,3,-2,875318962,875318963,1,114,607,4.136363636363637
342,3,4,1,875318963,875318988,25,607,197,4.112676056338028
342,4,4,0,875318988,875319012,24,197,238,3.888888888888889
342,4,1,-3,875319012,875319090,78,238,692,3.56
342,1,5,4,875319090,875319129,39,692,132,3.929411764705882
342,5,5,0,875319129,875319151,22,132,656,3.75
342,5,5,0,875319151,875319173,22,656,182,3.842857142857143
342,5,4,-1,875319173,875319254,81,182,427,4.2025316455696204
342,4,4,0,875319254,875319295,41,427,507,3.6285714285714286
342,4,4,0,875319295,875319334,39,507,496,4.094594594594595
342,4,4,0,875319334,875319383,49,496,655,3.7857142857142856
342,4,3,-1,875319383,875319412,29,655,789,3.7777777777777777
342,3,3,0,875319412,875319435,23,789,421,3.462962962962963
342,3,4,1,875319435,875319436,1,421,423,3.7016129032258065
342,4,3,-1,875319436,875319457,21,423,57,4.133333333333334
342,3,4,1,875319457,875319497,40,57,1071,3.0
342,4,5,1,875319497,875319536,39,1071,488,4.277777777777778
342,5,5,0,875319536,875319554,18,488,209,3.8275862068965516
342,5,4,-1,875319554,875319597,43,209,8,3.903225806451613
342,4,4,0,875319597,875319617,20,8,378,3.6904761904761907
342,4,4,0,875319617,875319745,128,378,654,4.119047619047619
342,4,5,1,875319745,875319786,41,654,131,3.731707317073171
342,5,4,-1,875319786,875319808,22,131,699,3.736842105263158
342,4,5,1,875319808,875319912,104,699,499,4.0
342,5,3,-2,875319912,875319967,55,499,478,4.161290322580645
342,3,5,2,875319967,875319991,24,478,191,4.168674698795181
342,5,2,-3,875319991,875320014,23,191,716,3.1904761904761907
342,2,2,0,875320014,875320037,23,716,26,3.36
342,2,5,3,875320037,875320104,67,26,216,3.8454545454545452
342,5,5,0,875320104,875320199,95,216,193,3.883720930232558
342,5,5,0,875320199,875320312,113,193,381,3.2758620689655173
340,1,4,3,884989963,884990004,41,179,204,3.6744186046511627
340,4,4,0,884990004,884990620,616,204,172,4.225225225225225
340,4,4,0,884990620,884990861,241,172,196,3.9404761904761907
340,4,5,1,884990861,884990891,30,196,71,3.6575342465753424
340,5,4,-1,884990891,884990922,31,71,402,3.3076923076923075
340,4,5,1,884990922,884990988,66,402,199,4.191489361702128
340,5,4,-1,884990988,884991082,94,199,186,3.905263157894737
340,4,4,0,884991082,884991083,1,186,486,3.9565217391304346
340,4,5,1,884991083,884991114,31,486,480,4.283018867924528
340,5,3,-2,884991114,884991236,122,480,180,3.9473684210526314
340,3,5,2,884991236,884991369,133,180,588,3.8358208955223883
340,5,5,0,884991369,884991396,27,588,526,3.909090909090909
340,5,3,-2,884991396,884991431,35,526,211,3.958904109589041
340,3,4,1,884991431,884991516,85,211,205,3.717391304347826
340,4,2,-2,884991516,884991584,68,205,662,3.4583333333333335
340,2,1,-1,884991584,884991618,34,662,428,3.744186046511628
340,1,5,4,884991618,884991647,29,428,946,3.1153846153846154
340,5,5,0,884991647,884991742,95,946,1133,3.076923076923077
340,5,5,0,884991742,884991817,75,1133,405,3.25
317,4,4,0,891446251,891446313,62,354,300,3.6861313868613137
317,4,4,0,891446313,891446371,58,300,299,3.0
317,4,2,-2,891446371,891446412,41,299,683,2.176470588235294
317,2,4,2,891446412,891446438,26,683,328,3.4895833333333335
317,4,3,-1,891446438,891446575,137,328,271,3.3134328358208953
317,3,3,0,891446575,891446819,244,271,351,2.4444444444444446
317,3,4,1,891446819,891446887,68,351,260,2.4716981132075473
341,4,5,1,890757686,890757745,59,288,887,3.5789473684210527
341,5,4,-1,890757745,890757782,37,887,335,2.5
341,4,4,0,890757782,890757886,104,335,876,3.0
341,4,5,1,890757886,890757961,75,876,1025,2.95
341,5,1,-4,890757961,890758050,89,1025,358,2.6551724137931036
341,1,3,2,890758050,890758051,1,358,259,2.492063492063492
341,3,3,0,890758051,890758080,29,259,908,2.5714285714285716
341,3,3,0,890758080,890758113,33,908,877,2.619047619047619
341,3,3,0,890758113,890758169,56,877,948,2.2962962962962963
343,2,3,1,876402428,876402468,40,288,333,3.546666666666667
343,3,1,-2,876402468,876402493,25,333,358,2.6551724137931036
343,1,4,3,876402493,876402516,23,358,306,4.033333333333333
343,4,4,0,876402516,876402626,110,306,515,4.202898550724638
343,4,5,1,876402626,876402738,112,515,9,3.8878504672897196
343,5,5,0,876402738,876402814,76,9,50,4.306532663316583
343,5,5,0,876402814,876402894,80,50,13,3.5454545454545454
343,5,4,-1,876402894,876402941,47,13,471,3.5714285714285716
343,4,4,0,876402941,876402978,37,471,222,3.578125
343,4,4,0,876402978,876403212,234,222,283,3.901639344262295
343,4,2,-2,876403212,876403239,27,283,476,3.1216216216216215
343,2,5,3,876403239,876403283,44,476,297,4.142857142857143
343,5,4,-1,876403283,876403310,27,297,536,3.3333333333333335
343,4,4,0,876403310,876403418,108,536,1008,3.5
343,4,3,-1,876403418,876403443,25,1008,274,3.5609756097560976
343,3,5,2,876403443,876403514,71,274,508,3.6923076923076925
343,5,3,-2,876403514,876403563,49,508,1117,3.0
343,3,1,-2,876403563,876403587,24,1117,930,2.793103448275862
343,1,3,2,876403587,876403851,264,930,823,2.75
343,3,4,1,876403851,876404385,534,823,462,3.7954545454545454
343,4,4,0,876404385,876404426,41,462,208,3.8125
343,4,5,1,876404426,876404464,38,208,657,4.341463414634147
343,5,5,0,876404464,876404499,35,657,23,3.9047619047619047
343,5,5,0,876404499,876404568,69,23,135,3.7974683544303796
343,5,4,-1,876404568,876404612,44,135,152,3.6785714285714284
343,4,5,1,876404612,876404613,1,152,180,3.9473684210526314
343,5,5,0,876404613,876404647,34,180,523,4.159090909090909
343,5,4,-1,876404647,876404688,41,523,961,3.4545454545454546
343,4,3,-1,876404688,876404757,69,961,164,3.6140350877192984
343,3,5,2,876404757,876404836,79,164,86,3.869565217391304
343,5,5,0,876404836,876404880,44,86,963,3.9285714285714284
343,5,4,-1,876404880,876404957,77,963,466,3.5
343,4,3,-1,876404957,876405004,47,466,77,3.3857142857142857
343,3,5,2,876405004,876405045,41,77,663,3.948717948717949
343,5,3,-2,876405045,876405129,84,663,55,4.051282051282051
343,3,5,2,876405129,876405200,71,55,194,4.029411764705882
343,5,5,0,876405200,876405553,353,194,176,3.967032967032967
343,5,1,-4,876405553,876405633,80,176,234,3.7674418604651163
343,1,3,2,876405633,876405697,64,234,48,4.055555555555555
343,3,5,2,876405697,876405735,38,48,12,4.358974358974359
343,5,3,-2,876405735,876405771,36,12,217,3.1538461538461537
343,3,4,1,876405771,876405820,49,217,581,3.130434782608696
343,4,4,0,876405820,876405857,37,581,193,3.883720930232558
343,4,2,-2,876405857,876405893,36,193,159,3.3902439024390243
343,2,5,3,876405893,876405943,50,159,715,3.257142857142857
343,5,4,-1,876405943,876406006,63,715,198,4.04
343,4,4,0,876406006,876406062,56,198,63,3.125
343,4,4,0,876406062,876406144,82,63,79,3.956989247311828
343,4,4,0,876406144,876406181,37,79,22,4.215909090909091
343,4,4,0,876406181,876406256,75,22,202,3.730337078651685
343,4,4,0,876406256,876406257,1,202,196,3.9404761904761907
343,4,4,0,876406257,876406283,26,196,58,3.543859649122807
343,4,3,-1,876406283,876406421,138,58,66,3.4705882352941178
343,3,4,1,876406421,876406462,41,66,727,3.5517241379310347
343,4,5,1,876406462,876406514,52,727,425,3.7027027027027026
343,5,4,-1,876406514,876406552,38,425,943,3.6666666666666665
343,4,5,1,876406552,876406576,24,943,735,3.58
343,5,4,-1,876406576,876406604,28,735,214,3.272727272727273
343,4,3,-1,876406604,876406640,36,214,44,3.1333333333333333
343,3,4,1,876406640,876406677,37,44,1211,3.5714285714285716
343,4,5,1,876406677,876406707,30,1211,318,4.5046728971962615
343,5,5,0,876406707,876406764,57,318,203,3.826923076923077
343,5,3,-2,876406764,876406822,58,203,559,3.477272727272727
343,3,2,-1,876406822,876406878,56,559,265,3.710144927536232
343,2,3,1,876406878,876406977,99,265,1107,2.9
343,3,2,-1,876406977,876406978,1,1107,375,2.076923076923077
343,2,5,3,876406978,876407032,54,375,231,2.938775510204082
343,5,2,-3,876407032,876407072,40,231,121,3.521212121212121
343,2,4,2,876407072,876407174,102,121,747,3.5526315789473686
343,4,4,0,876407174,876407340,166,747,229,3.185185185185185
343,4,1,-3,876407340,876407379,39,229,155,3.0588235294117645
343,1,4,3,876407379,876407565,186,155,76,3.1875
343,4,3,-1,876407565,876407663,98,76,67,3.106382978723404
343,3,1,-2,876407663,876407706,43,67,555,2.0
343,1,4,3,876407706,876407749,43,555,188,3.625
343,4,5,1,876407749,876408139,390,188,423,3.7016129032258065
344,5,3,-2,884813342,884813365,23,315,245,3.056179775280899
344,3,4,1,884813365,884814432,1067,245,537,3.5
344,4,5,1,884814432,884814457,25,537,1020,3.727272727272727
344,5,5,0,884814457,884814479,22,1020,89,3.9615384615384617
344,5,4,-1,884814479,884814480,1,89,25,3.3185840707964602
344,4,5,1,884814480,884814507,27,25,198,4.04
344,5,5,0,884814507,884814532,25,198,14,4.101694915254237
344,5,4,-1,884814532,884814668,136,14,7,3.76056338028169
344,4,3,-1,884814668,884814697,29,7,58,3.543859649122807
344,3,5,2,884814697,884899346,84649,58,124,4.052631578947368
344,5,4,-1,884899346,884899372,26,124,222,3.578125
344,4,4,0,884899372,884899397,25,222,275,4.087912087912088
344,4,4,0,884899397,884899442,45,275,628,3.573529411764706
344,4,3,-1,884899442,884899742,300,628,713,3.5
344,3,3,0,884899742,884899767,25,713,117,3.689189189189189
344,3,3,0,884899767,884899768,1,117,284,3.1547619047619047
344,3,3,0,884899768,884899791,23,284,845,3.661290322580645
344,3,3,0,884899791,884899815,24,845,1048,2.857142857142857
344,3,3,0,884899815,884899837,22,1048,472,2.984375
344,3,3,0,884899837,884900353,516,472,237,3.7315436241610738
344,3,3,0,884900353,884900374,21,237,281,3.2
344,3,3,0,884900374,884900391,17,281,762,3.3962264150943398
344,3,2,-1,884900391,884900409,18,762,928,3.142857142857143
344,2,3,1,884900409,884900499,90,928,476,3.1216216216216215
344,3,2,-1,884900499,884900529,30,476,756,2.6885245901639343
344,2,3,1,884900529,884900567,38,756,696,3.138888888888889
344,3,2,-1,884900567,884900583,16,696,106,2.8125
344,2,4,2,884900583,884900677,94,106,273,3.5238095238095237
344,4,5,1,884900677,884900771,94,273,195,3.9072164948453607
344,5,5,0,884900771,884900791,20,195,487,4.043478260869565
344,5,4,-1,884900791,884900792,1,487,707,3.909090909090909
344,4,3,-1,884900792,884901047,255,707,181,3.98974358974359
344,3,4,1,884901047,884901093,46,181,479,4.25
344,4,5,1,884901093,884901110,17,479,175,3.8354430379746836
344,5,4,-1,884901110,884901129,19,175,86,3.869565217391304
344,4,4,0,884901129,884901156,27,86,216,3.8454545454545452
344,4,4,0,884901156,884901210,54,216,478,4.161290322580645
344,4,3,-1,884901210,884901235,25,478,660,3.71875
344,3,3,0,884901235,884901249,14,660,684,3.847826086956522
344,3,3,0,884901249,884901270,21,684,11,3.8904109589041096
344,3,5,2,884901270,884901290,20,11,208,3.8125
344,5,3,-2,884901290,884901351,61,208,559,3.477272727272727
344,3,3,0,884901351,884901371,20,559,73,3.588235294117647
344,3,3,0,884901371,884901469,98,73,431,3.422222222222222
344,3,4,1,884901469,884901503,34,431,83,4.204081632653061
344,4,4,0,884901503,884901517,14,83,433,3.8035714285714284
344,4,3,-1,884901517,884901533,16,433,5,3.1481481481481484
344,3,5,2,884901533,884901560,27,5,367,3.4242424242424243
344,5,4,-1,884901560,884901561,1,367,708,3.3157894736842106
344,4,1,-3,884901561,886381986,1480425,708,1165,1.8
344,1,5,4,886381986,886382447,461,1165,190,4.233333333333333
344,5,4,-1,886382447,889813994,3431547,190,288,3.5214285714285714
344,4,5,1,889813994,889814068,74,288,285,4.181818181818182
344,5,5,0,889814068,889814194,126,285,191,4.168674698795181
344,5,4,-1,889814194,889814195,1,191,87,3.9
344,4,4,0,889814195,889814343,148,87,316,4.285714285714286
344,4,2,-2,889814343,889814470,127,316,322,3.0476190476190474
344,2,3,1,889814470,889814539,69,322,535,3.380952380952381
344,3,4,1,889814539,889814555,16,535,255,3.2027027027027026
344,4,3,-1,889814555,889814571,16,255,295,3.769230769230769
344,3,4,1,889814571,889814600,29,295,1014,3.1
345,4,5,1,884900448,884900466,18,303,269,4.085106382978723
345,5,4,-1,884900466,884900467,1,269,313,4.323076923076923
345,4,4,0,884900467,884900483,16,313,305,3.5789473684210527
345,4,3,-1,884900483,884900521,38,305,286,3.442857142857143
345,3,3,0,884900521,884900543,22,286,333,3.546666666666667
345,3,5,2,884900543,884900653,110,333,315,4.15
345,5,3,-2,884900653,884900709,56,315,312,3.0
345,3,3,0,884900709,884900736,27,312,886,2.857142857142857
345,3,5,2,884900736,884900777,41,886,124,4.052631578947368
345,5,4,-1,884900777,884900810,33,124,1117,3.0
345,4,5,1,884900810,884900899,89,1117,221,3.6923076923076925
345,5,4,-1,884900899,884900976,77,221,9,3.8878504672897196
345,4,4,0,884900976,884901000,24,9,508,3.6923076923076925
345,4,5,1,884901000,884901637,637,508,462,3.7954545454545454
345,5,5,0,884901637,884901701,64,462,12,4.358974358974359
345,5,5,0,884901701,884902339,638,12,298,3.779220779220779
345,5,3,-2,884902339,884916260,13921,298,481,3.8421052631578947
345,3,5,2,884916260,884916274,14,481,469,3.6842105263157894
345,5,4,-1,884916274,884916322,48,469,956,3.5714285714285716
345,4,4,0,884916322,884916339,17,956,200,3.8157894736842106
345,4,5,1,884916339,884916354,15,200,318,4.5046728971962615
345,5,3,-2,884916354,884916441,87,318,28,3.923076923076923
345,3,5,2,884916441,884916495,54,28,238,3.888888888888889
345,5,4,-1,884916495,884916532,37,238,258,3.7547169811320753
345,4,2,-2,884916532,884916551,19,258,988,2.5555555555555554
345,2,4,2,884916551,884991077,74526,988,14,4.101694915254237
345,4,3,-1,884991077,884991127,50,14,471,3.5714285714285716
345,3,5,2,884991127,884991191,64,471,151,3.6544117647058822
345,5,4,-1,884991191,884991220,29,151,13,3.5454545454545454
345,4,2,-2,884991220,884991244,24,13,473,2.9166666666666665
345,2,3,1,884991244,884991267,23,473,1008,3.5
345,3,4,1,884991267,884991285,18,1008,405,3.25
345,4,2,-2,884991285,884991303,18,405,1017,3.0
345,2,4,2,884991303,884991384,81,1017,676,3.3142857142857145
345,4,3,-1,884991384,884991419,35,676,282,3.610526315789474
345,3,2,-1,884991419,884991436,17,282,1048,2.857142857142857
345,2,3,1,884991436,884991457,21,1048,220,3.433333333333333
345,3,3,0,884991457,884991476,19,220,866,3.3962264150943398
345,3,3,0,884991476,884991505,29,866,476,3.1216216216216215
345,3,3,0,884991505,884991581,76,476,974,3.125
345,3,3,0,884991581,884991600,19,974,412,2.272727272727273
345,3,2,-1,884991600,884991614,14,412,620,3.0
345,2,4,2,884991614,884991670,56,620,287,3.4516129032258065
345,4,4,0,884991670,884991812,142,287,479,4.25
345,4,4,0,884991812,884991831,19,479,172,4.225225225225225
345,4,4,0,884991831,884991851,20,172,655,3.7857142857142856
345,4,2,-2,884991851,884991873,22,655,42,3.893617021276596
345,2,4,2,884991873,884991925,52,42,204,3.6744186046511627
345,4,4,0,884991925,884992005,80,204,684,3.847826086956522
345,4,4,0,884992005,884992084,79,684,470,3.72
345,4,3,-1,884992084,884992100,16,470,588,3.8358208955223883
345,3,4,1,884992100,884992117,17,588,498,4.290909090909091
345,4,4,0,884992117,884992141,24,498,485,3.717948717948718
345,4,4,0,884992141,884992158,17,485,65,3.511111111111111
345,4,4,0,884992158,884992174,16,65,210,3.921259842519685
345,4,3,-1,884992174,884992175,1,210,461,3.3333333333333335
345,3,3,0,884992175,884992194,19,461,566,3.543859649122807
345,3,3,0,884992194,884992218,24,566,202,3.730337078651685
345,3,5,2,884992218,884992248,30,202,70,3.5833333333333335
345,5,4,-1,884992248,884992291,43,70,79,3.956989247311828
345,4,4,0,884992291,884992337,46,79,11,3.8904109589041096
345,4,4,0,884992337,884992479,142,11,181,3.98974358974359
345,4,4,0,884992479,884992493,14,181,651,3.8627450980392157
345,4,4,0,884992493,884992755,262,651,69,3.8015873015873014
345,4,3,-1,884992755,884992770,15,69,44,3.1333333333333333
345,3,3,0,884992770,884992786,16,44,708,3.3157894736842106
345,3,5,2,884992786,884992807,21,708,582,3.7457627118644066
345,5,4,-1,884992807,884992823,16,582,387,3.5357142857142856
345,4,3,-1,884992823,884992897,74,387,736,4.083333333333333
345,3,3,0,884992897,884992922,25,736,71,3.6575342465753424
345,3,4,1,884992922,884992940,18,71,88,3.433734939759036
345,4,4,0,884992940,884992998,58,88,81,3.2857142857142856
345,4,4,0,884992998,884993016,18,81,739,3.391304347826087
345,4,4,0,884993016,884993033,17,739,709,4.171428571428572
345,4,4,0,884993033,884993047,14,709,568,3.5853658536585367
345,4,4,0,884993047,884993069,22,568,33,3.2941176470588234
345,4,5,1,884993069,884993085,16,33,451,3.207792207792208
345,5,4,-1,884993085,884993121,36,451,772,3.3333333333333335
345,4,5,1,884993121,884993139,18,772,724,3.64
345,5,4,-1,884993139,884993464,325,724,972,3.375
345,4,3,-1,884993464,884993505,41,972,49,3.3
345,3,3,0,884993505,884993506,1,49,54,3.3714285714285714
345,3,3,0,884993506,884993636,130,54,738,3.0
345,3,2,-1,884993636,884993662,26,738,570,3.526315789473684
345,2,3,1,884993662,884993686,24,570,356,3.2
345,3,3,0,884993686,884993703,17,356,1221,3.4285714285714284
345,3,5,2,884993703,884993744,41,1221,51,3.5277777777777777
345,5,2,-3,884993744,884993760,16,51,365,2.95
345,2,3,1,884993760,884993783,23,365,722,2.9642857142857144
345,3,3,0,884993783,884993903,120,722,1053,3.3846153846153846
345,3,3,0,884993903,884993932,29,1053,941,3.5
345,3,5,2,884993932,884994083,151,941,248,3.746268656716418
345,5,5,0,884994083,884994119,36,248,1007,4.117647058823529
345,5,4,-1,884994119,884994156,37,1007,246,4.0
345,4,4,0,884994156,884994592,436,246,295,3.769230769230769
345,4,3,-1,884994592,884994619,27,295,1016,3.559322033898305
345,3,3,0,884994619,884994631,12,1016,1315,3.4444444444444446
345,3,3,0,884994631,884994643,12,1315,1014,3.1
345,3,2,-1,884994643,884994658,15,1014,1023,2.5714285714285716
345,2,3,1,884994658,884994682,24,1023,1096,3.0
346,4,4,0,874947644,874947700,56,175,210,3.921259842519685
346,4,5,1,874947700,874947747,47,210,127,4.162790697674419
346,5,1,-4,874947747,874947794,47,127,727,3.5517241379310347
346,1,5,4,874947794,874947958,164,727,180,3.9473684210526314
346,5,3,-2,874947958,874948030,72,180,187,4.215189873417722
346,3,5,2,874948030,874948031,1,187,182,3.842857142857143
346,5,5,0,874948031,874948059,28,182,22,4.215909090909091
346,5,5,0,874948059,874948105,46,22,520,4.136363636363637
346,5,4,-1,874948105,874948139,34,520,203,3.826923076923077
346,4,4,0,874948139,874948174,35,203,11,3.8904109589041096
346,4,4,0,874948174,874948252,78,11,188,3.625
346,4,3,-1,874948252,874948303,51,188,186,3.905263157894737
346,3,3,0,874948303,874948332,29,186,143,3.56
346,3,4,1,874948332,874948475,143,143,211,3.958904109589041
346,4,4,0,874948475,874948513,38,211,742,3.5555555555555554
346,4,5,1,874948513,874948547,34,742,174,4.253521126760563
346,5,5,0,874948547,874948639,92,174,55,4.051282051282051
346,5,4,-1,874948639,874948703,64,55,121,3.521212121212121
346,4,4,0,874948703,874948730,27,121,204,3.6744186046511627
346,4,4,0,874948730,874948783,53,204,273,3.5238095238095237
346,4,3,-1,874948783,874948824,41,273,164,3.6140350877192984
346,3,4,1,874948824,874948889,65,164,518,3.5833333333333335
346,4,5,1,874948889,874948890,1,518,515,4.202898550724638
346,5,4,-1,874948890,874948929,39,515,684,3.847826086956522
346,4,3,-1,874948929,874948955,26,684,732,3.6266666666666665
346,3,3,0,874948955,874949011,56,732,216,3.8454545454545452
346,3,4,1,874949011,874949057,46,216,423,3.7016129032258065
346,4,4,0,874949057,874949086,29,423,237,3.7315436241610738
346,4,5,1,874949086,874949217,131,237,56,4.051724137931035
346,5,4,-1,874949217,874949380,163,56,88,3.433734939759036
346,4,3,-1,874949380,874949952,572,88,642,3.4285714285714284
346,3,4,1,874949952,874950054,102,642,117,3.689189189189189
346,4,4,0,874950054,874950135,81,117,76,3.1875
346,4,3,-1,874950135,874950172,37,76,561,3.1515151515151514
346,3,2,-1,874950172,874950208,36,561,128,3.45
346,2,5,3,874950208,874950232,24,128,12,4.358974358974359
346,5,2,-3,874950232,874950291,59,12,234,3.7674418604651163
346,2,3,1,874950291,874950316,25,234,739,3.391304347826087
346,3,3,0,874950316,874950383,67,739,685,3.2666666666666666
346,3,3,0,874950383,874950413,30,685,161,3.5844155844155843
346,3,2,-1,874950413,874950463,50,161,578,3.066666666666667
346,2,3,1,874950463,874950536,73,578,1018,3.0714285714285716
346,3,5,2,874950536,874950616,80,1018,431,3.422222222222222
346,5,4,-1,874950616,874950692,76,431,141,3.4827586206896552
346,4,5,1,874950692,874950766,74,141,566,3.543859649122807
346,5,4,-1,874950766,874950794,28,566,265,3.710144927536232
346,4,4,0,874950794,874950937,143,265,472,2.984375
346,4,4,0,874950937,874950966,29,472,549,3.4871794871794872
346,4,3,-1,874950966,874950993,27,549,38,2.784313725490196
346,3,3,0,874950993,874951029,36,38,809,2.7058823529411766
346,3,3,0,874951029,874951062,33,809,363,3.0
346,3,3,0,874951062,874951782,720,363,673,3.393939393939394
346,3,3,0,874951782,874951783,1,673,582,3.7457627118644066
346,3,3,0,874951783,875003052,51269,582,597,3.2771084337349397
346,3,4,1,875003052,875263238,260186,597,546,2.9789473684210526
346,4,1,-3,875263238,875263501,263,546,53,2.9523809523809526
346,1,3,2,875263501,875263574,73,53,218,3.5555555555555554
346,3,2,-1,875263574,875263664,90,218,219,2.735294117647059
346,2,3,1,875263664,875263845,181,219,94,2.8823529411764706
346,3,4,1,875263845,875263877,32,94,1222,2.6363636363636362
346,4,3,-1,875263877,875264262,385,1222,571,2.5
346,3,3,0,875264262,875264287,25,571,120,2.3421052631578947
346,3,1,-2,875264287,875264472,185,120,1188,2.45
346,1,2,1,875264472,875264945,473,1188,158,2.7027027027027026
346,2,2,0,875264945,875265071,126,158,1090,2.3529411764705883
346,2,3,1,875265071,875265106,35,1090,1231,2.7
346,3,4,1,875265106,875265236,130,1231,802,3.076923076923077
346,4,2,-2,875265236,875265295,59,802,743,1.9545454545454546
346,2,3,1,875265295,875265335,40,743,1210,2.7142857142857144
346,3,2,-1,875265335,875265527,192,1210,415,2.6666666666666665
346,2,2,0,875265527,875265528,1,415,720,3.2
346,2,1,-1,875265528,875266176,648,720,375,2.076923076923077
346,1,4,3,875266176,875266665,489,375,245,3.056179775280899
346,4,2,-2,875266665,886273426,11006761,245,259,2.492063492063492
346,2,3,1,886273426,886273541,115,259,322,3.0476190476190474
346,3,4,1,886273541,886273570,29,322,358,2.6551724137931036
346,4,3,-1,886273570,886273914,344,358,226,3.378787878787879
346,3,3,0,886273914,886274098,184,226,405,3.25
346,3,5,2,886274098,886274124,26,405,385,3.6129032258064515
346,5,4,-1,886274124,886274201,77,385,1217,3.4166666666666665
347,4,2,-2,881652077,881652142,65,258,748,3.1043478260869564
347,2,4,2,881652142,881652169,27,748,268,3.9838709677419355
347,4,1,-3,881652169,881652191,22,268,271,3.3134328358208953
347,1,5,4,881652191,881652230,39,271,245,3.056179775280899
347,5,1,-4,881652230,881652250,20,245,260,2.4716981132075473
347,1,5,4,881652250,881652377,127,260,181,3.98974358974359
347,5,4,-1,881652377,881652417,40,181,475,3.956043956043956
347,4,5,1,881652417,881652456,39,475,50,4.306532663316583
347,5,3,-2,881652456,881652480,24,50,151,3.6544117647058822
347,3,4,1,881652480,881652518,38,151,1,3.902439024390244
347,4,2,-2,881652518,881652535,17,1,15,3.725663716814159
347,2,5,3,881652535,881652568,33,15,125,3.5555555555555554
347,5,5,0,881652568,881652610,42,125,742,3.5555555555555554
347,5,4,-1,881652610,881652629,19,742,237,3.7315436241610738
347,4,4,0,881652629,881652657,28,237,280,3.103448275862069
347,4,5,1,881652657,881652683,26,280,249,3.3275862068965516
347,5,2,-3,881652683,881652684,1,249,25,3.3185840707964602
347,2,5,3,881652684,881652709,25,25,293,3.630434782608696
347,5,1,-4,881652709,881652730,21,293,1283,2.9
347,1,5,4,881652730,881652746,16,1283,291,3.2
347,5,3,-2,881652746,881652769,23,291,841,2.772727272727273
347,3,3,0,881652769,881652788,19,841,597,3.2771084337349397
347,3,5,2,881652788,881652813,25,597,472,2.984375
347,5,5,0,881652813,881652837,24,472,763,3.347826086956522
347,5,4,-1,881652837,881652862,25,763,544,3.185185185185185
347,4,3,-1,881652862,881652888,26,544,148,3.2131147540983607
347,3,5,2,881652888,881653059,171,148,410,3.0434782608695654
347,5,2,-3,881653059,881653087,28,410,1028,2.857142857142857
347,2,3,1,881653087,881653132,45,1028,290,3.108108108108108
347,3,4,1,881653132,881653155,23,290,829,2.4615384615384617
347,4,3,-1,881653155,881653176,21,829,928,3.142857142857143
347,3,2,-1,881653176,881653198,22,928,105,2.6176470588235294
347,2,2,0,881653198,881653244,46,105,595,2.9166666666666665
347,2,1,-1,881653244,881653266,22,595,827,2.4375
347,1,4,3,881653266,881653300,34,827,369,2.5714285714285716
347,4,3,-1,881653300,881653563,263,369,318,4.5046728971962615
347,3,3,0,881653563,881653584,21,318,12,4.358974358974359
347,3,5,2,881653584,881653603,19,12,55,4.051282051282051
347,5,2,-3,881653603,881653635,32,55,421,3.462962962962963
347,2,4,2,881653635,881653669,34,421,223,4.108695652173913
347,4,5,1,881653669,881653687,18,223,69,3.8015873015873014
347,5,5,0,881653687,881653736,49,69,182,3.842857142857143
347,5,5,0,881653736,881653774,38,182,357,4.063291139240507
347,5,4,-1,881653774,881653775,1,357,96,3.9130434782608696
347,4,3,-1,881653775,881653830,55,96,87,3.9
347,3,3,0,881653830,881653866,36,87,176,3.967032967032967
347,3,5,2,881653866,881653890,24,176,79,3.956989247311828
347,5,5,0,881653890,881653912,22,79,186,3.905263157894737
347,5,3,-2,881653912,881653933,21,186,216,3.8454545454545452
347,3,5,2,881653933,881653973,40,216,655,3.7857142857142856
347,5,4,-1,881653973,881654004,31,655,427,4.2025316455696204
347,4,5,1,881654004,881654005,1,427,22,4.215909090909091
347,5,5,0,881654005,881654064,59,22,132,3.929411764705882
347,5,4,-1,881654064,881654101,37,132,97,3.7282608695652173
347,4,5,1,881654101,881654156,55,97,693,3.6285714285714286
347,5,5,0,881654156,881654186,30,693,144,3.9545454545454546
347,5,5,0,881654186,881654211,25,144,435,3.8933333333333335
347,5,4,-1,881654211,881654248,37,435,174,4.253521126760563
347,4,5,1,881654248,881654269,21,174,82,3.6741573033707864
347,5,3,-2,881654269,881654301,32,82,123,3.297872340425532
347,3,5,2,881654301,881654321,20,123,31,3.642857142857143
347,5,2,-3,881654321,881654359,38,31,462,3.7954545454545454
347,2,5,3,881654359,881654386,27,462,77,3.3857142857142857
347,5,1,-4,881654386,881654409,23,77,317,3.774193548387097
347,1,4,3,881654409,881654410,1,317,95,3.8194444444444446
347,4,2,-2,881654410,881654428,18,95,70,3.5833333333333335
347,2,4,2,881654428,881654452,24,70,4,3.5538461538461537
347,4,5,1,881654452,881654480,28,4,188,3.625
347,5,2,-3,881654480,881654503,23,188,173,4.1441441441441444
347,2,3,1,881654503,881654522,19,173,1035,3.03125
347,3,4,1,881654522,881654545,23,1035,943,3.6666666666666665
347,4,5,1,881654545,881654567,22,943,157,3.5714285714285716
347,5,3,-2,881654567,881654591,24,157,99,3.8392857142857144
347,3,2,-1,881654591,881654592,1,99,392,3.5555555555555554
347,2,4,2,881654592,881654612,20,392,28,3.923076923076923
347,4,4,0,881654612,881654635,23,28,17,3.032258064516129
347,4,2,-2,881654635,881654679,44,17,65,3.511111111111111
347,2,1,-1,881654679,881654715,36,65,371,3.0
347,1,3,2,881654715,881654752,37,371,164,3.6140350877192984
347,3,3,0,881654752,881654773,21,164,158,2.7027027027027026
347,3,4,1,881654773,881654801,28,158,163,3.53125
347,4,5,1,881654801,881654880,79,163,85,3.3157894736842106
273,4,4,0,891292811,891292846,35,272,315,4.15
273,4,3,-1,891292846,891292873,27,315,313,4.323076923076923
273,3,4,1,891292873,891292905,32,313,311,3.761904761904762
273,4,3,-1,891292905,891292935,30,311,304,3.5306122448979593
273,3,4,1,891292935,891293008,73,304,347,3.59375
273,4,4,0,891293008,891293048,40,347,303,3.75
273,4,3,-1,891293048,891293108,60,303,345,3.4782608695652173
273,3,4,1,891293108,891293201,93,345,316,4.285714285714286
273,4,3,-1,891293201,891293304,103,316,338,2.75
55,3,3,0,878176047,878176084,37,117,257,3.7154471544715446
55,3,2,-1,878176084,878176206,122,257,254,2.7419354838709675
55,2,5,3,878176206,878176397,191,254,22,4.215909090909091
55,5,5,0,878176397,878176398,1,22,89,3.9615384615384617
349,4,5,1,879465477,879465569,92,9,10,3.85
349,5,5,0,879465569,879465642,73,10,20,3.375
349,5,3,-2,879465642,879465673,31,20,713,3.5
349,3,2,-1,879465673,879465712,39,713,455,3.1702127659574466
349,2,2,0,879465712,879465785,73,455,744,3.5714285714285716
349,2,2,0,879465785,879465814,29,744,596,3.180327868852459
349,2,5,3,879465814,879465841,27,596,276,3.6036036036036037
349,5,4,-1,879465841,879465933,92,276,458,3.0588235294117645
349,4,3,-1,879465933,879465934,1,458,696,3.138888888888889
349,3,3,0,879465934,879465966,32,696,25,3.3185840707964602
349,3,4,1,879465966,879466000,34,25,619,3.4782608695652173
349,4,3,-1,879466000,879466118,118,619,985,2.9
349,3,5,2,879466118,879466156,38,985,284,3.1547619047619047
349,5,2,-3,879466156,879466200,44,284,1028,2.857142857142857
349,2,1,-1,879466200,879466283,83,1028,106,2.8125
349,1,3,2,879466283,879466334,51,106,120,2.3421052631578947
349,3,1,-2,879466334,879466366,32,120,412,2.272727272727273
349,1,4,3,879466366,879466479,113,412,100,4.0162162162162165
349,4,4,0,879466479,879466507,28,100,847,3.7333333333333334
349,4,4,0,879466507,879466541,34,847,125,3.5555555555555554
348,5,4,-1,886522579,886522658,79,323,294,3.1052631578947367
348,4,3,-1,886522658,886522740,82,294,243,2.357142857142857
348,3,4,1,886522740,886522765,25,243,245,3.056179775280899
348,4,3,-1,886522765,886522799,34,245,988,2.5555555555555554
348,3,4,1,886522799,886523207,408,988,100,4.0162162162162165
348,4,4,0,886523207,886523256,49,100,117,3.689189189189189
348,4,4,0,886523256,886523302,46,117,7,3.76056338028169
348,4,4,0,886523302,886523330,28,7,15,3.725663716814159
348,4,5,1,886523330,886523361,31,15,147,3.3142857142857145
348,5,4,-1,886523361,886523387,26,147,827,2.4375
348,4,3,-1,886523387,886523456,69,827,151,3.6544117647058822
348,3,3,0,886523456,886523560,104,151,473,2.9166666666666665
348,3,4,1,886523560,886523588,28,473,118,3.2764227642276422
348,4,4,0,886523588,886523621,33,118,370,2.8125
348,4,3,-1,886523621,886523645,24,370,225,3.0714285714285716
348,3,4,1,886523645,886523683,38,225,974,3.125
348,4,3,-1,886523683,886523758,75,974,369,2.5714285714285716
348,3,5,2,886523758,886523790,32,369,1061,2.9166666666666665
348,5,4,-1,886523790,886523813,23,1061,975,3.411764705882353
348,4,3,-1,886523813,886523839,26,975,240,3.0350877192982457
348,3,3,0,886523839,886523876,37,240,368,1.8823529411764706
348,3,4,1,886523876,886523913,37,368,831,2.6097560975609757
354,5,5,0,891180419,891180445,26,904,306,4.033333333333333
354,5,4,-1,891180445,891180489,44,306,305,3.5789473684210527
354,4,4,0,891180489,891180527,38,305,900,4.2
354,4,5,1,891180527,891180548,21,900,303,3.75
354,5,4,-1,891180548,891180569,21,303,308,3.6153846153846154
354,4,2,-2,891180569,891216128,35559,308,321,3.0172413793103448
354,2,4,2,891216128,891216157,29,321,882,3.6666666666666665
354,4,4,0,891216157,891216526,369,882,275,4.087912087912088
354,4,4,0,891216526,891216549,23,275,1007,4.117647058823529
354,4,4,0,891216549,891216575,26,1007,14,4.101694915254237
354,4,4,0,891216575,891216607,32,14,936,3.727272727272727
354,4,5,1,891216607,891216632,25,936,124,4.052631578947368
354,5,4,-1,891216632,891216656,24,124,181,3.98974358974359
354,4,5,1,891216656,891216691,35,181,251,3.8333333333333335
354,5,5,0,891216691,891216692,1,251,10,3.85
354,5,3,-2,891216692,891216713,21,10,847,3.7333333333333334
354,3,3,0,891216713,891216735,22,847,257,3.7154471544715446
354,3,3,0,891216735,891216760,25,257,276,3.6036036036036037
354,3,5,2,891216760,891216788,28,276,676,3.3142857142857145
354,5,5,0,891216788,891216805,17,676,533,3.6
354,5,3,-2,891216805,891216825,20,533,13,3.5454545454545454
354,3,3,0,891216825,891216854,29,13,222,3.578125
354,3,4,1,891216854,891216875,21,222,1241,2.6666666666666665
354,4,3,-1,891216875,891216896,21,1241,1017,3.0
354,3,1,-2,891216896,891216915,19,1017,281,3.2
354,1,4,3,891216915,891216956,41,281,248,3.746268656716418
354,4,3,-1,891216956,891217109,153,248,496,4.094594594594595
354,3,4,1,891217109,891217110,1,496,47,3.5869565217391304
354,4,5,1,891217110,891217160,50,47,213,3.943396226415094
354,5,4,-1,891217160,891217194,34,213,494,3.8333333333333335
354,4,4,0,891217194,891217221,27,494,659,4.027777777777778
354,4,3,-1,891217221,891217249,28,659,189,3.88
354,3,3,0,891217249,891217274,25,189,180,3.9473684210526314
354,3,4,1,891217274,891217298,24,180,428,3.744186046511628
354,4,5,1,891217298,891217299,1,428,694,4.277777777777778
354,5,3,-2,891217299,891217365,66,694,318,4.5046728971962615
354,3,4,1,891217365,891217429,64,318,610,3.1818181818181817
354,4,4,0,891217429,891217449,20,610,631,3.581818181818182
354,4,5,1,891217449,891217547,98,631,52,3.727272727272727
354,5,4,-1,891217547,891217610,63,52,529,4.142857142857143
354,4,5,1,891217610,891217633,23,529,606,4.294117647058823
354,5,3,-2,891217633,891217659,26,606,629,3.3333333333333335
354,3,3,0,891217659,891217693,34,629,651,3.8627450980392157
354,3,3,0,891217693,891217717,24,651,210,3.921259842519685
354,3,4,1,891217717,891217755,38,210,165,3.9130434782608696
354,4,5,1,891217755,891217782,27,165,513,4.526315789473684
354,5,3,-2,891217782,891217811,29,513,131,3.731707317073171
354,3,4,1,891217811,891217897,86,131,154,3.6031746031746033
354,4,5,1,891217897,891217928,31,154,709,4.171428571428572
354,5,3,-2,891217928,891217929,1,709,32,3.7222222222222223
354,3,5,2,891217929,891217966,37,32,889,3.6666666666666665
354,5,3,-2,891217966,891218003,37,889,1101,3.793103448275862
354,3,5,2,891218003,891218024,21,1101,175,3.8354430379746836
354,5,4,-1,891218024,891218046,22,175,65,3.511111111111111
354,4,5,1,891218046,891218091,45,65,811,4.166666666666667
354,5,3,-2,891218091,891218116,25,811,462,3.7954545454545454
354,3,5,2,891218116,891218155,39,462,528,4.241379310344827
354,5,3,-2,891218155,891218208,53,528,70,3.5833333333333335
354,3,3,0,891218208,891218230,22,70,135,3.7974683544303796
354,3,5,2,891218230,891218249,19,135,509,3.7058823529411766
354,5,4,-1,891218249,891218271,22,509,956,3.5714285714285716
354,4,4,0,891218271,891218289,18,956,657,4.341463414634147
354,4,3,-1,891218289,891218312,23,657,98,4.240875912408759
354,3,4,1,891218312,891218379,67,98,166,4.0
354,4,3,-1,891218379,891218380,1,166,432,3.719298245614035
354,3,3,0,891218380,891218439,59,432,429,3.742857142857143
354,3,3,0,891218439,891218457,18,429,196,3.9404761904761907
354,3,4,1,891218457,891218492,35,196,414,3.3076923076923075
354,4,5,1,891218492,891218507,15,414,168,4.0476190476190474
354,5,5,0,891218507,891218568,61,168,736,4.083333333333333
354,5,3,-2,891218568,891219432,864,736,1085,4.0
354,3,3,0,891219432,891306892,87460,1085,507,3.6285714285714286
354,3,3,0,891306892,891306919,27,507,863,3.727272727272727
354,3,4,1,891306919,891306946,27,863,661,4.133333333333334
354,4,3,-1,891306946,891306974,28,661,152,3.6785714285714284
354,3,2,-1,891306974,891307069,95,152,747,3.5526315789473686
354,2,2,0,891307069,891307114,45,747,692,3.56
354,2,2,0,891307114,891307157,43,692,732,3.6266666666666665
354,2,2,0,891307157,891307180,23,732,66,3.4705882352941178
354,2,4,2,891307180,891307206,26,66,737,3.12
351,4,2,-2,879481425,879481460,35,341,880,2.8421052631578947
351,2,5,3,879481460,879481461,1,880,879,3.2291666666666665
351,5,5,0,879481461,879481495,34,879,332,3.6511627906976742
351,5,3,-2,879481495,879481643,148,332,873,2.7586206896551726
351,3,5,2,879481643,879481675,32,873,984,2.6666666666666665
351,5,3,-2,879481675,883356591,3874916,984,895,3.142857142857143
351,3,5,2,883356591,883356614,23,895,754,3.5789473684210527
351,5,5,0,883356614,883356684,70,754,327,3.5076923076923077
351,5,5,0,883356684,883356710,26,327,323,3.0
351,5,5,0,883356710,883356784,74,323,312,3.0
351,5,5,0,883356784,883356810,26,312,750,4.027777777777778
351,5,4,-1,883356810,883356883,73,750,1316,4.0
358,1,5,4,891269117,891269179,62,127,8,3.903225806451613
358,5,4,-1,891269179,891269511,332,8,558,3.75
358,4,3,-1,891269511,891269584,73,558,638,3.923076923076923
358,3,5,2,891269584,891269617,33,638,1159,4.0
358,5,4,-1,891269617,891269666,49,1159,179,3.8823529411764706
358,4,4,0,891269666,891269723,57,179,1005,4.166666666666667
358,4,4,0,891269723,891269827,104,1005,1396,4.0
358,4,5,1,891269827,891269913,86,1396,1006,2.7777777777777777
358,5,3,-2,891269913,891270043,130,1006,1149,3.857142857142857
358,3,3,0,891270043,891270091,48,1149,643,3.0
358,3,2,-1,891270091,891270510,419,643,482,3.9444444444444446
358,2,1,-1,891270510,891270560,50,482,174,4.253521126760563
358,1,4,3,891270560,891271063,503,174,469,3.6842105263157894
352,3,5,2,884289729,884289759,30,228,172,4.225225225225225
352,5,5,0,884289759,884289760,1,172,174,4.253521126760563
352,5,4,-1,884289760,884290390,630,174,216,3.8454545454545452
352,4,4,0,884290390,884290428,38,216,100,4.0162162162162165
352,4,4,0,884290428,884290549,121,100,234,3.7674418604651163
352,4,1,-3,884290549,884290574,25,234,175,3.8354430379746836
360,4,4,0,880353526,880353584,58,302,308,3.6153846153846154
360,4,4,0,880353584,880353585,1,308,258,3.7547169811320753
360,4,4,0,880353585,880353616,31,258,242,3.5217391304347827
360,4,4,0,880353616,880353660,44,242,304,3.5306122448979593
360,4,4,0,880353660,880354181,521,304,936,3.727272727272727
360,4,4,0,880354181,880354250,69,936,1142,4.0476190476190474
360,4,3,-1,880354250,880354275,25,1142,116,3.6666666666666665
360,3,5,2,880354275,880354315,40,116,251,3.8333333333333335
360,5,3,-2,880354315,880354347,32,251,405,3.25
360,3,5,2,880354347,880354379,32,405,137,3.9545454545454546
360,5,3,-2,880354379,880354436,57,137,15,3.725663716814159
360,3,4,1,880354436,880354484,48,15,297,4.142857142857143
360,4,5,1,880354484,880354624,140,297,10,3.85
360,5,3,-2,880354624,880354942,318,10,845,3.661290322580645
360,3,3,0,880354942,880354991,49,845,284,3.1547619047619047
360,3,4,1,880354991,880355066,75,284,744,3.5714285714285716
360,4,2,-2,880355066,880355094,28,744,222,3.578125
360,2,4,2,880355094,880355177,83,222,471,3.5714285714285716
360,4,4,0,880355177,880355209,32,471,25,3.3185840707964602
360,4,3,-1,880355209,880355261,52,25,1134,2.888888888888889
360,3,4,1,880355261,880355353,92,1134,181,3.98974358974359
360,4,5,1,880355353,880355448,95,181,963,3.9285714285714284
360,5,5,0,880355448,880355485,37,963,170,4.242424242424242
360,5,4,-1,880355485,880355527,42,170,187,4.215189873417722
360,4,4,0,880355527,880355594,67,187,582,3.7457627118644066
360,4,4,0,880355594,880355623,29,582,423,3.7016129032258065
360,4,5,1,880355623,880355678,55,423,199,4.191489361702128
360,5,4,-1,880355678,880355747,69,199,45,4.130434782608695
360,4,5,1,880355747,880355803,56,45,223,4.108695652173913
360,5,4,-1,880355803,880355958,155,223,191,4.168674698795181
360,4,5,1,880355958,880355994,36,191,511,4.096153846153846
360,5,4,-1,880355994,880356025,31,511,1149,3.857142857142857
360,4,4,0,880356025,880356059,34,1149,165,3.9130434782608696
360,4,3,-1,880356059,880356092,33,165,496,4.094594594594595
360,3,5,2,880356092,880356131,39,496,661,4.133333333333334
360,5,3,-2,880356131,880356240,109,661,174,4.253521126760563
363,3,1,-2,891493603,891493634,31,315,333,3.546666666666667
363,1,4,3,891493634,891493723,89,333,288,3.5214285714285714
363,4,4,0,891493723,891493746,23,288,346,3.5128205128205128
363,4,1,-3,891493746,891493772,26,346,751,3.3896103896103895
363,1,5,4,891493772,891493795,23,751,307,3.6031746031746033
363,5,3,-2,891493795,891493840,45,307,895,3.142857142857143
363,3,2,-1,891493840,891493864,24,895,351,2.4444444444444446
363,2,5,3,891493864,891493885,21,351,752,3.6666666666666665
363,5,3,-2,891493885,891493918,33,752,301,3.2465753424657535
363,3,2,-1,891493918,891493959,41,301,322,3.0476190476190474
363,2,1,-1,891493959,891494012,53,322,678,2.8181818181818183
363,1,5,4,891494012,891494587,575,678,11,3.8904109589041096
363,5,3,-2,891494587,891494628,41,11,9,3.8878504672897196
363,3,5,2,891494628,891494658,30,9,173,4.1441441441441444
363,5,5,0,891494658,891494659,1,173,919,4.0
363,5,5,0,891494659,891494688,29,919,114,4.3478260869565215
363,5,3,-2,891494688,891494754,66,114,24,3.3728813559322033
363,3,5,2,891494754,891494783,29,24,181,3.98974358974359
363,5,4,-1,891494783,891494835,52,181,518,3.5833333333333335
363,4,3,-1,891494835,891494865,30,518,186,3.905263157894737
363,3,4,1,891494865,891494905,40,186,210,3.921259842519685
363,4,5,1,891494905,891494906,1,210,152,3.6785714285714284
363,5,5,0,891494906,891494929,23,152,474,4.172413793103448
363,5,3,-2,891494929,891494962,33,474,156,4.017857142857143
363,3,4,1,891494962,891495003,41,156,709,4.171428571428572
363,4,3,-1,891495003,891495004,1,709,1101,3.793103448275862
363,3,4,1,891495004,891495109,105,1101,176,3.967032967032967
363,4,3,-1,891495109,891495143,34,176,163,3.53125
363,3,5,2,891495143,891495168,25,163,50,4.306532663316583
363,5,3,-2,891495168,891495197,29,50,234,3.7674418604651163
363,3,3,0,891495197,891495238,41,234,505,4.0625
363,3,3,0,891495238,891495301,63,505,71,3.6575342465753424
363,3,3,0,891495301,891495338,37,71,741,3.3043478260869565
363,3,2,-1,891495338,891495371,33,741,705,3.7857142857142856
363,2,4,2,891495371,891495510,139,705,778,3.5925925925925926
363,4,4,0,891495510,891495595,85,778,116,3.6666666666666665
363,4,4,0,891495595,891495630,35,116,746,3.7560975609756095
363,4,3,-1,891495630,891495711,81,746,461,3.3333333333333335
363,3,5,2,891495711,891495742,31,461,137,3.9545454545454546
363,5,2,-3,891495742,891495809,67,137,68,3.5714285714285716
363,2,3,1,891495809,891495849,40,68,675,3.625
363,3,3,0,891495849,891495850,1,675,435,3.8933333333333335
363,3,3,0,891495850,891495879,29,435,216,3.8454545454545452
363,3,5,2,891495879,891495918,39,216,747,3.5526315789473686
363,5,2,-3,891495918,891495987,69,747,284,3.1547619047619047
363,2,3,1,891495987,891496077,90,284,589,4.384615384615385
363,3,4,1,891496077,891496102,25,589,1485,4.0
363,4,1,-3,891496102,891496103,1,1485,557,3.090909090909091
363,1,4,3,891496103,891496169,66,557,1056,3.3333333333333335
363,4,4,0,891496169,891496190,21,1056,208,3.8125
363,4,5,1,891496190,891496264,74,208,47,3.5869565217391304
363,5,3,-2,891496264,891496306,42,47,215,3.662921348314607
363,3,3,0,891496306,891496337,31,215,25,3.3185840707964602
363,3,2,-1,891496337,891496373,36,25,70,3.5833333333333335
363,2,5,3,891496373,891496414,41,70,1019,3.7777777777777777
363,5,4,-1,891496414,891496481,67,1019,380,3.4878048780487805
363,4,2,-2,891496481,891496513,32,380,97,3.7282608695652173
363,2,2,0,891496513,891496543,30,97,673,3.393939393939394
363,2,2,0,891496543,891496587,44,673,1168,3.4166666666666665
363,2,4,2,891496587,891496616,29,1168,81,3.2857142857142856
363,4,2,-2,891496616,891496667,51,81,32,3.7222222222222223
363,2,3,1,891496667,891496694,27,32,95,3.8194444444444446
363,3,2,-1,891496694,891496722,28,95,164,3.6140350877192984
363,2,4,2,891496722,891496753,31,164,161,3.5844155844155843
363,4,4,0,891496753,891496849,96,161,66,3.4705882352941178
363,4,1,-3,891496849,891496850,1,66,72,3.175438596491228
363,1,3,2,891496850,891496927,77,72,44,3.1333333333333333
363,3,1,-2,891496927,891496953,26,44,101,3.4827586206896552
363,1,2,1,891496953,891497076,123,101,742,3.5555555555555554
363,2,5,3,891497076,891497130,54,742,235,3.106382978723404
363,5,1,-4,891497130,891497174,44,235,737,3.12
363,1,4,3,891497174,891497205,31,737,550,3.272727272727273
363,4,4,0,891497205,891497277,72,550,679,3.2432432432432434
363,4,5,1,891497277,891497278,1,679,1495,5.0
363,5,3,-2,891497278,891497393,115,1495,229,3.185185185185185
363,3,3,0,891497393,891497439,46,229,148,3.2131147540983607
363,3,2,-1,891497439,891497440,1,148,230,3.3518518518518516
363,2,1,-1,891497440,891497523,83,230,959,3.4583333333333335
363,1,4,3,891497523,891497583,60,959,238,3.888888888888889
363,4,1,-3,891497583,891497712,129,238,1214,1.8
363,1,1,0,891497712,891497748,36,1214,979,3.1
363,1,5,4,891497748,891497853,105,979,8,3.903225806451613
363,5,4,-1,891497853,891497881,28,8,825,2.914285714285714
363,4,5,1,891497881,891497953,72,825,448,3.466666666666667
363,5,1,-4,891497953,891498012,59,448,554,2.9555555555555557
363,1,4,3,891498012,891498038,26,554,625,3.25
363,4,1,-3,891498038,891498066,28,625,384,2.7941176470588234
363,1,2,1,891498066,891498087,21,384,88,3.433734939759036
363,2,4,2,891498087,891498135,48,88,227,3.169811320754717
363,4,3,-1,891498135,891498183,48,227,761,3.0588235294117645
363,3,1,-2,891498183,891498223,40,761,417,3.0588235294117645
363,1,4,3,891498223,891498286,63,417,597,3.2771084337349397
363,4,2,-2,891498286,891498365,79,597,849,2.5625
363,2,3,1,891498365,891498407,42,849,38,2.784313725490196
363,3,4,1,891498407,891498434,27,38,80,2.967741935483871
363,4,2,-2,891498434,891498558,124,80,1157,3.142857142857143
363,2,1,-1,891498558,891498589,31,1157,145,2.3636363636363638
363,1,2,1,891498589,891498681,92,145,802,3.076923076923077
363,2,1,-1,891498681,891498787,106,802,816,2.0
363,1,4,3,891498787,891498835,48,816,774,3.0
363,4,3,-1,891498835,891498863,28,774,449,2.9069767441860463
363,3,2,-1,891498863,891498884,21,449,561,3.1515151515151514
363,2,1,-1,891498884,891498920,36,561,555,2.0
363,1,2,1,891498920,891498964,44,555,665,2.72972972972973
363,2,4,2,891498964,891499355,391,665,1012,3.2916666666666665
363,4,5,1,891499355,891499411,56,1012,298,3.779220779220779
363,5,4,-1,891499411,891499437,26,298,591,3.7169811320754715
363,4,1,-3,891499437,891499468,31,591,250,3.4698795180722892
363,1,3,2,891499468,891499542,74,250,256,3.5
363,3,2,-1,891499542,891499595,53,256,257,3.7154471544715446
363,2,1,-1,891499595,891499760,165,257,1014,3.1
363,1,3,2,891499760,891499875,115,1014,1013,2.388888888888889
363,3,1,-2,891499875,891499993,118,1013,760,2.35
363,1,3,2,891499993,891500134,141,760,1052,2.4545454545454546
363,3,2,-1,891500134,891500179,45,1052,767,3.0
363,2,1,-1,891500179,891500218,39,767,120,2.3421052631578947
363,1,3,2,891500218,891500269,51,120,370,2.8125
363,3,4,1,891500269,891500334,65,370,443,3.8421052631578947
363,4,4,0,891500334,891500406,72,443,444,2.6842105263157894
363,4,3,-1,891500406,891500527,121,444,590,1.8888888888888888
355,4,4,0,879485523,879486422,899,681,328,3.4895833333333335
355,4,4,0,879486422,879486529,107,328,300,3.6861313868613137
362,5,4,-1,885019261,885019304,43,333,288,3.5214285714285714
362,4,4,0,885019304,885019435,131,288,258,3.7547169811320753
362,4,2,-2,885019435,885019504,69,258,328,3.4895833333333335
362,2,5,3,885019504,885019537,33,328,350,3.2
362,5,1,-4,885019537,885019592,55,350,748,3.1043478260869564
362,1,1,0,885019592,885019695,103,748,264,2.65
362,1,1,0,885019695,885019722,27,264,683,2.176470588235294
362,1,2,1,885019722,885019746,24,683,1025,2.95
357,3,5,2,878951101,878951217,116,322,117,3.689189189189189
357,5,5,0,878951217,878951498,281,117,471,3.5714285714285716
357,5,3,-2,878951498,878951537,39,471,7,3.76056338028169
357,3,5,2,878951537,878951576,39,7,713,3.5
357,5,4,-1,878951576,878951615,39,713,150,3.803921568627451
357,4,4,0,878951615,878951653,38,150,819,2.6666666666666665
357,4,5,1,878951653,878951728,75,819,151,3.6544117647058822
357,5,5,0,878951728,878951729,1,151,546,2.9789473684210526
357,5,5,0,878951729,878951784,55,546,405,3.25
357,5,5,0,878951784,878951831,47,405,10,3.85
357,5,4,-1,878951831,878951864,33,10,123,3.297872340425532
357,4,2,-2,878951864,878951918,54,123,412,2.272727272727273
357,2,5,3,878951918,878951954,36,412,220,3.433333333333333
357,5,3,-2,878951954,878951984,30,220,826,2.5555555555555554
357,3,4,1,878951984,878952041,57,826,928,3.142857142857143
357,4,4,0,878952041,878952137,96,928,291,3.2
357,4,3,-1,878952137,878952190,53,291,1095,2.8
357,3,4,1,878952190,878952265,75,1095,287,3.4516129032258065
357,4,4,0,878952265,878952341,76,287,833,2.9444444444444446
357,4,4,0,878952341,878952342,1,833,105,2.6176470588235294
356,5,4,-1,891405651,891406040,389,313,307,3.6031746031746033
356,4,1,-3,891406040,891406076,36,307,294,3.1052631578947367
356,1,4,3,891406076,891406193,117,294,326,3.262295081967213
356,4,1,-3,891406193,891406241,48,326,892,2.9615384615384617
356,1,3,2,891406241,891406289,48,892,322,3.0476190476190474
356,3,3,0,891406289,891406317,28,322,312,3.0
356,3,5,2,891406317,891406372,55,312,689,3.1538461538461537
356,5,4,-1,891406372,891406500,128,689,748,3.1043478260869564
361,2,4,2,879440345,879440346,1,150,652,3.9642857142857144
361,4,5,1,879440346,879440386,40,652,100,4.0162162162162165
361,5,4,-1,879440386,879440475,89,100,813,4.055555555555555
361,4,4,0,879440475,879440516,41,813,285,4.181818181818182
361,4,4,0,879440516,879440545,29,285,207,3.4761904761904763
361,4,5,1,879440545,879440573,28,207,165,3.9130434782608696
361,5,4,-1,879440573,879440605,32,165,60,4.105263157894737
361,4,4,0,879440605,879440651,46,60,14,4.101694915254237
361,4,4,0,879440651,879440652,1,14,639,4.083333333333333
361,4,4,0,879440652,879440694,42,639,283,3.901639344262295
361,4,5,1,879440694,879440739,45,283,197,4.112676056338028
361,5,5,0,879440739,879440774,35,197,173,4.1441441441441444
361,5,3,-2,879440774,879440941,167,173,26,3.36
361,3,3,0,879440941,879440974,33,26,111,3.5106382978723403
361,3,2,-1,879440974,879441008,34,111,1152,3.4375
361,2,3,1,879441008,879441033,25,1152,794,3.6
361,3,3,0,879441033,879441034,1,794,274,3.5609756097560976
361,3,3,0,879441034,879441179,145,274,49,3.3
361,3,4,1,879441179,879441214,35,49,12,4.358974358974359
361,4,4,0,879441214,879441252,38,12,156,4.017857142857143
361,4,4,0,879441252,879441253,1,156,525,4.0
361,4,4,0,879441253,879441285,32,525,183,3.951219512195122
361,4,4,0,879441285,879441286,1,183,673,3.393939393939394
361,4,1,-3,879441286,879441351,65,673,742,3.5555555555555554
361,1,3,2,879441351,879441352,1,742,770,3.25
361,3,4,1,879441352,879441416,64,770,498,4.290909090909091
361,4,4,0,879441416,879441417,1,498,276,3.6036036036036037
361,4,4,0,879441417,879441462,45,276,611,4.384615384615385
365,4,2,-2,891303408,891303454,46,271,1420,1.5
365,2,5,3,891303454,891303474,20,1420,268,3.9838709677419355
365,5,4,-1,891303474,891303515,41,268,258,3.7547169811320753
365,4,5,1,891303515,891303536,21,258,340,3.7419354838709675
365,5,1,-4,891303536,891303566,30,340,309,2.3333333333333335
365,1,3,2,891303566,891303638,72,309,908,2.5714285714285716
365,3,3,0,891303638,891303694,56,908,289,2.988888888888889
365,3,1,-2,891303694,891303728,34,289,352,1.8333333333333333
365,1,1,0,891303728,891303760,32,352,894,2.0
365,1,1,0,891303760,891303809,49,894,948,2.2962962962962963
365,1,3,2,891303809,891303950,141,948,13,3.5454545454545454
365,3,4,1,891303950,891303999,49,13,285,4.181818181818182
365,4,4,0,891303999,891304019,20,285,275,4.087912087912088
365,4,4,0,891304019,891304039,20,275,124,4.052631578947368
365,4,2,-2,891304039,891304059,20,124,741,3.3043478260869565
365,2,4,2,891304059,891304078,19,741,277,3.6
365,4,2,-2,891304078,891304213,135,277,7,3.76056338028169
365,2,3,1,891304213,891304278,65,7,237,3.7315436241610738
365,3,4,1,891304278,891304300,22,237,762,3.3962264150943398
365,4,4,0,891304300,891304301,1,762,287,3.4516129032258065
350,4,5,1,882345384,882345502,118,324,50,4.306532663316583
350,5,4,-1,882345502,882345734,232,50,1,3.902439024390244
350,4,5,1,882345734,882345789,55,1,479,4.25
350,5,5,0,882345789,882345823,34,479,172,4.225225225225225
350,5,5,0,882345823,882345918,95,172,480,4.283018867924528
350,5,5,0,882345918,882345975,57,480,603,4.315789473684211
350,5,5,0,882345975,882346086,111,603,604,3.8181818181818183
350,5,5,0,882346086,882346118,32,604,427,4.2025316455696204
350,5,4,-1,882346118,882346161,43,427,530,4.125
350,4,4,0,882346161,882346257,96,530,340,3.7419354838709675
350,4,4,0,882346257,882346720,463,340,181,3.98974358974359
350,4,5,1,882346720,882346900,180,181,133,3.7777777777777777
350,5,3,-2,882346900,882347466,566,133,271,3.3134328358208953
350,3,4,1,882347466,882347598,132,271,228,3.7246376811594204
350,4,4,0,882347598,882347653,55,228,193,3.883720930232558
350,4,5,1,882347653,882347734,81,193,483,4.475609756097561
350,5,5,0,882347734,882347782,48,483,187,4.215189873417722
350,5,5,0,882347782,882347832,50,187,195,3.9072164948453607
367,5,4,-1,876689418,876689502,84,324,326,3.262295081967213
367,4,5,1,876689502,876689696,194,326,50,4.306532663316583
367,5,5,0,876689696,876689738,42,50,176,3.967032967032967
367,5,5,0,876689738,876689790,52,176,919,4.0
367,5,5,0,876689790,876689824,34,919,250,3.4698795180722892
367,5,4,-1,876689824,876689825,1,250,1012,3.2916666666666665
367,4,5,1,876689825,876689878,53,1012,7,3.76056338028169
367,5,4,-1,876689878,876689879,1,7,413,2.5652173913043477
367,4,4,0,876689879,876689962,83,413,218,3.5555555555555554
367,4,5,1,876689962,876689990,28,218,184,3.393939393939394
367,5,4,-1,876689990,876689991,1,184,5,3.1481481481481484
367,4,5,1,876689991,876690021,30,5,217,3.1538461538461537
367,5,4,-1,876690021,876690048,27,217,379,3.35
367,4,3,-1,876690048,876690049,1,379,441,2.4
367,3,4,1,876690049,876690076,27,441,53,2.9523809523809526
367,4,3,-1,876690076,876690077,1,53,769,2.2222222222222223
367,3,4,1,876690077,876690098,21,769,448,3.466666666666667
367,4,4,0,876690098,876690119,21,448,443,3.8421052631578947
367,4,4,0,876690119,876690120,1,443,452,2.6129032258064515
368,3,3,0,889783364,889783365,1,164,448,3.466666666666667
368,3,3,0,889783365,889783453,88,448,288,3.5214285714285714
368,3,3,0,889783453,889783454,1,288,5,3.1481481481481484
368,3,5,2,889783454,889783562,108,5,217,3.1538461538461537
368,5,2,-3,889783562,889783586,24,217,145,2.3636363636363638
368,2,3,1,889783586,889783617,31,145,441,2.4
368,3,5,2,889783617,889783678,61,441,183,3.951219512195122
371,5,4,-1,877487052,877487135,83,237,177,3.875
371,4,4,0,877487135,877487213,78,177,66,3.4705882352941178
371,4,5,1,877487213,877487309,96,66,527,3.823529411764706
371,5,4,-1,877487309,877487364,55,527,55,4.051282051282051
371,4,4,0,877487364,877487440,76,55,1,3.902439024390244
371,4,4,0,877487440,877487656,216,1,627,3.3823529411764706
371,4,3,-1,877487656,877487751,95,627,435,3.8933333333333335
371,3,4,1,877487751,880435210,2947459,435,523,4.159090909090909
371,4,5,1,880435210,880435238,28,523,663,3.948717948717949
371,5,4,-1,880435238,880435313,75,663,210,3.921259842519685
371,4,5,1,880435313,880435544,231,210,265,3.710144927536232
371,5,5,0,880435544,880435576,32,265,31,3.642857142857143
371,5,5,0,880435576,880435601,25,31,77,3.3857142857142857
371,5,2,-3,880435601,880435634,33,77,452,2.6129032258064515
371,2,3,1,880435634,880435733,99,452,449,2.9069767441860463
373,4,5,1,877098042,877098075,33,748,269,4.085106382978723
373,5,5,0,877098075,877098177,102,269,210,3.921259842519685
373,5,4,-1,877098177,877098262,85,210,633,3.9
373,4,5,1,877098262,877098297,35,633,168,4.0476190476190474
373,5,3,-2,877098297,877098343,46,168,842,3.0
373,3,5,2,877098343,877098374,31,842,655,3.7857142857142856
373,5,5,0,877098374,877098402,28,655,114,4.3478260869565215
373,5,4,-1,877098402,877098437,35,114,209,3.8275862068965516
373,4,5,1,877098437,877098487,50,209,196,3.9404761904761907
373,5,4,-1,877098487,877098568,81,196,15,3.725663716814159
373,4,4,0,877098568,877098643,75,15,499,4.0
373,4,4,0,877098643,877098678,35,499,520,4.136363636363637
373,4,4,0,877098678,877098714,36,520,746,3.7560975609756095
373,4,2,-2,877098714,877098751,37,746,20,3.375
373,2,1,-1,877098751,877098784,33,20,135,3.7974683544303796
373,1,3,2,877098784,877098821,37,135,217,3.1538461538461537
373,3,2,-1,877098821,877098849,28,217,187,4.215189873417722
373,2,3,1,877098849,877098890,41,187,390,4.0
373,3,5,2,877098890,877098891,1,390,71,3.6575342465753424
373,5,5,0,877098891,877098919,28,71,154,3.6031746031746033
373,5,5,0,877098919,877098949,30,154,432,3.719298245614035
373,5,5,0,877098949,877099016,67,432,169,4.548387096774194
373,5,4,-1,877099016,877099048,32,169,648,3.9545454545454546
373,4,5,1,877099048,877099091,43,648,99,3.8392857142857144
373,5,3,-2,877099091,877099092,1,99,417,3.0588235294117645
373,3,5,2,877099092,877099178,86,417,186,3.905263157894737
373,5,4,-1,877099178,877099211,33,186,215,3.662921348314607
373,4,4,0,877099211,877099263,52,215,66,3.4705882352941178
373,4,4,0,877099263,877099317,54,66,427,4.2025316455696204
373,4,3,-1,877099317,877099352,35,427,175,3.8354430379746836
373,3,4,1,877099352,877099968,616,175,131,3.731707317073171
373,4,4,0,877099968,877100016,48,131,24,3.3728813559322033
373,4,4,0,877100016,877100061,45,24,213,3.943396226415094
373,4,5,1,877100061,877100096,35,213,102,3.3684210526315788
373,5,2,-3,877100096,877100129,33,102,1006,2.7777777777777777
373,2,4,2,877100129,877100161,32,1006,58,3.543859649122807
373,4,3,-1,877100161,877100199,38,58,100,4.0162162162162165
373,3,5,2,877100199,877100326,127,100,241,3.5625
373,5,5,0,877100326,877100354,28,241,153,3.7865168539325844
373,5,3,-2,877100354,877100379,25,153,510,3.823529411764706
373,3,4,1,877100379,877100416,37,510,2,3.0851063829787235
373,4,3,-1,877100416,877100458,42,2,367,3.4242424242424243
373,3,3,0,877100458,877103935,3477,367,281,3.2
373,3,5,2,877103935,877104048,113,281,946,3.1153846153846154
373,5,1,-4,877104048,877104086,38,946,1087,1.0
373,1,4,3,877104086,877104115,29,1087,1147,3.4
373,4,4,0,877104115,877104202,87,1147,465,3.75
373,4,5,1,877104202,877104235,33,465,418,3.825
373,5,4,-1,877104235,877104284,49,418,393,3.5125
373,4,3,-1,877104284,877105005,721,393,143,3.56
373,3,4,1,877105005,877105075,70,143,660,3.71875
373,4,5,1,877105075,877105529,454,660,778,3.5925925925925926
373,5,3,-2,877105529,877105588,59,778,233,3.323529411764706
373,3,3,0,877105588,877105674,86,233,399,3.317073170731707
373,3,4,1,877105674,877105730,56,399,402,3.3076923076923075
373,4,4,0,877105730,877105809,79,402,566,3.543859649122807
373,4,4,0,877105809,877105901,92,566,529,4.142857142857143
373,4,3,-1,877105901,877106305,404,529,559,3.477272727272727
373,3,4,1,877106305,877106328,23,559,228,3.7246376811594204
373,4,4,0,877106328,877106623,295,228,88,3.433734939759036
373,4,4,0,877106623,877106711,88,88,401,2.6774193548387095
373,4,3,-1,877106711,877106741,30,401,596,3.180327868852459
373,3,4,1,877106741,877106773,32,596,208,3.8125
373,4,3,-1,877106773,877106900,127,208,756,2.6885245901639343
373,3,3,0,877106900,877106940,40,756,132,3.929411764705882
373,3,4,1,877106940,877106966,26,132,459,3.875
373,4,3,-1,877106966,877107024,58,459,226,3.378787878787879
373,3,3,0,877107024,877107043,19,226,1135,3.0526315789473686
373,3,3,0,877107043,877107235,192,1135,80,2.967741935483871
373,3,2,-1,877107235,877107379,144,80,1228,2.5
373,2,3,1,877107379,877107403,24,1228,386,2.769230769230769
373,3,5,2,877107403,877107430,27,386,451,3.207792207792208
373,5,3,-2,877107430,877111362,3932,451,142,3.1481481481481484
373,3,4,1,877111362,877111422,60,142,404,3.6578947368421053
373,4,1,-3,877111422,877111423,1,404,577,1.7058823529411764
373,1,1,0,877111423,877111864,441,577,571,2.5
373,1,3,2,877111864,877111951,87,571,472,2.984375
373,3,4,1,877111951,877112017,66,472,380,3.4878048780487805
373,4,3,-1,877112017,877112076,59,380,598,2.5
373,3,3,0,877112076,877112116,40,598,1444,2.3333333333333335
370,5,1,-4,879434206,879434229,23,269,294,3.1052631578947367
370,1,2,1,879434229,879434265,36,294,321,3.0172413793103448
370,2,3,1,879434265,879434308,43,321,322,3.0476190476190474
370,3,2,-1,879434308,879434333,25,322,323,3.0
370,2,5,3,879434333,879434468,135,323,257,3.7154471544715446
370,5,2,-3,879434468,879434587,119,257,56,4.051724137931035
370,2,3,1,879434587,879434666,79,56,705,3.7857142857142856
370,3,3,0,879434666,879434707,41,705,116,3.6666666666666665
370,3,4,1,879434707,879434745,38,116,64,4.373737373737374
370,4,3,-1,879434745,879434746,1,64,222,3.578125
370,3,3,0,879434746,879434804,58,222,175,3.8354430379746836
370,3,4,1,879434804,879434832,28,175,181,3.98974358974359
370,4,4,0,879434832,879434859,27,181,134,4.174603174603175
370,4,3,-1,879434859,879434860,1,134,425,3.7027027027027026
370,3,5,2,879434860,879434909,49,425,835,4.0
370,5,4,-1,879434909,879434937,28,835,183,3.951219512195122
370,4,4,0,879434937,879434999,62,183,136,3.764705882352941
370,4,3,-1,879434999,879435033,34,136,494,3.8333333333333335
370,3,4,1,879435033,879435074,41,494,923,4.142857142857143
370,4,5,1,879435074,879435146,72,923,427,4.2025316455696204
370,5,5,0,879435146,879435168,22,427,607,4.136363636363637
370,5,3,-2,879435168,879435193,25,607,285,4.181818181818182
370,3,5,2,879435193,879435217,24,285,661,4.133333333333334
370,5,5,0,879435217,879435244,27,661,603,4.315789473684211
370,5,4,-1,879435244,879435369,125,603,12,4.358974358974359
370,4,5,1,879435369,879435461,92,12,209,3.8275862068965516
370,5,3,-2,879435461,879435462,1,209,42,3.893617021276596
374,5,5,0,880392237,880392268,31,310,872,3.0
374,5,2,-3,880392268,880392592,324,872,948,2.2962962962962963
374,2,1,-1,880392592,880392626,34,948,457,1.7
374,1,5,4,880392626,880392717,91,457,237,3.7315436241610738
374,5,2,-3,880392717,880392747,30,237,273,3.5238095238095237
374,2,4,2,880392747,880392778,31,273,222,3.578125
374,4,5,1,880392778,880392846,68,222,117,3.689189189189189
374,5,3,-2,880392846,880392873,27,117,124,4.052631578947368
374,3,5,2,880392873,880392936,63,124,282,3.610526315789474
374,5,4,-1,880392936,880392992,56,282,1,3.902439024390244
374,4,1,-3,880392992,880393056,64,1,9,3.8878504672897196
374,1,4,3,880393056,880393095,39,9,591,3.7169811320754715
374,4,1,-3,880393095,880393191,96,591,248,3.746268656716418
374,1,3,2,880393191,880393223,32,248,126,3.8620689655172415
374,3,2,-1,880393223,880393268,45,126,111,3.5106382978723403
374,2,4,2,880393268,880393307,39,111,685,3.2666666666666666
374,4,3,-1,880393307,880393380,73,685,15,3.725663716814159
374,3,5,2,880393380,880393424,44,15,125,3.5555555555555554
374,5,3,-2,880393424,880393425,1,125,281,3.2
374,3,5,2,880393425,880393460,35,281,762,3.3962264150943398
374,5,2,-3,880393460,880393511,51,762,123,3.297872340425532
374,2,3,1,880393511,880393553,42,123,619,3.4782608695652173
374,3,4,1,880393553,880393668,115,619,274,3.5609756097560976
374,4,5,1,880393668,880393710,42,274,458,3.0588235294117645
374,5,3,-2,880393710,880393754,44,458,763,3.347826086956522
374,3,4,1,880393754,880393783,29,763,1011,3.1
374,4,1,-3,880393783,880393864,81,1011,369,2.5714285714285716
374,1,1,0,880393864,880393892,28,369,928,3.142857142857143
374,1,5,4,880393892,880393921,29,928,1010,3.611111111111111
374,5,3,-2,880393921,880394000,79,1010,254,2.7419354838709675
374,3,2,-1,880394000,880394138,138,254,476,3.1216216216216215
374,2,2,0,880394138,880394179,41,476,930,2.793103448275862
374,2,3,1,880394179,880394233,54,930,825,2.914285714285714
374,3,3,0,880394233,880394301,68,825,235,3.106382978723404
374,3,3,0,880394301,880394331,30,235,1277,3.5555555555555554
374,3,3,0,880394331,880394367,36,1277,50,4.306532663316583
374,3,3,0,880394367,880394484,117,50,423,3.7016129032258065
374,3,5,2,880394484,880394520,36,423,223,4.108695652173913
374,5,5,0,880394520,880394716,196,223,144,3.9545454545454546
374,5,5,0,880394716,880394840,124,144,69,3.8015873015873014
374,5,5,0,880394840,880394885,45,69,56,4.051724137931035
374,5,2,-3,880394885,880394886,1,56,318,4.5046728971962615
374,2,4,2,880394886,880394997,111,318,454,3.0
374,4,4,0,880394997,880395320,323,454,732,3.6266666666666665
374,4,5,1,880395320,880395426,106,732,48,4.055555555555555
374,5,5,0,880395426,880395487,61,48,153,3.7865168539325844
374,5,5,0,880395487,880395530,43,153,174,4.253521126760563
374,5,1,-4,880395530,880395575,45,174,179,3.8823529411764706
374,1,4,3,880395575,880395604,29,179,204,3.6744186046511627
374,4,4,0,880395604,880395634,30,204,1101,3.793103448275862
374,4,3,-1,880395634,880395665,31,1101,88,3.433734939759036
374,3,5,2,880395665,880395735,70,88,200,3.8157894736842106
374,5,2,-3,880395735,880395896,161,200,89,3.9615384615384617
374,2,2,0,880395896,880395924,28,89,4,3.5538461538461537
374,2,4,2,880395924,880395973,49,4,393,3.5125
374,4,2,-2,880395973,880396080,107,393,1206,2.8333333333333335
374,2,4,2,880396080,880396256,176,1206,234,3.7674418604651163
374,4,4,0,880396256,880396292,36,234,1194,4.181818181818182
374,4,5,1,880396292,880396359,67,1194,735,3.58
374,5,4,-1,880396359,880396444,85,735,27,3.235294117647059
374,4,1,-3,880396444,880396511,67,27,463,3.6818181818181817
374,1,1,0,880396511,880396622,111,463,68,3.5714285714285716
374,1,5,4,880396622,880396659,37,68,31,3.642857142857143
374,5,3,-2,880396659,880936233,539574,31,931,2.2758620689655173
374,3,2,-1,880936233,880936289,56,931,983,2.5
374,2,5,3,880936289,880936389,100,983,546,2.9789473684210526
374,5,1,-4,880936389,880936476,87,546,823,2.75
374,1,1,0,880936476,880937253,777,823,1150,3.0
374,1,5,4,880937253,880937735,482,1150,443,3.8421052631578947
374,5,5,0,880937735,880937779,44,443,77,3.3857142857142857
374,5,5,0,880937779,880937780,1,77,229,3.185185185185185
374,5,4,-1,880937780,880937875,95,229,5,3.1481481481481484
374,4,5,1,880937875,880937920,45,5,1042,3.625
374,5,5,0,880937920,880938044,124,1042,1046,3.3529411764705883
374,5,4,-1,880938044,880938100,56,1046,1210,2.7142857142857144
374,4,3,-1,880938100,880938370,270,1210,761,3.0588235294117645
374,3,4,1,880938370,880938965,595,761,526,3.909090909090909
374,4,2,-2,880938965,880939034,69,526,184,3.393939393939394
374,2,4,2,880939034,880939035,1,184,2,3.0851063829787235
374,4,2,-2,880939035,880939126,91,2,403,3.298507462686567
374,2,3,1,880939126,880939186,60,403,576,3.125
374,3,2,-1,880939186,880939228,42,576,231,2.938775510204082
374,2,3,1,880939228,880939304,76,231,540,2.4615384615384617
374,3,1,-2,880939304,882157930,1218626,540,832,2.7142857142857144
374,1,3,2,882157930,882157967,37,832,756,2.6885245901639343
374,3,4,1,882157967,882158020,53,756,1094,3.2
374,4,3,-1,882158020,882158071,51,1094,225,3.0714285714285716
374,3,3,0,882158071,882158147,76,225,120,2.3421052631578947
374,3,4,1,882158147,882158327,180,120,820,3.0444444444444443
374,4,2,-2,882158327,882158328,1,820,122,2.282608695652174
374,2,3,1,882158328,882158521,193,122,173,4.1441441441441444
374,3,4,1,882158521,882158577,56,173,95,3.8194444444444446
374,4,4,0,882158577,882158609,32,95,789,3.7777777777777777
374,4,5,1,882158609,882158641,32,789,692,3.56
374,5,5,0,882158641,882158849,208,692,465,3.75
374,5,5,0,882158849,882158940,91,465,197,4.112676056338028
374,5,4,-1,882158940,882159077,137,197,135,3.7974683544303796
374,4,2,-2,882159077,882159114,37,135,143,3.56
374,2,4,2,882159114,882159237,123,143,637,2.888888888888889
374,4,4,0,882159237,883627129,1467892,637,412,2.272727272727273
374,4,2,-2,883627129,883627582,453,412,1093,3.0
374,2,1,-1,883627582,883628021,439,1093,1049,2.5714285714285716
374,1,1,0,883628021,883628159,138,1049,932,2.5
374,1,1,0,883628159,883628189,30,932,977,2.473684210526316
374,1,3,2,883628189,885107905,1479716,977,291,3.2
374,3,1,-2,885107905,885107929,24,291,477,3.1666666666666665
372,4,4,0,876869066,876869147,81,262,299,3.0
372,4,5,1,876869147,876869183,36,299,327,3.5076923076923077
372,5,4,-1,876869183,876869330,147,327,332,3.6511627906976742
372,4,5,1,876869330,876869387,57,332,234,3.7674418604651163
372,5,3,-2,876869387,876869388,1,234,100,4.0162162162162165
372,3,5,2,876869388,876869445,57,100,185,3.9726027397260273
372,5,4,-1,876869445,876869446,1,185,164,3.6140350877192984
372,4,5,1,876869446,876869481,35,164,218,3.5555555555555554
372,5,5,0,876869481,876869534,53,218,561,3.1515151515151514
372,5,5,0,876869534,876869667,133,561,183,3.951219512195122
372,5,5,0,876869667,876869701,34,183,23,3.9047619047619047
372,5,5,0,876869701,876869730,29,23,273,3.5238095238095237
372,5,4,-1,876869730,876869837,107,273,44,3.1333333333333333
372,4,4,0,876869837,876869878,41,44,595,2.9166666666666665
372,4,5,1,876869878,876869894,16,595,159,3.3902439024390243
372,5,4,-1,876869894,876869957,63,159,574,2.0
372,4,3,-1,876869957,876869977,20,574,649,3.625
337,5,5,0,875184353,875184413,60,742,50,4.306532663316583
337,5,3,-2,875184413,875184717,304,50,235,3.106382978723404
337,3,4,1,875184717,875184825,108,235,1016,3.559322033898305
337,4,2,-2,875184825,875185319,494,1016,450,2.2758620689655173
337,2,5,3,875185319,875185596,277,450,15,3.725663716814159
337,5,5,0,875185596,875185627,31,15,151,3.6544117647058822
337,5,5,0,875185627,875185664,37,151,121,3.521212121212121
337,5,4,-1,875185664,875236281,50617,121,636,3.4146341463414633
337,4,4,0,875236281,875236631,350,636,67,3.106382978723404
337,4,4,0,875236631,875429292,192661,67,631,3.581818181818182
378,3,4,1,880043804,880043929,125,288,304,3.5306122448979593
378,4,3,-1,880043929,880044108,179,304,875,2.736842105263158
378,3,4,1,880044108,880044221,113,875,273,3.5238095238095237
378,4,5,1,880044221,880044251,30,273,14,4.101694915254237
378,5,4,-1,880044251,880044278,27,14,508,3.6923076923076925
378,4,4,0,880044278,880044385,107,508,591,3.7169811320754715
378,4,5,1,880044385,880044419,34,591,9,3.8878504672897196
378,5,2,-3,880044419,880044454,35,9,1061,2.9166666666666665
378,2,2,0,880044454,880044488,34,1061,928,3.142857142857143
378,2,2,0,880044488,880044489,1,928,280,3.103448275862069
378,2,3,1,880044489,880044532,43,280,123,3.297872340425532
378,3,3,0,880044532,880044562,30,123,111,3.5106382978723403
378,3,2,-1,880044562,880044609,47,111,125,3.5555555555555554
378,2,2,0,880044609,880044642,33,125,409,2.9615384615384617
378,2,4,2,880044642,880044697,55,409,237,3.7315436241610738
378,4,2,-2,880044697,880044726,29,237,1047,2.6923076923076925
378,2,3,1,880044726,880044763,37,1047,597,3.2771084337349397
378,3,2,-1,880044763,880044802,39,597,287,3.4516129032258065
378,2,3,1,880044802,880044835,33,287,284,3.1547619047619047
378,3,4,1,880044835,880044879,44,284,118,3.2764227642276422
378,4,2,-2,880044879,880044944,65,118,220,3.433333333333333
378,2,4,2,880044944,880045006,62,220,235,3.106382978723404
378,4,3,-1,880045006,880045044,38,235,696,3.138888888888889
378,3,4,1,880045044,880045145,101,696,50,4.306532663316583
378,4,4,0,880045145,880045167,22,50,181,3.98974358974359
378,4,4,0,880045167,880045207,40,181,257,3.7154471544715446
378,4,4,0,880045207,880045288,81,257,252,2.911392405063291
378,4,4,0,880045288,880045553,265,252,655,3.7857142857142856
378,4,4,0,880045553,880045580,27,655,692,3.56
378,4,5,1,880045580,880045612,32,692,97,3.7282608695652173
378,5,4,-1,880045612,880045651,39,97,174,4.253521126760563
378,4,4,0,880045651,880045652,1,174,31,3.642857142857143
378,4,4,0,880045652,880045722,70,31,79,3.956989247311828
378,4,5,1,880045722,880045760,38,79,98,4.240875912408759
378,5,4,-1,880045760,880045791,31,98,99,3.8392857142857144
378,4,3,-1,880045791,880045822,31,99,180,3.9473684210526314
378,3,3,0,880045822,880045856,34,180,566,3.543859649122807
378,3,4,1,880045856,880045886,30,566,172,4.225225225225225
378,4,3,-1,880045886,880045935,49,172,496,4.094594594594595
378,3,4,1,880045935,880045989,54,496,356,3.2
378,4,4,0,880045989,880046022,33,356,143,3.56
378,4,3,-1,880046022,880046069,47,143,69,3.8015873015873014
378,3,4,1,880046069,880046100,31,69,144,3.9545454545454546
378,4,3,-1,880046100,880046132,32,144,65,3.511111111111111
378,3,3,0,880046132,880046161,29,65,238,3.888888888888889
378,3,5,2,880046161,880046229,68,238,191,4.168674698795181
378,5,4,-1,880046229,880046256,27,191,132,3.929411764705882
378,4,4,0,880046256,880046306,50,132,196,3.9404761904761907
378,4,2,-2,880046306,880046362,56,196,135,3.7974683544303796
378,2,3,1,880046362,880046408,46,135,959,3.4583333333333335
378,3,3,0,880046408,880046516,108,959,11,3.8904109589041096
378,3,4,1,880046516,880055002,8486,11,207,3.4761904761904763
378,4,3,-1,880055002,880055037,35,207,44,3.1333333333333333
378,3,3,0,880055037,880055148,111,44,239,3.423076923076923
378,3,3,0,880055148,880055186,38,239,636,3.4146341463414633
378,3,4,1,880055186,880055239,53,636,182,3.842857142857143
378,4,4,0,880055239,880055296,57,182,95,3.8194444444444446
378,4,2,-2,880055296,880055336,40,95,179,3.8823529411764706
378,2,3,1,880055336,880055396,60,179,723,3.5384615384615383
378,3,4,1,880055396,880055454,58,723,727,3.5517241379310347
378,4,5,1,880055454,880055478,24,727,606,4.294117647058823
378,5,4,-1,880055478,880055520,42,606,382,3.764705882352941
378,4,5,1,880055520,880055564,44,382,632,3.9523809523809526
378,5,3,-2,880055564,880055565,1,632,141,3.4827586206896552
378,3,3,0,880055565,880055597,32,141,747,3.5526315789473686
378,3,3,0,880055597,880055636,39,747,392,3.5555555555555554
378,3,4,1,880055636,880055706,70,392,175,3.8354430379746836
378,4,4,0,880055706,880055740,34,175,96,3.9130434782608696
378,4,4,0,880055740,880055779,39,96,153,3.7865168539325844
378,4,4,0,880055779,880055840,61,153,543,4.166666666666667
378,4,4,0,880055840,880055891,51,543,500,4.285714285714286
378,4,4,0,880055891,880055949,58,500,708,3.3157894736842106
378,4,4,0,880055949,880055984,35,708,47,3.5869565217391304
378,4,4,0,880055984,880056034,50,47,161,3.5844155844155843
378,4,3,-1,880056034,880056073,39,161,755,3.085714285714286
378,3,4,1,880056073,880056160,87,755,193,3.883720930232558
378,4,4,0,880056160,880056195,35,193,969,3.8947368421052633
378,4,4,0,880056195,880056287,92,969,423,3.7016129032258065
378,4,5,1,880056287,880056318,31,423,629,3.3333333333333335
378,5,4,-1,880056318,880056350,32,629,686,3.9
378,4,3,-1,880056350,880056351,1,686,1107,2.9
378,3,3,0,880056351,880056384,33,1107,517,3.625
378,3,4,1,880056384,880056452,68,517,387,3.5357142857142856
378,4,4,0,880056452,880056453,1,387,77,3.3857142857142857
378,4,4,0,880056453,880056491,38,77,972,3.375
378,4,4,0,880056491,880056547,56,972,660,3.71875
378,4,3,-1,880056547,880056582,35,660,620,3.0
378,3,3,0,880056582,880056632,50,620,66,3.4705882352941178
378,3,4,1,880056632,880056667,35,66,921,3.611111111111111
378,4,3,-1,880056667,880056701,34,921,549,3.4871794871794872
378,3,3,0,880056701,880056735,34,549,674,2.6875
378,3,3,0,880056735,880056736,1,674,569,2.4285714285714284
378,3,4,1,880056736,880056761,25,569,385,3.6129032258064515
378,4,3,-1,880056761,880056798,37,385,942,3.4545454545454546
378,3,4,1,880056798,880056826,28,942,204,3.6744186046511627
378,4,4,0,880056826,880056888,62,204,447,3.46875
378,4,2,-2,880056888,880056930,42,447,1425,2.6
378,2,4,2,880056930,880056976,46,1425,54,3.3714285714285714
378,4,4,0,880056976,880057018,42,54,126,3.8620689655172415
378,4,5,1,880057018,880057088,70,126,173,4.1441441441441444
378,5,4,-1,880057088,880057137,49,173,210,3.921259842519685
378,4,3,-1,880057137,880331938,274801,210,418,3.825
378,3,3,0,880331938,880332034,96,418,956,3.5714285714285716
378,3,2,-1,880332034,880332537,503,956,1181,2.6
378,2,2,0,880332537,880332563,26,1181,67,3.106382978723404
378,2,3,1,880332563,880332609,46,67,5,3.1481481481481484
378,3,4,1,880332609,880332643,34,5,419,3.8208955223880596
378,4,3,-1,880332643,880332683,40,419,1092,2.5714285714285716
378,3,3,0,880332683,880332752,69,1092,94,2.8823529411764706
378,3,3,0,880332752,880332802,50,94,1074,2.857142857142857
378,3,3,0,880332802,880332831,29,1074,1053,3.3846153846153846
378,3,4,1,880332831,880332879,48,1053,396,2.84
378,4,3,-1,880332879,880332911,32,396,1035,3.03125
378,3,2,-1,880332911,880332998,87,1035,160,3.4
378,2,3,1,880332998,880333027,29,160,576,3.125
378,3,2,-1,880333027,880333069,42,576,1135,3.0526315789473686
378,2,3,1,880333069,880333121,52,1135,1232,2.6666666666666665
378,3,3,0,880333121,880333144,23,1232,1439,3.0
378,3,3,0,880333144,880333168,24,1439,623,3.0454545454545454
378,3,3,0,880333168,880333195,27,623,449,2.9069767441860463
378,3,4,1,880333195,880333239,44,449,739,3.391304347826087
378,4,2,-2,880333239,880333261,22,739,665,2.72972972972973
378,2,3,1,880333261,880333305,44,665,775,2.4285714285714284
378,3,3,0,880333305,880333383,78,775,1168,3.4166666666666665
378,3,2,-1,880333383,880333446,63,1168,68,3.5714285714285716
378,2,2,0,880333446,880333494,48,68,370,2.8125
378,2,3,1,880333494,880333516,22,370,1211,3.5714285714285716
378,3,4,1,880333516,880333598,82,1211,768,3.238095238095238
378,4,2,-2,880333598,880333626,28,768,796,2.923076923076923
378,2,3,1,880333626,880333653,27,796,40,2.7037037037037037
378,3,3,0,880333653,880333695,42,40,561,3.1515151515151514
378,3,3,0,880333695,880333719,24,561,63,3.125
378,3,2,-1,880333719,880333802,83,63,635,2.5
378,2,2,0,880333802,880333851,49,635,1048,2.857142857142857
378,2,4,2,880333851,880333918,67,1048,155,3.0588235294117645
378,4,2,-2,880333918,880333995,77,155,577,1.7058823529411764
378,2,3,1,880333995,880334017,22,577,722,2.9642857142857144
378,3,2,-1,880334017,880334067,50,722,1523,2.0
378,2,3,1,880334067,880334269,202,1523,1180,2.6666666666666665
378,3,2,-1,880334269,880334305,36,1180,1230,1.8888888888888888
378,2,3,1,880334305,880334329,24,1230,1407,2.375
378,3,3,0,880334329,880334440,111,1407,803,2.75
378,3,3,0,880334440,880334476,36,803,450,2.2758620689655173
378,3,3,0,880334476,883835834,3501358,450,248,3.746268656716418
378,3,4,1,883835834,889665041,5829207,248,272,4.2
378,4,3,-1,889665041,892382865,2717824,272,326,3.262295081967213
366,3,5,2,888857684,888857750,66,758,185,3.9726027397260273
366,5,5,0,888857750,888858078,328,185,573,2.909090909090909
377,4,3,-1,891295957,891296044,87,271,751,3.3896103896103895
377,3,4,1,891296044,891296356,312,751,258,3.7547169811320753
377,4,3,-1,891296356,891296448,92,258,682,3.0476190476190474
377,3,2,-1,891296448,891297001,553,682,323,3.0
377,2,3,1,891297001,891297023,22,323,358,2.6551724137931036
377,3,3,0,891297023,891297293,270,358,338,2.75
377,3,5,2,891297293,891298549,1256,338,194,4.029411764705882
377,5,3,-2,891298549,891298589,40,194,100,4.0162162162162165
377,3,5,2,891298589,891298627,38,100,154,3.6031746031746033
377,5,4,-1,891298627,891299010,383,154,7,3.76056338028169
377,4,3,-1,891299010,891299078,68,7,219,2.735294117647059
375,4,2,-2,886621917,886621950,33,603,1073,3.6315789473684212
375,2,3,1,886621950,886621985,35,1073,773,3.1666666666666665
375,3,3,0,886621985,886622024,39,773,939,3.6333333333333333
375,3,4,1,886622024,886622066,42,939,5,3.1481481481481484
359,4,5,1,886453214,886453239,25,1,408,4.4772727272727275
359,5,3,-2,886453239,886453271,32,408,748,3.1043478260869564
359,3,4,1,886453271,886453305,34,748,117,3.689189189189189
359,4,3,-1,886453305,886453354,49,117,405,3.25
359,3,3,0,886453354,886453431,77,405,323,3.0
359,3,5,2,886453431,886453450,19,323,313,4.323076923076923
359,5,4,-1,886453450,886453467,17,313,751,3.3896103896103895
359,4,4,0,886453467,886453490,23,751,268,3.9838709677419355
379,3,5,2,880524363,880524541,178,294,234,3.7674418604651163
379,5,4,-1,880524541,880524582,41,234,164,3.6140350877192984
379,4,3,-1,880524582,880524614,32,164,452,2.6129032258064515
379,3,3,0,880524614,880524669,55,452,559,3.477272727272727
379,3,5,2,880524669,880524753,84,559,522,3.8461538461538463
379,5,4,-1,880524753,880524754,1,522,69,3.8015873015873014
379,4,4,0,880524754,880524783,29,69,23,3.9047619047619047
379,4,5,1,880524783,880524811,28,23,127,4.162790697674419
379,5,3,-2,880524811,880524835,24,127,704,3.125
379,3,3,0,880524835,880524860,25,704,527,3.823529411764706
379,3,5,2,880524860,880524886,26,527,191,4.168674698795181
379,5,5,0,880524886,880524908,22,191,520,4.136363636363637
379,5,5,0,880524908,880525001,93,520,317,3.774193548387097
379,5,4,-1,880525001,880525031,30,317,461,3.3333333333333335
379,4,4,0,880525031,880525062,31,461,196,3.9404761904761907
379,4,4,0,880525062,880525084,22,196,649,3.625
379,4,4,0,880525084,880525108,24,649,523,4.159090909090909
379,4,5,1,880525108,880525132,24,523,179,3.8823529411764706
379,5,4,-1,880525132,880525133,1,179,735,3.58
379,4,5,1,880525133,880525194,61,735,194,4.029411764705882
379,5,4,-1,880525194,880525214,20,194,208,3.8125
379,4,5,1,880525214,880525236,22,208,238,3.888888888888889
379,5,5,0,880525236,880525259,23,238,202,3.730337078651685
379,5,4,-1,880525259,880525284,25,202,153,3.7865168539325844
379,4,4,0,880525284,880525306,22,153,516,4.055555555555555
379,4,5,1,880525306,880525367,61,516,144,3.9545454545454546
379,5,4,-1,880525367,880525400,33,144,172,4.225225225225225
379,4,4,0,880525400,880525424,24,172,89,3.9615384615384617
379,4,4,0,880525424,880525469,45,89,684,3.847826086956522
379,4,5,1,880525469,880525502,33,684,530,4.125
379,5,4,-1,880525502,880525540,38,530,82,3.6741573033707864
379,4,5,1,880525540,880525566,26,82,568,3.5853658536585367
379,5,5,0,880525566,880525598,32,568,4,3.5538461538461537
379,5,1,-4,880525598,880525638,40,4,398,2.1
379,1,4,3,880525638,880525678,40,398,554,2.9555555555555557
379,4,4,0,880525678,880525815,137,554,621,2.75
379,4,4,0,880525815,880525926,111,621,216,3.8454545454545452
379,4,4,0,880525926,880525945,19,216,736,4.083333333333333
379,4,5,1,880525945,880525995,50,736,732,3.6266666666666665
379,5,2,-3,880525995,880526100,105,732,54,3.3714285714285714
379,2,5,3,880526100,880526123,23,54,654,4.119047619047619
379,5,5,0,880526123,880526141,18,654,504,4.085714285714285
379,5,4,-1,880526141,880526281,140,504,331,3.5517241379310347
379,4,5,1,880526281,880568253,41972,331,197,4.112676056338028
379,5,5,0,880568253,880568307,54,197,659,4.027777777777778
379,5,4,-1,880568307,880568407,100,659,284,3.1547619047619047
379,4,4,0,880568407,880568452,45,284,428,3.744186046511628
379,4,4,0,880568452,880568511,59,428,651,3.8627450980392157
379,4,5,1,880568511,880740437,171926,651,211,3.958904109589041
379,5,5,0,880740437,880740461,24,211,47,3.5869565217391304
379,5,5,0,880740461,880740495,34,47,186,3.905263157894737
379,5,3,-2,880740495,880741832,1337,186,712,3.0434782608695654
379,3,2,-1,880741832,880741868,36,712,395,2.5714285714285716
379,2,4,2,880741868,880961600,219732,395,157,3.5714285714285716
379,4,4,0,880961600,880961621,21,157,729,3.3793103448275863
379,4,3,-1,880961621,880961672,51,729,434,3.588235294117647
379,3,3,0,880961672,880961718,46,434,514,4.033333333333333
379,3,4,1,880961718,880961742,24,514,524,4.166666666666667
379,4,4,0,880961742,880961807,65,524,372,3.6666666666666665
379,4,4,0,880961807,880961839,32,372,710,3.41025641025641
379,4,4,0,880961839,880961874,35,710,239,3.423076923076923
379,4,2,-2,880961874,880962047,173,239,637,2.888888888888889
379,2,2,0,880962047,880962106,59,637,563,2.0
379,2,3,1,880962106,880962187,81,563,401,2.6774193548387095
379,3,2,-1,880962187,880962215,28,401,63,3.125
379,2,4,2,880962215,880962285,70,63,843,2.933333333333333
379,4,5,1,880962285,882563797,1601512,843,131,3.731707317073171
379,5,2,-3,882563797,883156704,592907,131,1219,3.142857142857143
379,2,5,3,883156704,883156810,106,1219,94,2.8823529411764706
379,5,4,-1,883156810,883156880,70,94,210,3.921259842519685
379,4,3,-1,883156880,883156925,45,210,405,3.25
379,3,3,0,883156925,885063346,1906421,405,436,3.5
379,3,5,2,885063346,886317533,1254187,436,474,4.172413793103448
379,5,4,-1,886317533,886835699,518166,474,177,3.875
379,4,4,0,886835699,888646088,1810389,177,310,3.6666666666666665
379,4,2,-2,888646088,890464337,1818249,310,616,3.1052631578947367
380,4,4,0,885477802,885477975,173,306,315,4.15
380,4,4,0,885477975,885478193,218,315,427,4.2025316455696204
380,4,3,-1,885478193,885478218,25,427,423,3.7016129032258065
380,3,3,0,885478218,885478241,23,423,652,3.9642857142857144
380,3,3,0,885478241,885478292,51,652,651,3.8627450980392157
380,3,4,1,885478292,885478334,42,651,22,4.215909090909091
380,4,4,0,885478334,885478374,40,22,462,3.7954545454545454
380,4,4,0,885478374,885478425,51,462,357,4.063291139240507
380,4,2,-2,885478425,885478447,22,357,234,3.7674418604651163
380,2,2,0,885478447,885478497,50,234,629,3.3333333333333335
380,2,3,1,885478497,885478519,22,629,222,3.578125
380,3,3,0,885478519,885478539,20,222,114,4.3478260869565215
380,3,4,1,885478539,885478558,19,114,474,4.172413793103448
380,4,5,1,885478558,885478583,25,474,89,3.9615384615384617
380,5,3,-2,885478583,885478603,20,89,923,4.142857142857143
380,3,3,0,885478603,885478624,21,923,154,3.6031746031746033
380,3,4,1,885478624,885478646,22,154,732,3.6266666666666665
380,4,4,0,885478646,885478668,22,732,631,3.581818181818182
380,4,4,0,885478668,885478698,30,631,98,4.240875912408759
380,4,4,0,885478698,885478738,40,98,498,4.290909090909091
380,4,3,-1,885478738,885478759,21,498,382,3.764705882352941
380,3,2,-1,885478759,885478780,21,382,630,3.25
380,2,4,2,885478780,885478799,19,630,194,4.029411764705882
380,4,3,-1,885478799,885478821,22,194,518,3.5833333333333335
380,3,4,1,885478821,885478845,24,518,1449,4.0
380,4,5,1,885478845,885478886,41,1449,530,4.125
380,5,3,-2,885478886,885478908,22,530,81,3.2857142857142856
380,3,4,1,885478908,885478924,16,81,174,4.253521126760563
380,4,4,0,885478924,885478953,29,174,654,4.119047619047619
380,4,4,0,885478953,885479057,104,654,185,3.9726027397260273
380,4,3,-1,885479057,885479082,25,185,177,3.875
380,3,3,0,885479082,885479124,42,177,435,3.8933333333333335
380,3,3,0,885479124,885479163,39,435,215,3.662921348314607
380,3,3,0,885479163,885479186,23,215,699,3.736842105263158
380,3,4,1,885479186,885479212,26,699,527,3.823529411764706
380,4,3,-1,885479212,885479252,40,527,729,3.3793103448275863
380,3,4,1,885479252,885479274,22,729,95,3.8194444444444446
380,4,4,0,885479274,885479301,27,95,69,3.8015873015873014
380,4,2,-2,885479301,885479319,18,69,213,3.943396226415094
380,2,4,2,885479319,885479372,53,213,463,3.6818181818181817
380,4,4,0,885479372,885479397,25,463,1116,3.5714285714285716
380,4,3,-1,885479397,885479415,18,1116,664,3.15
380,3,3,0,885479415,885479436,21,664,135,3.7974683544303796
380,3,2,-1,885479436,885479455,19,135,959,3.4583333333333335
380,2,4,2,885479455,885479487,32,959,1101,3.793103448275862
380,4,2,-2,885479487,885479519,32,1101,561,3.1515151515151514
380,2,2,0,885479519,885479537,18,561,38,2.784313725490196
380,2,1,-1,885479537,885479730,193,38,31,3.642857142857143
380,1,2,1,885479730,885479754,24,31,554,2.9555555555555557
380,2,4,2,885479754,885479777,23,554,196,3.9404761904761907
380,4,3,-1,885479777,885479799,22,196,1045,3.2
380,3,3,0,885479799,885479926,127,1045,549,3.4871794871794872
380,3,2,-1,885479926,885479997,71,549,241,3.5625
380,2,2,0,885479997,885480046,49,241,414,3.3076923076923075
380,2,2,0,885480046,885480064,18,414,356,3.2
380,2,2,0,885480064,885480093,29,356,109,3.282608695652174
380,2,3,1,885480093,885480144,51,109,744,3.5714285714285716
380,3,1,-2,885480144,885480187,43,744,670,2.9375
380,1,3,2,885480187,885480222,35,670,770,3.25
380,3,4,1,885480222,885480283,61,770,443,3.8421052631578947
380,4,2,-2,885480283,885480301,18,443,208,3.8125
380,2,3,1,885480301,885480320,19,208,428,3.744186046511628
380,3,1,-2,885480320,885480414,94,428,139,2.7222222222222223
380,1,1,0,885480414,885480530,116,139,502,3.272727272727273
380,1,2,1,885480530,885480585,55,502,712,3.0434782608695654
380,2,1,-1,885480585,885480795,210,712,1444,2.3333333333333335
380,1,3,2,885480795,885480902,107,1444,449,2.9069767441860463
381,5,3,-2,892696019,892696045,26,480,403,3.298507462686567
381,3,5,2,892696045,892696060,15,403,529,4.142857142857143
381,5,4,-1,892696060,892696106,46,529,1533,4.0
381,4,4,0,892696106,892696130,24,1533,607,4.136363636363637
381,4,5,1,892696130,892696168,38,607,640,2.75
381,5,4,-1,892696168,892696186,18,640,495,3.65
381,4,5,1,892696186,892696209,23,495,705,3.7857142857142856
381,5,5,0,892696209,892696268,59,705,175,3.8354430379746836
381,5,4,-1,892696268,892696291,23,175,178,4.378378378378378
381,4,2,-2,892696291,892696328,37,178,49,3.3
381,2,5,3,892696328,892696347,19,49,134,4.174603174603175
381,5,2,-3,892696347,892696367,20,134,77,3.3857142857142857
381,2,2,0,892696367,892696426,59,77,660,3.71875
381,2,5,3,892696426,892696446,20,660,419,3.8208955223880596
381,5,4,-1,892696446,892696471,25,419,656,3.75
381,4,2,-2,892696471,892696512,41,656,566,3.543859649122807
381,2,4,2,892696512,892696534,22,566,95,3.8194444444444446
381,4,2,-2,892696534,892696557,23,95,771,2.5714285714285716
381,2,3,1,892696557,892696616,59,771,961,3.4545454545454546
381,3,5,2,892696616,892696654,38,961,318,4.5046728971962615
381,5,4,-1,892696654,892696698,44,318,176,3.967032967032967
381,4,4,0,892696698,892696738,40,176,459,3.875
381,4,5,1,892696738,892696757,19,459,520,4.136363636363637
381,5,2,-3,892696757,892696793,36,520,121,3.521212121212121
381,2,3,1,892696793,892696872,79,121,634,3.6
381,3,5,2,892696872,892696982,110,634,525,4.0
381,5,4,-1,892696982,892697066,84,525,778,3.5925925925925926
381,4,5,1,892697066,892697083,17,778,487,4.043478260869565
381,5,4,-1,892697083,892697133,50,487,647,4.142857142857143
381,4,5,1,892697133,892697150,17,647,473,2.9166666666666665
381,5,5,0,892697150,892697174,24,473,96,3.9130434782608696
381,5,3,-2,892697174,892697297,123,96,596,3.180327868852459
381,3,3,0,892697297,892697314,17,596,1407,2.375
381,3,2,-1,892697314,892697338,24,1407,214,3.272727272727273
381,2,2,0,892697338,892697358,20,214,15,3.725663716814159
381,2,4,2,892697358,892697373,15,15,228,3.7246376811594204
381,4,3,-1,892697373,892697394,21,228,1400,3.5
381,3,5,2,892697394,892697413,19,1400,133,3.7777777777777777
381,5,2,-3,892697413,892697495,82,133,934,3.0294117647058822
381,2,5,3,892697495,892697526,31,934,151,3.6544117647058822
381,5,4,-1,892697526,892697574,48,151,1117,3.0
381,4,4,0,892697574,892697600,26,1117,1115,3.3846153846153846
381,4,4,0,892697600,892697628,28,1115,931,2.2758620689655173
381,4,5,1,892697628,892697655,27,931,283,3.901639344262295
381,5,5,0,892697655,892697677,22,283,1060,3.235294117647059
381,5,5,0,892697677,892697690,13,1060,124,4.052631578947368
381,5,2,-3,892697690,892697869,179,124,313,4.323076923076923
381,2,3,1,892697869,892697941,72,313,887,3.5789473684210527
381,3,4,1,892697941,892697982,41,887,268,3.9838709677419355
381,4,3,-1,892697982,892697999,17,268,303,3.75
381,3,2,-1,892697999,892698054,55,303,259,2.492063492063492
381,2,5,3,892698054,892698068,14,259,294,3.1052631578947367
385,4,2,-2,879438647,879439637,990,340,236,3.2666666666666666
385,2,4,2,879439637,879439667,30,236,127,4.162790697674419
385,4,3,-1,879439667,879439728,61,127,293,3.630434782608696
385,3,3,0,879439728,879439949,221,293,1007,4.117647058823529
385,3,2,-1,879439949,879439984,35,1007,283,3.901639344262295
385,2,3,1,879439984,879440127,143,283,1010,3.611111111111111
385,3,4,1,879440127,879440158,31,1010,919,4.0
385,4,3,-1,879440158,879440211,53,919,1012,3.2916666666666665
385,3,3,0,879440211,879440236,25,1012,257,3.7154471544715446
385,3,2,-1,879440236,879440267,31,257,111,3.5106382978723403
385,2,3,1,879440267,879440584,317,111,473,2.9166666666666665
385,3,4,1,879440584,879440602,18,473,533,3.6
385,4,3,-1,879440602,879440674,72,533,290,3.108108108108108
385,3,4,1,879440674,879440701,27,290,455,3.1702127659574466
385,4,3,-1,879440701,879440726,25,455,24,3.3728813559322033
385,3,2,-1,879440726,879440892,166,24,249,3.3275862068965516
385,2,5,3,879440892,879440940,48,249,235,3.106382978723404
385,5,1,-4,879440940,879440986,46,235,871,2.3823529411764706
385,1,4,3,879440986,879441454,468,871,523,4.159090909090909
385,4,3,-1,879441454,879441538,84,523,194,4.029411764705882
385,3,4,1,879441538,879441572,34,194,160,3.4
385,4,3,-1,879441572,879441599,27,160,520,4.136363636363637
385,3,3,0,879441599,879441662,63,520,1128,3.0
385,3,4,1,879441662,879441728,66,1128,187,4.215189873417722
385,4,5,1,879441728,879441777,49,187,48,4.055555555555555
385,5,4,-1,879441777,879441942,165,48,659,4.027777777777778
385,4,4,0,879441942,879441982,40,659,47,3.5869565217391304
385,4,3,-1,879441982,879442028,46,47,81,3.2857142857142856
385,3,5,2,879442028,879442085,57,81,238,3.888888888888889
385,5,4,-1,879442085,879442109,24,238,657,4.341463414634147
385,4,4,0,879442109,879442189,80,657,604,3.8181818181818183
385,4,4,0,879442189,879442235,46,604,1069,3.6
385,4,4,0,879442235,879442360,125,1069,197,4.112676056338028
385,4,3,-1,879442360,879442402,42,197,136,3.764705882352941
385,3,2,-1,879442402,879442490,88,136,59,4.0
385,2,4,2,879442490,879442559,69,59,484,4.116279069767442
385,4,4,0,879442559,879442606,47,484,1506,4.0
385,4,2,-2,879442606,879442673,67,1506,558,3.75
385,2,4,2,879442673,879442706,33,558,180,3.9473684210526314
385,4,5,1,879442706,879443065,359,180,408,4.4772727272727275
385,5,1,-4,879443065,879443102,37,408,727,3.5517241379310347
385,1,3,2,879443102,879443150,48,727,447,3.46875
385,3,5,2,879443150,879443186,36,447,497,3.35
385,5,3,-2,879443186,879443217,31,497,503,3.6363636363636362
385,3,1,-2,879443217,879443252,35,503,42,3.893617021276596
385,1,3,2,879443252,879443315,63,42,671,3.4285714285714284
385,3,4,1,879443315,879444685,1370,671,525,4.0
385,4,3,-1,879444685,879445098,413,525,443,3.8421052631578947
385,3,3,0,879445098,879445153,55,443,1065,3.1578947368421053
385,3,2,-1,879445153,879445291,138,1065,506,3.566666666666667
385,2,3,1,879445291,879445335,44,506,664,3.15
385,3,2,-1,879445335,879445454,119,664,658,3.393939393939394
385,2,3,1,879445454,879445587,133,658,1131,3.6666666666666665
385,3,3,0,879445587,879445724,137,1131,425,3.7027027027027026
385,3,4,1,879445724,879445754,30,425,131,3.731707317073171
385,4,2,-2,879445754,879445779,25,131,673,3.393939393939394
385,2,3,1,879445779,879445856,77,673,152,3.6785714285714284
385,3,4,1,879445856,879445949,93,152,529,4.142857142857143
385,4,1,-3,879445949,879446110,161,529,53,2.9523809523809526
385,1,3,2,879446110,879446183,73,53,211,3.958904109589041
385,3,3,0,879446183,879446208,25,211,521,3.787878787878788
385,3,3,0,879446208,879446235,27,521,502,3.272727272727273
385,3,4,1,879446235,879446431,196,502,663,3.948717948717949
385,4,3,-1,879446431,879446465,34,663,568,3.5853658536585367
385,3,2,-1,879446465,879446566,101,568,1110,2.85
385,2,2,0,879446566,879446643,77,1110,629,3.3333333333333335
385,2,3,1,879446643,879446671,28,629,715,3.257142857142857
385,3,3,0,879446671,879446741,70,715,959,3.4583333333333335
385,3,2,-1,879446741,879446786,45,959,557,3.090909090909091
385,2,2,0,879446786,879446868,82,557,216,3.8454545454545452
385,2,3,1,879446868,879446952,84,216,1286,3.5714285714285716
385,3,3,0,879446952,879447047,95,1286,1118,3.533333333333333
385,3,3,0,879447047,879447089,42,1118,940,2.4
385,3,2,-1,879447089,879447136,47,940,719,2.6666666666666665
385,2,1,-1,879447136,879447205,69,719,451,3.207792207792208
385,1,4,3,879447205,879447317,112,451,240,3.0350877192982457
385,4,2,-2,879447317,879447361,44,240,218,3.5555555555555554
385,2,1,-1,879447361,879447555,194,218,378,3.6904761904761907
385,1,2,1,879447555,879447671,116,378,417,3.0588235294117645
385,2,1,-1,879447671,879447845,174,417,29,2.5714285714285716
385,1,3,2,879447845,879447873,28,29,1411,2.4615384615384617
385,3,2,-1,879447873,879448208,335,1411,217,3.1538461538461537
385,2,3,1,879448208,879448263,55,217,448,3.466666666666667
385,3,4,1,879448263,879448294,31,448,1535,3.5
385,4,4,0,879448294,879448426,132,1535,1071,3.0
385,4,4,0,879448426,879924267,475841,1071,865,2.6666666666666665
385,4,2,-2,879924267,879924297,30,865,174,4.253521126760563
385,2,5,3,879924297,880870206,945909,174,46,3.6666666666666665
385,5,5,0,880870206,881047168,176962,46,1499,5.0
385,5,5,0,881047168,881530739,483571,1499,189,3.88
385,5,3,-2,881530739,883791602,2260863,189,346,3.5128205128205128
385,3,3,0,883791602,883791666,64,346,1017,3.0
385,3,3,0,883791666,883791694,28,1017,122,2.282608695652174
382,3,4,1,875945781,875945812,31,127,100,4.0162162162162165
382,4,2,-2,875945812,875945837,25,100,7,3.76056338028169
382,2,2,0,875945837,875945880,43,7,25,3.3185840707964602
382,2,2,0,875945880,875946055,175,25,150,3.803921568627451
382,2,3,1,875946055,875946103,48,150,475,3.956043956043956
382,3,3,0,875946103,875946185,82,475,756,2.6885245901639343
382,3,2,-1,875946185,875946262,77,756,252,2.911392405063291
382,2,3,1,875946262,875946347,85,252,717,2.9696969696969697
382,3,3,0,875946347,875946440,93,717,122,2.282608695652174
382,3,3,0,875946440,875946563,123,122,98,4.240875912408759
382,3,3,0,875946563,875946639,76,98,171,4.090909090909091
382,3,4,1,875946639,875946700,61,171,168,4.0476190476190474
382,4,3,-1,875946700,875946730,30,168,514,4.033333333333333
382,3,4,1,875946730,875946809,79,514,507,3.6285714285714286
382,4,4,0,875946809,875946830,21,507,151,3.6544117647058822
382,4,5,1,875946830,875946945,115,151,482,3.9444444444444446
382,5,5,0,875946945,875947049,104,482,59,4.0
382,5,3,-2,875947049,875947078,29,59,135,3.7974683544303796
382,3,3,0,875947078,875947149,71,135,134,4.174603174603175
382,3,5,2,875947149,875947199,50,134,474,4.172413793103448
382,5,5,0,875947199,875947240,41,474,1229,2.4
382,5,5,0,875947240,875947296,56,1229,1268,3.5
387,3,2,-1,886479484,886479528,44,333,23,3.9047619047619047
387,2,4,2,886479528,886479575,47,23,113,4.25
387,4,3,-1,886479575,886479649,74,113,144,3.9545454545454546
387,3,2,-1,886479649,886479689,40,144,651,3.8627450980392157
387,2,4,2,886479689,886479690,1,651,508,3.6923076923076925
387,4,5,1,886479690,886479737,47,508,32,3.7222222222222223
387,5,2,-3,886479737,886479771,34,32,204,3.6744186046511627
387,2,5,3,886479771,886480163,392,204,474,4.172413793103448
387,5,3,-2,886480163,886480206,43,474,116,3.6666666666666665
387,3,4,1,886480206,886480244,38,116,98,4.240875912408759
387,4,4,0,886480244,886480352,108,98,198,4.04
387,4,4,0,886480352,886480353,1,198,432,3.719298245614035
387,4,5,1,886480353,886480384,31,432,174,4.253521126760563
387,5,3,-2,886480384,886480413,29,174,69,3.8015873015873014
387,3,3,0,886480413,886480446,33,69,176,3.967032967032967
387,3,4,1,886480446,886480447,1,176,96,3.9130434782608696
387,4,3,-1,886480447,886480483,36,96,593,4.0
387,3,3,0,886480483,886480484,1,593,208,3.8125
387,3,2,-1,886480484,886480515,31,208,186,3.905263157894737
387,2,4,2,886480515,886480548,33,186,42,3.893617021276596
387,4,5,1,886480548,886480623,75,42,1007,4.117647058823529
387,5,4,-1,886480623,886480681,58,1007,1,3.902439024390244
387,4,5,1,886480681,886480703,22,1,93,3.5641025641025643
387,5,1,-4,886480703,886480733,30,93,477,3.1666666666666665
387,1,5,4,886480733,886480755,22,477,515,4.202898550724638
387,5,3,-2,886480755,886480788,33,515,117,3.689189189189189
387,3,3,0,886480788,886480789,1,117,410,3.0434782608695654
387,3,4,1,886480789,886480970,181,410,250,3.4698795180722892
387,4,4,0,886480970,886481033,63,250,1128,3.0
387,4,4,0,886481033,886481105,72,1128,455,3.1702127659574466
387,4,4,0,886481105,886481151,46,455,273,3.5238095238095237
387,4,1,-3,886481151,886481183,32,273,458,3.0588235294117645
387,1,3,2,886481183,886481687,504,458,218,3.5555555555555554
387,3,2,-1,886481687,886481737,50,218,569,2.4285714285714284
387,2,4,2,886481737,886481800,63,569,444,2.6842105263157894
387,4,1,-3,886481800,886481851,51,444,769,2.2222222222222223
387,1,3,2,886481851,886482882,1031,769,430,4.136363636363637
387,3,3,0,886482882,886482883,1,430,367,3.4242424242424243
387,3,5,2,886482883,886482928,45,367,238,3.888888888888889
387,5,1,-4,886482928,886482969,41,238,790,2.8518518518518516
387,1,2,1,886482969,886483009,40,790,393,3.5125
387,2,4,2,886483009,886483049,40,393,187,4.215189873417722
387,4,3,-1,886483049,886483098,49,187,33,3.2941176470588234
387,3,4,1,886483098,886483099,1,33,68,3.5714285714285716
387,4,5,1,886483099,886483150,51,68,190,4.233333333333333
387,5,5,0,886483150,886483151,1,190,188,3.625
387,5,3,-2,886483151,886483194,43,188,231,2.938775510204082
387,3,2,-1,886483194,886483252,58,231,550,3.272727272727273
387,2,2,0,886483252,886483289,37,550,232,3.0789473684210527
387,2,5,3,886483289,886483330,41,232,513,4.526315789473684
387,5,4,-1,886483330,886483357,27,513,943,3.6666666666666665
387,4,4,0,886483357,886483394,37,943,581,3.130434782608696
387,4,4,0,886483394,886483395,1,581,642,3.4285714285714284
387,4,4,0,886483395,886483429,34,642,206,3.0
387,4,5,1,886483429,886483497,68,206,52,3.727272727272727
387,5,5,0,886483497,886483565,68,52,580,3.625
387,5,5,0,886483565,886483619,54,580,189,3.88
387,5,1,-4,886483619,886483670,51,189,1091,2.5384615384615383
387,1,5,4,886483670,886483753,83,1091,214,3.272727272727273
387,5,4,-1,886483753,886483782,29,214,772,3.3333333333333335
387,4,4,0,886483782,886483858,76,772,199,4.191489361702128
387,4,2,-2,886483858,886483859,1,199,97,3.7282608695652173
387,2,4,2,886483859,886483906,47,97,317,3.774193548387097
387,4,3,-1,886483906,886484011,105,317,46,3.6666666666666665
387,3,2,-1,886484011,886484012,1,46,953,3.076923076923077
387,2,5,3,886484012,886484124,112,953,856,4.142857142857143
387,5,5,0,886484124,886484157,33,856,715,3.257142857142857
387,5,1,-4,886484157,886484215,58,715,732,3.6266666666666665
387,1,5,4,886484215,886484336,121,732,192,4.090909090909091
387,5,1,-4,886484336,886484384,48,192,319,3.0408163265306123
387,1,1,0,886484384,886484413,29,319,289,2.988888888888889
387,1,1,0,886484413,886484460,47,289,984,2.6666666666666665
387,1,4,3,886484460,886484492,32,984,408,4.4772727272727275
387,4,5,1,886484492,886484522,30,408,24,3.3728813559322033
387,5,5,0,886484522,886484561,39,24,952,3.3529411764705883
387,5,5,0,886484561,886484631,70,952,201,3.75
364,3,2,-1,875931432,875931478,46,289,321,3.0172413793103448
364,2,4,2,875931478,875931561,83,321,948,2.2962962962962963
364,4,5,1,875931561,875931585,24,948,1048,2.857142857142857
369,4,4,0,889428011,889428097,86,752,751,3.3896103896103895
369,4,2,-2,889428097,889428228,131,751,948,2.2962962962962963
369,2,3,1,889428228,889428268,40,948,890,1.7692307692307692
369,3,4,1,889428268,889428418,150,890,166,4.0
369,4,4,0,889428418,889428442,24,166,179,3.8823529411764706
369,4,3,-1,889428442,889428494,52,179,168,4.0476190476190474
369,3,5,2,889428494,889428641,147,168,316,4.285714285714286
388,4,4,0,886436661,886436756,95,628,121,3.521212121212121
388,4,4,0,886436756,886436871,115,121,147,3.3142857142857145
388,4,3,-1,886436871,886436930,59,147,508,3.6923076923076925
388,3,3,0,886436930,886437226,296,508,9,3.8878504672897196
388,3,4,1,886437226,886439561,2335,9,294,3.1052631578947367
388,4,5,1,886439561,886439918,357,294,266,2.6666666666666665
388,5,5,0,886439918,886441133,1215,266,559,3.477272727272727
388,5,4,-1,886441133,886441248,115,559,816,2.0
386,5,4,-1,877655028,877655085,57,117,685,3.2666666666666666
386,4,5,1,877655085,877655145,60,685,840,3.090909090909091
386,5,4,-1,877655145,877655146,1,840,825,2.914285714285714
386,4,3,-1,877655146,877655195,49,825,833,2.9444444444444446
389,5,3,-2,879915701,879915726,25,100,591,3.7169811320754715
389,3,5,2,879915726,879915780,54,591,50,4.306532663316583
389,5,5,0,879915780,879915860,80,50,275,4.087912087912088
389,5,5,0,879915860,879916099,239,275,283,3.901639344262295
389,5,2,-3,879916099,879916135,36,283,15,3.725663716814159
389,2,1,-1,879916135,879916203,68,15,763,3.347826086956522
389,1,3,2,879916203,879916254,51,763,240,3.0350877192982457
389,3,4,1,879916254,879916385,131,240,301,3.2465753424657535
389,4,2,-2,879916385,879990996,74611,301,210,3.921259842519685
389,2,4,2,879990996,879991017,21,210,204,3.6744186046511627
389,4,5,1,879991017,879991045,28,204,134,4.174603174603175
389,5,4,-1,879991045,879991115,70,134,489,4.076923076923077
389,4,5,1,879991115,879991175,60,489,172,4.225225225225225
389,5,5,0,879991175,879991196,21,172,507,3.6285714285714286
389,5,4,-1,879991196,879991218,22,507,612,4.0
389,4,5,1,879991218,879991264,46,612,478,4.161290322580645
389,5,3,-2,879991264,879991297,33,478,607,4.136363636363637
389,3,5,2,879991297,879991298,1,607,588,3.8358208955223883
389,5,5,0,879991298,879991329,31,588,514,4.033333333333333
389,5,4,-1,879991329,879991352,23,514,4,3.5538461538461537
389,4,5,1,879991352,879991387,35,4,238,3.888888888888889
389,5,5,0,879991387,879991411,24,238,654,4.119047619047619
389,5,5,0,879991411,879991434,23,654,185,3.9726027397260273
389,5,4,-1,879991434,879991461,27,185,497,3.35
389,4,4,0,879991461,879991485,24,497,1121,3.5
389,4,4,0,879991485,879991512,27,1121,584,3.5238095238095237
389,4,4,0,879991512,879991535,23,584,479,4.25
389,4,5,1,879991535,880086777,95242,479,482,3.9444444444444446
389,5,4,-1,880086777,880086820,43,482,367,3.4242424242424243
389,4,3,-1,880086820,880086868,48,367,527,3.823529411764706
389,3,5,2,880086868,880086888,20,527,133,3.7777777777777777
389,5,5,0,880086888,880086918,30,133,498,4.290909090909091
389,5,5,0,880086918,880086943,25,498,603,4.315789473684211
389,5,5,0,880086943,880086944,1,603,492,4.117647058823529
389,5,4,-1,880086944,880086971,27,492,47,3.5869565217391304
389,4,3,-1,880086971,880087003,32,47,419,3.8208955223880596
389,3,4,1,880087003,880087026,23,419,663,3.948717948717949
389,4,4,0,880087026,880087048,22,663,209,3.8275862068965516
389,4,4,0,880087048,880087073,25,209,435,3.8933333333333335
389,4,4,0,880087073,880087096,23,435,1098,3.533333333333333
389,4,5,1,880087096,880087151,55,1098,923,4.142857142857143
389,5,3,-2,880087151,880087200,49,923,526,3.909090909090909
389,3,5,2,880087200,880087260,60,526,488,4.277777777777778
389,5,5,0,880087260,880087415,155,488,208,3.8125
389,5,2,-3,880087415,880087435,20,208,186,3.905263157894737
389,2,5,3,880087435,880087461,26,186,423,3.7016129032258065
389,5,5,0,880087461,880087493,32,423,191,4.168674698795181
389,5,5,0,880087493,880087544,51,191,1451,4.0
389,5,5,0,880087544,880087599,55,1451,202,3.730337078651685
389,5,4,-1,880087599,880087647,48,202,152,3.6785714285714284
389,4,4,0,880087647,880087671,24,152,136,3.764705882352941
389,4,3,-1,880087671,880087739,68,136,131,3.731707317073171
389,3,4,1,880087739,880087761,22,131,684,3.847826086956522
389,4,3,-1,880087761,880087782,21,684,568,3.5853658536585367
389,3,5,2,880087782,880087804,22,568,501,3.289473684210526
389,5,4,-1,880087804,880087850,46,501,732,3.6266666666666665
389,4,4,0,880087850,880087897,47,732,160,3.4
389,4,3,-1,880087897,880087939,42,160,239,3.423076923076923
389,3,4,1,880087939,880087977,38,239,82,3.6741573033707864
389,4,5,1,880087977,880088038,61,82,613,4.1
389,5,4,-1,880088038,880088115,77,613,792,3.793103448275862
389,4,2,-2,880088115,880088229,114,792,739,3.391304347826087
389,2,2,0,880088229,880088330,101,739,159,3.3902439024390243
389,2,3,1,880088330,880088363,33,159,946,3.1153846153846154
389,3,3,0,880088363,880088401,38,946,66,3.4705882352941178
389,3,4,1,880088401,880088421,20,66,274,3.5609756097560976
389,4,3,-1,880088421,880088510,89,274,153,3.7865168539325844
389,3,3,0,880088510,880088578,68,153,401,2.6774193548387095
389,3,2,-1,880088578,880088659,81,401,29,2.5714285714285716
389,2,3,1,880088659,880088680,21,29,559,3.477272727272727
389,3,3,0,880088680,880088717,37,559,1168,3.4166666666666665
389,3,2,-1,880088717,880088753,36,1168,1530,2.5
389,2,3,1,880088753,880088774,21,1530,217,3.1538461538461537
389,3,3,0,880088774,880088878,104,217,142,3.1481481481481484
389,3,2,-1,880088878,880088900,22,142,118,3.2764227642276422
389,2,2,0,880088900,880088922,22,118,77,3.3857142857142857
389,2,3,1,880088922,880088923,1,77,550,3.272727272727273
389,3,2,-1,880088923,880088942,19,550,756,2.6885245901639343
389,2,4,2,880088942,880088995,53,756,778,3.5925925925925926
389,4,2,-2,880088995,880089015,20,778,553,3.5
389,2,3,1,880089015,880089037,22,553,396,2.84
389,3,2,-1,880089037,880089076,39,396,38,2.784313725490196
389,2,2,0,880089076,880089115,39,38,94,2.8823529411764706
389,2,2,0,880089115,880089133,18,94,395,2.5714285714285716
389,2,3,1,880089133,880089152,19,395,731,3.4
389,3,3,0,880089152,880089170,18,731,412,2.272727272727273
389,3,2,-1,880089170,880089211,41,412,384,2.7941176470588234
389,2,3,1,880089211,880089302,91,384,728,3.05
389,3,4,1,880089302,880165070,75768,728,945,3.4
389,4,4,0,880165070,880165277,207,945,525,4.0
389,4,4,0,880165277,880165344,67,525,649,3.625
389,4,4,0,880165344,880165411,67,649,28,3.923076923076923
389,4,2,-2,880165411,880165787,376,28,1518,3.142857142857143
389,2,3,1,880165787,880165832,45,1518,95,3.8194444444444446
389,3,2,-1,880165832,880165881,49,95,451,3.207792207792208
389,2,3,1,880165881,880613773,447892,451,88,3.433734939759036
389,3,3,0,880613773,880613797,24,88,402,3.3076923076923075
389,3,3,0,880613797,880614012,215,402,715,3.257142857142857
389,3,4,1,880614012,880614031,19,715,954,3.5
389,4,2,-2,880614031,880614050,19,954,1114,3.2
389,2,3,1,880614050,880614164,114,1114,72,3.175438596491228
389,3,3,0,880614164,880614254,90,72,80,2.967741935483871
389,3,1,-2,880614254,880614292,38,80,407,2.611111111111111
389,1,3,2,880614292,880614316,24,407,105,2.6176470588235294
389,3,2,-1,880614316,880614340,24,105,67,3.106382978723404
389,2,4,2,880614340,880614449,109,67,509,3.7058823529411766
389,4,2,-2,880614449,881384441,769992,509,700,2.7142857142857144
389,2,4,2,881384441,881384464,23,700,502,3.272727272727273
389,4,1,-3,881384464,881384611,147,502,579,2.727272727272727
389,1,2,1,881384611,881384711,100,579,1052,2.4545454545454546
383,5,4,-1,891192186,891192216,30,286,302,4.133333333333334
383,4,2,-2,891192216,891192251,35,302,345,3.4782608695652173
383,2,5,3,891192251,891192276,25,345,340,3.7419354838709675
383,5,5,0,891192276,891192338,62,340,268,3.9838709677419355
383,5,5,0,891192338,891192376,38,268,321,3.0172413793103448
383,5,2,-3,891192376,891192377,1,321,319,3.0408163265306123
383,2,5,3,891192377,891192472,95,319,316,4.285714285714286
383,5,5,0,891192472,891192778,306,316,134,4.174603174603175
383,5,5,0,891192778,891192801,23,134,9,3.8878504672897196
383,5,4,-1,891192801,891192836,35,9,237,3.7315436241610738
383,4,5,1,891192836,891192858,22,237,657,4.341463414634147
383,5,3,-2,891192858,891192888,30,657,531,3.7435897435897436
383,3,5,2,891192888,891192949,61,531,514,4.033333333333333
383,5,4,-1,891192949,891192985,36,514,479,4.25
383,4,4,0,891192985,891193016,31,479,100,4.0162162162162165
383,4,5,1,891193016,891193042,26,100,478,4.161290322580645
383,5,4,-1,891193042,891193072,30,478,193,3.883720930232558
383,4,3,-1,891193072,891193137,65,193,223,4.108695652173913
383,3,4,1,891193137,891193181,44,223,639,4.083333333333333
383,4,5,1,891193181,891193210,29,639,285,4.181818181818182
383,5,4,-1,891193210,891193242,32,285,528,4.241379310344827
390,5,4,-1,879693561,879693608,47,319,990,2.769230769230769
390,4,5,1,879693608,879693677,69,990,989,3.142857142857143
390,5,2,-3,879693677,879693723,46,989,331,3.5517241379310347
390,2,2,0,879693723,879693770,47,331,1296,3.2222222222222223
390,2,5,3,879693770,879694123,353,1296,100,4.0162162162162165
390,5,4,-1,879694123,879694198,75,100,742,3.5555555555555554
390,4,4,0,879694198,879694316,118,742,283,3.901639344262295
393,4,4,0,887742006,887742040,34,272,310,3.6666666666666665
393,4,4,0,887742040,887742110,70,310,690,3.260869565217391
393,4,3,-1,887742110,887742145,35,690,245,3.056179775280899
393,3,3,0,887742145,887742798,653,245,879,3.2291666666666665
393,3,4,1,887742798,887742825,27,879,322,3.0476190476190474
393,4,4,0,887742825,887742851,26,322,259,2.492063492063492
393,4,2,-2,887742851,887742916,65,259,323,3.0
393,2,3,1,887742916,887742939,23,323,349,2.5714285714285716
393,3,2,-1,887742939,887742964,25,349,338,2.75
393,2,1,-1,887742964,887742991,27,338,890,1.7692307692307692
393,1,3,2,887742991,887743611,620,890,1,3.902439024390244
393,3,4,1,887743611,887744202,591,1,248,3.746268656716418
393,4,3,-1,887744202,887744239,37,248,283,3.901639344262295
393,3,3,0,887744239,887744266,27,283,15,3.725663716814159
393,3,2,-1,887744266,887744294,28,15,25,3.3185840707964602
393,2,4,2,887744294,887744328,34,25,255,3.2027027027027026
393,4,4,0,887744328,887744372,44,255,815,3.135135135135135
393,4,3,-1,887744372,887744373,1,815,249,3.3275862068965516
393,3,4,1,887744373,887744419,46,249,922,4.0
393,4,4,0,887744419,887744473,54,922,278,3.0357142857142856
393,4,2,-2,887744473,887744578,105,278,546,2.9789473684210526
393,2,4,2,887744578,887744626,48,546,628,3.573529411764706
393,4,4,0,887744626,887744658,32,628,840,3.090909090909091
393,4,4,0,887744658,887744688,30,840,1049,2.5714285714285716
393,4,4,0,887744688,887744724,36,1049,280,3.103448275862069
393,4,3,-1,887744724,887744765,41,280,21,2.9210526315789473
393,3,3,0,887744765,887744766,1,21,252,2.911392405063291
393,3,3,0,887744766,887745135,369,252,473,2.9166666666666665
393,3,3,0,887745135,887745174,39,473,1028,2.857142857142857
393,3,4,1,887745174,887745200,26,1028,926,2.7857142857142856
393,4,4,0,887745200,887745230,30,926,825,2.914285714285714
393,4,4,0,887745230,887745258,28,825,696,3.138888888888889
393,4,3,-1,887745258,887745293,35,696,597,3.2771084337349397
393,3,4,1,887745293,887745343,50,597,281,3.2
393,4,3,-1,887745343,887745380,37,281,1244,2.7777777777777777
393,3,3,0,887745380,887745409,29,1244,1120,3.1
393,3,4,1,887745409,887745410,1,1120,1001,2.6666666666666665
393,4,3,-1,887745410,887745454,44,1001,870,2.75
393,3,2,-1,887745454,887745501,47,870,411,2.911764705882353
393,2,3,1,887745501,887745544,43,411,934,3.0294117647058822
393,3,4,1,887745544,887745575,31,934,117,3.689189189189189
393,4,3,-1,887745575,887745624,49,117,443,3.8421052631578947
393,3,4,1,887745624,887745717,93,443,189,3.88
393,4,2,-2,887745717,887745815,98,189,357,4.063291139240507
393,2,4,2,887745815,887745816,1,357,939,3.6333333333333333
393,4,4,0,887745816,887745883,67,939,69,3.8015873015873014
393,4,4,0,887745883,887745912,29,69,215,3.662921348314607
393,4,4,0,887745912,887745937,25,215,613,4.1
393,4,3,-1,887745937,887745973,36,613,89,3.9615384615384617
393,3,4,1,887745973,887746015,42,89,196,3.9404761904761907
393,4,4,0,887746015,887746091,76,196,203,3.826923076923077
393,4,5,1,887746091,887746119,28,203,496,4.094594594594595
393,5,3,-2,887746119,887746145,26,496,128,3.45
393,3,4,1,887746145,887746174,29,128,82,3.6741573033707864
393,4,4,0,887746174,887746206,32,82,73,3.588235294117647
393,4,4,0,887746206,887746207,1,73,385,3.6129032258064515
393,4,4,0,887746207,887746239,32,385,194,4.029411764705882
393,4,4,0,887746239,887746301,62,194,265,3.710144927536232
393,4,2,-2,887746301,887746302,1,265,154,3.6031746031746033
393,2,3,1,887746302,887746346,44,154,655,3.7857142857142856
393,3,4,1,887746346,887746378,32,655,659,4.027777777777778
393,4,4,0,887746378,887746431,53,659,729,3.3793103448275863
393,4,4,0,887746431,887746456,25,729,51,3.5277777777777777
393,4,4,0,887746456,887746482,26,51,168,4.0476190476190474
393,4,4,0,887746482,887746523,41,168,419,3.8208955223880596
393,4,2,-2,887746523,887746670,147,419,485,3.717948717948718
393,2,3,1,887746670,887746671,1,485,153,3.7865168539325844
393,3,3,0,887746671,887746734,63,153,58,3.543859649122807
393,3,3,0,887746734,887746767,33,58,26,3.36
393,3,2,-1,887746767,887746824,57,26,134,4.174603174603175
393,2,3,1,887746824,887746849,25,134,5,3.1481481481481484
393,3,3,0,887746849,887746883,34,5,693,3.6285714285714286
393,3,4,1,887746883,887746916,33,693,465,3.75
393,4,2,-2,887746916,887746965,49,465,431,3.422222222222222
393,2,3,1,887746965,889554171,1807206,431,355,2.75
393,3,5,2,889554171,889554297,126,355,316,4.285714285714286
393,5,3,-2,889554297,889554316,19,316,876,3.0
393,3,3,0,889554316,889554457,141,876,893,2.625
393,3,4,1,889554457,889554540,83,893,1063,3.642857142857143
393,4,4,0,889554540,889554563,23,1063,568,3.5853658536585367
393,4,4,0,889554563,889554607,44,568,710,3.41025641025641
393,4,3,-1,889554607,889554648,41,710,33,3.2941176470588234
393,3,4,1,889554648,889554674,26,33,28,3.923076923076923
393,4,4,0,889554674,889554706,32,28,87,3.9
393,4,3,-1,889554706,889554756,50,87,821,3.076923076923077
393,3,4,1,889554756,889554780,24,821,625,3.25
393,4,2,-2,889554780,889554859,79,625,507,3.6285714285714286
393,2,3,1,889554859,889554908,49,507,692,3.56
393,3,5,2,889554908,889554930,22,692,143,3.56
393,5,4,-1,889554930,889554976,46,143,42,3.893617021276596
393,4,3,-1,889554976,889554977,1,42,71,3.6575342465753424
393,3,5,2,889554977,889555050,73,71,136,3.764705882352941
393,5,3,-2,889555050,889555074,24,136,644,3.7
393,3,4,1,889555074,889555126,52,644,97,3.7282608695652173
393,4,4,0,889555126,889555225,99,97,463,3.6818181818181817
393,4,4,0,889555225,889555251,26,463,184,3.393939393939394
393,4,3,-1,889555251,889555272,21,184,195,3.9072164948453607
393,3,4,1,889555272,889555295,23,195,95,3.8194444444444446
393,4,4,0,889555295,889555384,89,95,4,3.5538461538461537
393,4,2,-2,889555384,889555461,77,4,964,3.0
393,2,3,1,889555461,889727536,172075,964,99,3.8392857142857144
393,3,3,0,889727536,889727614,78,99,527,3.823529411764706
393,3,4,1,889727614,889727702,88,527,494,3.8333333333333335
393,4,3,-1,889727702,889727768,66,494,273,3.5238095238095237
393,3,3,0,889727768,889727833,65,273,477,3.1666666666666665
393,3,4,1,889727833,889727862,29,477,55,4.051282051282051
393,4,2,-2,889727862,889727930,68,55,721,3.4583333333333335
393,2,4,2,889727930,889727969,39,721,747,3.5526315789473686
393,4,3,-1,889727969,889728074,105,747,420,3.5652173913043477
393,3,4,1,889728074,889728150,76,420,630,3.25
393,4,2,-2,889728150,889728177,27,630,48,4.055555555555555
393,2,4,2,889728177,889728238,61,48,651,3.8627450980392157
393,4,3,-1,889728238,889728324,86,651,1043,3.2
393,3,4,1,889728324,889728353,29,1043,399,3.317073170731707
393,4,3,-1,889728353,889728385,32,399,228,3.7246376811594204
393,3,4,1,889728385,889728413,28,228,578,3.066666666666667
393,4,3,-1,889728413,889728438,25,578,561,3.1515151515151514
393,3,3,0,889728438,889728531,93,561,951,2.6666666666666665
393,3,3,0,889728531,889728554,23,951,1441,3.0
393,3,3,0,889728554,889728584,30,1441,560,3.111111111111111
393,3,3,0,889728584,889728606,22,560,1185,2.111111111111111
393,3,5,2,889728606,889728627,21,1185,394,3.5714285714285716
393,5,4,-1,889728627,889728667,40,394,761,3.0588235294117645
393,4,2,-2,889728667,889728712,45,761,575,2.619047619047619
393,2,3,1,889728712,889728713,1,575,404,3.6578947368421053
393,3,4,1,889728713,889729185,472,404,686,3.9
393,4,4,0,889729185,889729212,27,686,941,3.5
393,4,4,0,889729212,889729296,84,941,627,3.3823529411764706
393,4,3,-1,889729296,889729319,23,627,1419,1.7142857142857142
393,3,3,0,889729319,889729346,27,1419,1168,3.4166666666666665
393,3,3,0,889729346,889729375,29,1168,85,3.3157894736842106
393,3,3,0,889729375,889729440,65,85,77,3.3857142857142857
393,3,3,0,889729440,889729460,20,77,365,2.95
393,3,4,1,889729460,889729486,26,365,554,2.9555555555555557
393,4,3,-1,889729486,889729508,22,554,636,3.4146341463414633
393,3,4,1,889729508,889729536,28,636,1219,3.142857142857143
393,4,4,0,889729536,889729537,1,1219,68,3.5714285714285716
393,4,3,-1,889729537,889729561,24,68,783,2.388888888888889
393,3,3,0,889729561,889729614,53,783,672,2.7222222222222223
393,3,2,-1,889729614,889729638,24,672,552,2.8095238095238093
393,2,3,1,889729638,889729673,35,552,779,2.2
393,3,4,1,889729673,889729674,1,779,49,3.3
393,4,3,-1,889729674,889729749,75,49,1469,3.4
393,3,4,1,889729749,889729773,24,1469,790,2.8518518518518516
393,4,2,-2,889729773,889729938,165,790,90,3.0
393,2,4,2,889729938,889730045,107,90,72,3.175438596491228
393,4,3,-1,889730045,889730066,21,72,88,3.433734939759036
393,3,3,0,889730066,889730088,22,88,67,3.106382978723404
393,3,4,1,889730088,889730117,29,67,794,3.6
393,4,3,-1,889730117,889730187,70,794,402,3.3076923076923075
393,3,3,0,889730187,889730209,22,402,728,3.05
393,3,3,0,889730209,889730262,53,728,823,2.75
393,3,3,0,889730262,889730296,34,823,1074,2.857142857142857
393,3,3,0,889730296,889730460,164,1074,233,3.323529411764706
393,3,3,0,889730460,889730494,34,233,1206,2.8333333333333335
393,3,1,-2,889730494,889730514,20,1206,396,2.84
393,1,3,2,889730514,889731040,526,396,1183,2.5
393,3,2,-1,889731040,889731088,48,1183,449,2.9069767441860463
393,2,3,1,889731088,889731109,21,449,1076,2.5
393,3,3,0,889731109,889731138,29,1076,797,3.1538461538461537
393,3,3,0,889731138,889731139,1,797,1092,2.5714285714285716
393,3,4,1,889731139,889731329,190,1092,1249,3.2
393,4,3,-1,889731329,889731359,30,1249,1440,3.0
393,3,4,1,889731359,889731390,31,1440,386,2.769230769230769
393,4,2,-2,889731390,889731413,23,386,1034,2.6
393,2,3,1,889731413,889731465,52,1034,949,3.392857142857143
393,3,2,-1,889731465,889731501,36,949,725,3.0
393,2,2,0,889731501,889731521,20,725,78,2.3636363636363638
393,2,3,1,889731521,889731562,41,78,623,3.0454545454545454
393,3,1,-2,889731562,889731592,30,623,715,3.257142857142857
393,1,4,3,889731592,889731593,1,715,769,2.2222222222222223
393,4,4,0,889731593,889731618,25,769,572,2.857142857142857
393,4,3,-1,889731618,889731702,84,572,374,2.111111111111111
393,3,1,-2,889731702,889731703,1,374,997,2.7142857142857144
393,1,3,2,889731703,889731729,26,997,826,2.5555555555555554
393,3,3,0,889731729,889731753,24,826,395,2.5714285714285716
393,3,3,0,889731753,889731793,40,395,138,2.6
393,3,3,0,889731793,889731820,27,138,145,2.3636363636363638
393,3,2,-1,889731820,889731840,20,145,1091,2.5384615384615383
393,2,3,1,889731840,889731861,21,1091,843,2.933333333333333
393,3,4,1,889731861,891364609,1632748,843,303,3.75
393,4,3,-1,891364609,891364757,148,303,539,2.6666666666666665
392,4,4,0,891037437,891037531,94,346,288,3.5214285714285714
392,4,4,0,891037531,891037561,30,288,294,3.1052631578947367
392,4,4,0,891037561,891037600,39,294,347,3.59375
392,4,3,-1,891037600,891037634,34,347,328,3.4895833333333335
392,3,5,2,891037634,891037685,51,328,321,3.0172413793103448
392,5,1,-4,891037685,891037720,35,321,324,3.2291666666666665
392,1,3,2,891037720,891037769,49,324,323,3.0
392,3,1,-2,891037769,891037790,21,323,260,2.4716981132075473
392,1,5,4,891037790,891037811,21,260,316,4.285714285714286
392,5,3,-2,891037811,891038158,347,316,250,3.4698795180722892
392,3,5,2,891038158,891038184,26,250,1142,4.0476190476190474
392,5,1,-4,891038184,891038205,21,1142,298,3.779220779220779
392,1,3,2,891038205,891038247,42,298,244,2.9411764705882355
392,3,4,1,891038247,891038288,41,244,1226,3.5454545454545454
392,4,3,-1,891038288,891038401,113,1226,495,3.65
392,3,4,1,891038401,891038433,32,495,58,3.543859649122807
392,4,5,1,891038433,891038466,33,58,517,3.625
392,5,3,-2,891038466,891038946,480,517,463,3.6818181818181817
392,3,5,2,891038946,891038978,32,463,197,4.112676056338028
392,5,4,-1,891038978,891038979,1,197,492,4.117647058823529
392,4,3,-1,891038979,891039015,36,492,813,4.055555555555555
392,3,3,0,891039015,891039050,35,813,285,4.181818181818182
376,3,4,1,879433102,879434613,1511,301,603,4.315789473684211
376,4,3,-1,879434613,879434750,137,603,663,3.948717948717949
376,3,3,0,879434750,879459115,24365,663,274,3.5609756097560976
376,3,3,0,879459115,879459207,92,274,815,3.135135135135135
394,4,4,0,880886670,880886821,151,101,28,3.923076923076923
394,4,4,0,880886821,880886855,34,28,156,4.017857142857143
394,4,5,1,880886855,880886919,64,156,96,3.9130434782608696
394,5,5,0,880886919,880886978,59,96,144,3.9545454545454546
394,5,4,-1,880886978,880887000,22,144,132,3.929411764705882
394,4,4,0,880887000,880887035,35,132,12,4.358974358974359
394,4,5,1,880887035,880887063,28,12,69,3.8015873015873014
394,5,5,0,880887063,880887088,25,69,98,4.240875912408759
394,5,3,-2,880887088,880887152,64,98,31,3.642857142857143
394,3,5,2,880887152,880887250,98,31,419,3.8208955223880596
394,5,5,0,880887250,880887322,72,419,186,3.905263157894737
394,5,5,0,880887322,880887406,84,186,56,4.051724137931035
394,5,4,-1,880887406,880887462,56,56,418,3.825
394,4,3,-1,880887462,880888063,601,418,216,3.8454545454545452
394,3,3,0,880888063,880888096,33,216,282,3.610526315789474
394,3,4,1,880888096,880888223,127,282,651,3.8627450980392157
394,4,5,1,880888223,880888245,22,651,202,3.730337078651685
394,5,5,0,880888245,880888313,68,202,655,3.7857142857142856
394,5,5,0,880888313,880888390,77,655,7,3.76056338028169
394,5,4,-1,880888390,880888452,62,7,121,3.521212121212121
394,4,4,0,880888452,880888501,49,121,39,3.107142857142857
394,4,5,1,880888501,880888566,65,39,123,3.297872340425532
394,5,3,-2,880888566,880888603,37,123,77,3.3857142857142857
394,3,4,1,880888603,880888689,86,77,210,3.921259842519685
394,4,4,0,880888689,880888746,57,210,559,3.477272727272727
394,4,4,0,880888746,880888775,29,559,402,3.3076923076923075
394,4,3,-1,880888775,880888815,40,402,141,3.4827586206896552
394,3,2,-1,880888815,880888850,35,141,226,3.378787878787879
394,2,2,0,880888850,880888927,77,226,578,3.066666666666667
394,2,3,1,880888927,880889010,83,578,405,3.25
394,3,4,1,880889010,880889159,149,405,109,3.282608695652174
394,4,4,0,880889159,880889187,28,109,218,3.5555555555555554
394,4,4,0,880889187,880889259,72,218,33,3.2941176470588234
394,4,3,-1,880889259,880889400,141,33,88,3.433734939759036
394,3,3,0,880889400,880889528,128,88,90,3.0
394,3,4,1,880889528,880889553,25,90,82,3.6741573033707864
394,4,4,0,880889553,880889629,76,82,72,3.175438596491228
394,4,3,-1,880889629,880889741,112,72,541,2.9473684210526314
394,3,4,1,880889741,880889766,25,541,739,3.391304347826087
394,4,5,1,880889766,881057914,168148,739,174,4.253521126760563
394,5,3,-2,881057914,881058062,148,174,679,3.2432432432432434
394,3,4,1,881058062,881058101,39,679,554,2.9555555555555557
394,4,4,0,881058101,881058167,66,554,546,2.9789473684210526
394,4,3,-1,881058167,881058330,163,546,797,3.1538461538461537
394,3,2,-1,881058330,881058371,41,797,576,3.125
394,2,5,3,881058371,881058419,48,576,68,3.5714285714285716
394,5,3,-2,881058419,881058929,510,68,763,3.347826086956522
394,3,4,1,881058929,881058969,40,763,411,2.911764705882353
394,4,2,-2,881058969,881059103,134,411,795,2.4
394,2,3,1,881059103,881059148,45,795,1079,2.1923076923076925
394,3,2,-1,881059148,881059180,32,1079,780,3.08
394,2,5,3,881059180,881059383,203,780,67,3.106382978723404
394,5,4,-1,881059383,881059464,81,67,63,3.125
394,4,4,0,881059464,881059619,155,63,1484,4.0
394,4,4,0,881059619,881059902,283,1484,928,3.142857142857143
394,4,4,0,881059902,881060053,151,928,773,3.1666666666666665
394,4,3,-1,881060053,881060176,123,773,552,2.8095238095238093
394,3,4,1,881060176,881060177,1,552,561,3.1515151515151514
394,4,3,-1,881060177,881060330,153,561,1210,2.7142857142857144
394,3,4,1,881060330,881060366,36,1210,771,2.5714285714285716
394,4,4,0,881060366,881130047,69681,771,257,3.7154471544715446
394,4,4,0,881130047,881130076,29,257,250,3.4698795180722892
394,4,4,0,881130076,881132877,2801,250,227,3.169811320754717
391,3,3,0,877398619,877398679,60,748,288,3.5214285714285714
391,3,2,-1,877398679,877398704,25,288,678,2.8181818181818183
391,2,4,2,877398704,877398856,152,678,213,3.943396226415094
391,4,3,-1,877398856,877398898,42,213,491,3.55
391,3,3,0,877398898,877398951,53,491,11,3.8904109589041096
391,3,5,2,877398951,877398991,40,11,603,4.315789473684211
391,5,4,-1,877398991,877398992,1,603,23,3.9047619047619047
391,4,4,0,877398992,877399030,38,23,187,4.215189873417722
391,4,4,0,877399030,877399066,36,187,646,3.9285714285714284
391,4,5,1,877399066,877399100,34,646,648,3.9545454545454546
391,5,4,-1,877399100,877399133,33,648,98,4.240875912408759
391,4,3,-1,877399133,877399171,38,98,378,3.6904761904761907
391,3,4,1,877399171,877399208,37,378,659,4.027777777777778
391,4,5,1,877399208,877399236,28,659,127,4.162790697674419
391,5,5,0,877399236,877399269,33,127,200,3.8157894736842106
391,5,5,0,877399269,877399301,32,200,174,4.253521126760563
391,5,3,-2,877399301,877399336,35,174,191,4.168674698795181
391,3,5,2,877399336,877399337,1,191,530,4.125
391,5,4,-1,877399337,877399380,43,530,482,3.9444444444444446
391,4,4,0,877399380,877399423,43,482,1101,3.793103448275862
391,4,5,1,877399423,877399486,63,1101,357,4.063291139240507
391,5,5,0,877399486,877399512,26,357,427,4.2025316455696204
391,5,3,-2,877399512,877399541,29,427,527,3.823529411764706
391,3,2,-1,877399541,877399588,47,527,715,3.257142857142857
391,2,3,1,877399588,877399658,70,715,188,3.625
391,3,5,2,877399658,877399659,1,188,238,3.888888888888889
391,5,4,-1,877399659,877399696,37,238,182,3.842857142857143
391,4,5,1,877399696,877399745,49,182,12,4.358974358974359
391,5,5,0,877399745,877399746,1,12,61,4.190476190476191
391,5,3,-2,877399746,877399780,34,61,276,3.6036036036036037
391,3,4,1,877399780,877399805,25,276,15,3.725663716814159
391,4,2,-2,877399805,877399864,59,15,222,3.578125
391,2,4,2,877399864,877399894,30,222,591,3.7169811320754715
391,4,3,-1,877399894,877400037,143,591,546,2.9789473684210526
391,3,3,0,877400037,877400062,25,546,148,3.2131147540983607
391,3,4,1,877400062,877400092,30,148,544,3.185185185185185
391,4,2,-2,877400092,877400116,24,544,924,3.3703703703703702
398,4,3,-1,875651657,875652760,1103,127,476,3.1216216216216215
398,3,3,0,875652760,875652816,56,476,100,4.0162162162162165
398,3,3,0,875652816,875652876,60,100,591,3.7169811320754715
398,3,3,0,875652876,875653043,167,591,993,3.4838709677419355
398,3,4,1,875653043,875653091,48,993,117,3.689189189189189
398,4,3,-1,875653091,875653168,77,117,237,3.7315436241610738
398,3,5,2,875653168,875657926,4758,237,228,3.7246376811594204
398,5,5,0,875657926,875658794,868,228,480,4.283018867924528
398,5,3,-2,875658794,875658898,104,480,134,4.174603174603175
398,3,3,0,875658898,875658968,70,134,953,3.076923076923077
398,3,4,1,875658968,875659266,298,953,735,3.58
398,4,4,0,875659266,875659517,251,735,588,3.8358208955223883
398,4,5,1,875659517,875660302,785,588,28,3.923076923076923
398,5,4,-1,875660302,875660439,137,28,64,4.373737373737374
398,4,4,0,875660439,875660535,96,64,79,3.956989247311828
398,4,4,0,875660535,875716829,56294,79,429,3.742857142857143
398,4,2,-2,875716829,875716830,1,429,710,3.41025641025641
398,2,3,1,875716830,875717020,190,710,159,3.3902439024390243
398,3,5,2,875717020,875717717,697,159,1450,4.0
398,5,3,-2,875717717,875718670,953,1450,432,3.719298245614035
398,3,4,1,875718670,875718731,61,432,85,3.3157894736842106
398,4,4,0,875718731,875719080,349,85,173,4.1441441441441444
398,4,4,0,875719080,875721702,2622,173,152,3.6785714285714284
398,4,5,1,875721702,875723253,1551,152,208,3.8125
398,5,3,-2,875723253,875738391,15138,208,659,4.027777777777778
398,3,3,0,875738391,875738523,132,659,47,3.5869565217391304
398,3,2,-1,875738523,875743840,5317,47,231,2.938775510204082
398,2,4,2,875743840,875812011,68171,231,1119,3.5185185185185186
397,2,1,-1,875063649,875063678,29,327,991,2.4545454545454546
397,1,1,0,875063678,875063722,44,991,457,1.7
397,1,2,1,875063722,882838749,7775027,457,324,3.2291666666666665
397,2,2,0,882838749,882838773,24,324,332,3.6511627906976742
397,2,1,-1,882838773,882838796,23,332,894,2.0
397,1,3,2,882838796,882838853,57,894,325,2.625
397,3,5,2,882838853,882839540,687,325,171,4.090909090909091
397,5,5,0,882839540,882839559,19,171,474,4.172413793103448
397,5,5,0,882839559,885349202,2509643,474,58,3.543859649122807
397,5,3,-2,885349202,885349348,146,58,289,2.988888888888889
397,3,4,1,885349348,885349476,128,289,855,3.590909090909091
397,4,4,0,885349476,885349528,52,855,588,3.8358208955223883
397,4,5,1,885349528,885349562,34,588,611,4.384615384615385
397,5,5,0,885349562,885349610,48,611,192,4.090909090909091
397,5,5,0,885349610,885349715,105,192,483,4.475609756097561
397,5,5,0,885349715,885349759,44,483,182,3.842857142857143
397,5,4,-1,885349759,885349790,31,182,12,4.358974358974359
397,4,4,0,885349790,885349825,35,12,210,3.921259842519685
397,4,5,1,885349825,885349865,40,210,504,4.085714285714285
397,5,5,0,885349865,885349913,48,504,7,3.76056338028169
397,5,4,-1,885349913,885349955,42,7,693,3.6285714285714286
397,4,5,1,885349955,885349999,44,693,174,4.253521126760563
397,5,5,0,885349999,885350045,46,174,705,3.7857142857142856
397,5,4,-1,885350045,885350326,281,705,529,4.142857142857143
397,4,3,-1,885350326,885350543,217,529,1298,3.0
397,3,4,1,885350543,889760663,4410120,1298,345,3.4782608695652173
397,4,5,1,889760663,889760703,40,345,302,4.133333333333334
397,5,4,-1,889760703,889760725,22,302,896,3.6666666666666665
397,4,4,0,889760725,889760803,78,896,109,3.282608695652174
399,3,3,0,882340200,882340242,42,288,754,3.5789473684210527
399,3,3,0,882340242,882340264,22,754,307,3.6031746031746033
399,3,3,0,882340264,882340284,20,307,268,3.9838709677419355
399,3,4,1,882340284,882340311,27,268,289,2.988888888888889
399,4,3,-1,882340311,882340421,110,289,1393,2.6666666666666665
399,3,1,-2,882340421,882340517,96,1393,323,3.0
399,1,4,3,882340517,882340556,39,323,1137,4.25
399,4,5,1,882340556,882340620,64,1137,147,3.3142857142857145
399,5,3,-2,882340620,882340639,19,147,246,4.0
399,3,5,2,882340639,882340678,39,246,924,3.3703703703703702
399,5,3,-2,882340678,882340719,41,924,628,3.573529411764706
399,3,3,0,882340719,882340775,56,628,282,3.610526315789474
399,3,2,-1,882340775,882340807,32,282,123,3.297872340425532
399,2,3,1,882340807,882340827,20,123,1086,3.857142857142857
399,3,5,2,882340827,882340828,1,1086,15,3.725663716814159
399,5,4,-1,882340828,882340844,16,15,742,3.5555555555555554
399,4,2,-2,882340844,882340900,56,742,413,2.5652173913043477
399,2,4,2,882340900,882341239,339,413,24,3.3728813559322033
399,4,4,0,882341239,882341264,25,24,295,3.769230769230769
399,4,3,-1,882341264,882341330,66,295,597,3.2771084337349397
399,3,4,1,882341330,882341362,32,597,148,3.2131147540983607
399,4,2,-2,882341362,882341383,21,148,546,2.9789473684210526
399,2,3,1,882341383,882341403,20,546,121,3.521212121212121
399,3,2,-1,882341403,882341445,42,121,824,2.590909090909091
399,2,1,-1,882341445,882341554,109,824,760,2.35
399,1,3,2,882341554,882341607,53,760,977,2.473684210526316
399,3,3,0,882341607,882341625,18,977,1279,3.0
399,3,3,0,882341625,882341644,19,1279,407,2.611111111111111
399,3,1,-2,882341644,882341881,237,407,616,3.1052631578947367
399,1,4,3,882341881,882341974,93,616,114,4.3478260869565215
399,4,3,-1,882341974,882342019,45,114,96,3.9130434782608696
399,3,3,0,882342019,882342061,42,96,204,3.6744186046511627
399,3,3,0,882342061,882342127,66,204,176,3.967032967032967
399,3,5,2,882342127,882342158,31,176,746,3.7560975609756095
399,5,3,-2,882342158,882342187,29,746,174,4.253521126760563
399,3,3,0,882342187,882342219,32,174,1401,3.0
399,3,3,0,882342219,882342313,94,1401,64,4.373737373737374
399,3,3,0,882342313,882342354,41,64,399,3.317073170731707
399,3,3,0,882342354,882342537,183,399,156,4.017857142857143
399,3,5,2,882342537,882342589,52,156,318,4.5046728971962615
399,5,3,-2,882342589,882342669,80,318,175,3.8354430379746836
399,3,3,0,882342669,882342689,20,175,144,3.9545454545454546
399,3,3,0,882342689,882342805,116,144,210,3.921259842519685
399,3,4,1,882342805,882342866,61,210,241,3.5625
399,4,4,0,882342866,882342894,28,241,98,4.240875912408759
399,4,5,1,882342894,882342938,44,98,588,3.8358208955223883
399,5,3,-2,882342938,882342964,26,588,531,3.7435897435897436
399,3,3,0,882342964,882343012,48,531,223,4.108695652173913
399,3,3,0,882343012,882343040,28,223,50,4.306532663316583
399,3,4,1,882343040,882343126,86,50,54,3.3714285714285714
399,4,3,-1,882343126,882343171,45,54,526,3.909090909090909
399,3,3,0,882343171,882343172,1,526,946,3.1153846153846154
399,3,4,1,882343172,882343204,32,946,97,3.7282608695652173
399,4,4,0,882343204,882343260,56,97,57,4.133333333333334
399,4,3,-1,882343260,882343293,33,57,128,3.45
399,3,3,0,882343293,882343294,1,128,234,3.7674418604651163
399,3,2,-1,882343294,882343389,95,234,1220,2.9166666666666665
399,2,3,1,882343389,882343523,134,1220,959,3.4583333333333335
399,3,4,1,882343523,882343605,82,959,622,3.3333333333333335
399,4,4,0,882343605,882343731,126,622,140,3.238095238095238
399,4,3,-1,882343731,882343789,58,140,673,3.393939393939394
399,3,3,0,882343789,882344052,263,673,423,3.7016129032258065
399,3,3,0,882344052,882344096,44,423,559,3.477272727272727
399,3,3,0,882344096,882344134,38,559,382,3.764705882352941
399,3,3,0,882344134,882344236,102,382,102,3.3684210526315788
399,3,3,0,882344236,882344269,33,102,433,3.8035714285714284
399,3,2,-1,882344269,882344310,41,433,39,3.107142857142857
399,2,3,1,882344310,882344372,62,39,655,3.7857142857142856
399,3,3,0,882344372,882344406,34,655,226,3.378787878787879
399,3,4,1,882344406,882344434,28,226,203,3.826923076923077
399,4,3,-1,882344434,882344512,78,203,230,3.3518518518518516
399,3,3,0,882344512,882344553,41,230,239,3.423076923076923
399,3,3,0,882344553,882344638,85,239,1184,2.5
399,3,4,1,882344638,882344722,84,1184,214,3.272727272727273
399,4,2,-2,882344722,882344757,35,214,755,3.085714285714286
399,2,2,0,882344757,882344794,37,755,227,3.169811320754717
399,2,4,2,882344794,882344832,38,227,470,3.72
399,4,4,0,882344832,882344871,39,470,566,3.543859649122807
399,4,2,-2,882344871,882344906,35,566,431,3.422222222222222
399,2,3,1,882344906,882344942,36,431,33,3.2941176470588234
399,3,2,-1,882344942,882344974,32,33,975,3.411764705882353
399,2,3,1,882344974,882345001,27,975,180,3.9473684210526314
399,3,4,1,882345001,882345023,22,180,91,3.6
399,4,3,-1,882345023,882345053,30,91,774,3.0
399,3,3,0,882345053,882345078,25,774,389,3.272727272727273
399,3,2,-1,882345078,882345164,86,389,38,2.784313725490196
399,2,3,1,882345164,882345212,48,38,225,3.0714285714285716
399,3,3,0,882345212,882345271,59,225,366,3.4285714285714284
399,3,2,-1,882345271,882345335,64,366,561,3.1515151515151514
399,2,3,1,882345335,882345408,73,561,665,2.72972972972973
399,3,2,-1,882345408,882345454,46,665,697,2.7777777777777777
399,2,3,1,882345454,882345473,19,697,1459,3.6
399,3,3,0,882345473,882345500,27,1459,1228,2.5
399,3,3,0,882345500,882345649,149,1228,31,3.642857142857143
399,3,2,-1,882345649,882345842,193,31,568,3.5853658536585367
399,2,2,0,882345842,882346585,743,568,127,4.162790697674419
399,2,3,1,882346585,882346649,64,127,56,4.051724137931035
399,3,3,0,882346649,882346728,79,56,969,3.8947368421052633
399,3,2,-1,882346728,882346851,123,969,501,3.289473684210526
399,2,3,1,882346851,882347019,168,501,633,3.9
399,3,4,1,882347019,882347190,171,633,549,3.4871794871794872
399,4,2,-2,882347190,882347620,430,549,117,3.689189189189189
399,2,3,1,882347620,882347783,163,117,420,3.5652173913043477
399,3,3,0,882347783,882348284,501,420,378,3.6904761904761907
399,3,2,-1,882348284,882348478,194,378,436,3.5
399,2,3,1,882348478,882348565,87,436,720,3.2
399,3,3,0,882348565,882348592,27,720,554,2.9555555555555557
399,3,3,0,882348592,882348615,23,554,63,3.125
399,3,3,0,882348615,882348664,49,63,43,3.1
399,3,2,-1,882348664,882348690,26,43,1210,2.7142857142857144
399,2,2,0,882348690,882348722,32,1210,578,3.066666666666667
399,2,2,0,882348722,882348850,128,578,926,2.7857142857142856
399,2,2,0,882348850,882348876,26,926,41,3.0625
399,2,3,1,882348876,882348948,72,41,78,2.3636363636363638
399,3,4,1,882348948,882348974,26,78,1139,2.611111111111111
399,4,3,-1,882348974,882349068,94,1139,80,2.967741935483871
399,3,2,-1,882349068,882349094,26,80,77,3.3857142857142857
399,2,2,0,882349094,882349143,49,77,229,3.185185185185185
399,2,3,1,882349143,882349170,27,229,400,2.375
399,3,3,0,882349170,882349198,28,400,29,2.5714285714285716
399,3,3,0,882349198,882349274,76,29,794,3.6
399,3,2,-1,882349274,882349353,79,794,826,2.5555555555555554
399,2,3,1,882349353,882349868,515,826,48,4.055555555555555
399,3,3,0,882349868,882349928,60,48,173,4.1441441441441444
399,3,3,0,882349928,882350005,77,173,465,3.75
399,3,3,0,882350005,882350198,193,465,658,3.393939393939394
399,3,4,1,882350198,882350323,125,658,72,3.175438596491228
399,4,3,-1,882350323,882350341,18,72,1178,2.375
399,3,3,0,882350341,882350375,34,1178,231,2.938775510204082
399,3,2,-1,882350375,882350431,56,231,232,3.0789473684210527
399,2,3,1,882350431,882350487,56,232,1231,2.7
399,3,3,0,882350487,882350502,15,1231,403,3.298507462686567
399,3,4,1,882350502,882350583,81,403,738,3.0
399,4,2,-2,882350583,882350617,34,738,781,3.4166666666666665
399,2,1,-1,882350617,882350733,116,781,444,2.6842105263157894
399,1,1,0,882350733,882350762,29,444,575,2.619047619047619
399,1,2,1,882350762,882350791,29,575,388,2.5833333333333335
399,2,1,-1,882350791,882350850,59,388,780,3.08
399,1,1,0,882350850,882350870,20,780,1274,1.8
399,1,3,2,882350870,882350899,29,1274,67,3.106382978723404
399,3,3,0,882350899,882351626,727,67,587,3.4
399,3,3,0,882351626,882352357,731,587,809,2.7058823529411766
399,3,3,0,882352357,882352404,47,809,560,3.111111111111111
399,3,2,-1,882352404,882352468,64,560,412,2.272727272727273
399,2,3,1,882352468,882509855,157387,412,100,4.0162162162162165
399,3,3,0,882509855,882509891,36,100,1543,3.0
399,3,4,1,882509891,882509927,36,1543,817,4.0
399,4,3,-1,882509927,882509971,44,817,508,3.6923076923076925
399,3,3,0,882509971,882510018,47,508,9,3.8878504672897196
399,3,3,0,882510018,882510107,89,9,1541,3.0
399,3,3,0,882510107,882510147,40,1541,744,3.5714285714285716
399,3,3,0,882510147,882510165,18,744,693,3.6285714285714286
399,3,2,-1,882510165,882510226,61,693,215,3.662921348314607
399,2,3,1,882510226,882510250,24,215,660,3.71875
399,3,3,0,882510250,882510269,19,660,1060,3.235294117647059
399,3,2,-1,882510269,882510379,110,1060,919,4.0
399,2,3,1,882510379,882511093,714,919,527,3.823529411764706
399,3,3,0,882511093,882512003,910,527,379,3.35
399,3,3,0,882512003,882512167,164,379,274,3.5609756097560976
399,3,3,0,882512167,882512214,47,274,79,3.956989247311828
399,3,2,-1,882512214,882512342,128,79,284,3.1547619047619047
396,3,2,-1,884645550,884645615,65,300,329,3.25
396,2,3,1,884645615,884645648,33,329,751,3.3896103896103895
396,3,3,0,884645648,884645720,72,751,245,3.056179775280899
396,3,3,0,884645720,884645754,34,245,260,2.4716981132075473
396,3,4,1,884645754,884645790,36,260,322,3.0476190476190474
396,4,4,0,884645790,884645813,23,322,328,3.4895833333333335
396,4,3,-1,884645813,884645838,25,328,678,2.8181818181818183
396,3,4,1,884645838,884645839,1,678,1025,2.95
396,4,3,-1,884645839,884645942,103,1025,1399,3.5
396,3,4,1,884645942,884646052,110,1399,282,3.610526315789474
396,4,2,-2,884646052,884646092,40,282,100,4.0162162162162165
396,2,3,1,884646092,884646114,22,100,591,3.7169811320754715
396,3,5,2,884646114,884646152,38,591,222,3.578125
396,5,3,-2,884646152,884646191,39,222,25,3.3185840707964602
396,3,5,2,884646191,884646235,44,25,121,3.521212121212121
396,5,4,-1,884646235,884646263,28,121,471,3.5714285714285716
396,4,4,0,884646263,884646314,51,471,118,3.2764227642276422
396,4,4,0,884646314,884646346,32,118,742,3.5555555555555554
396,4,4,0,884646346,884646401,55,742,9,3.8878504672897196
396,4,4,0,884646401,884646436,35,9,148,3.2131147540983607
396,4,3,-1,884646436,884646468,32,148,977,2.473684210526316
396,3,4,1,884646468,884646537,69,977,986,2.5555555555555554
396,4,2,-2,884646537,884646582,45,986,455,3.1702127659574466
396,2,2,0,884646582,884646647,65,455,823,2.75
396,2,3,1,884646647,884646648,1,823,840,3.090909090909091
396,3,2,-1,884646648,884646709,61,840,1215,2.0714285714285716
401,3,1,-2,891031508,891031532,24,272,751,3.3896103896103895
401,1,2,1,891031532,891031554,22,751,321,3.0172413793103448
401,2,1,-1,891031554,891031621,67,321,294,3.1052631578947367
401,1,1,0,891031621,891031723,102,294,342,2.64
401,1,5,4,891031723,891031756,33,342,316,4.285714285714286
401,5,2,-3,891031756,891031784,28,316,322,3.0476190476190474
401,2,3,1,891031784,891031936,152,322,678,2.8181818181818183
401,3,3,0,891031936,891032218,282,678,9,3.8878504672897196
401,3,3,0,891032218,891032271,53,9,14,4.101694915254237
401,3,4,1,891032271,891032296,25,14,111,3.5106382978723403
401,4,3,-1,891032296,891032316,20,111,137,3.9545454545454546
401,3,2,-1,891032316,891032334,18,137,273,3.5238095238095237
401,2,3,1,891032334,891032367,33,273,1011,3.1
401,3,3,0,891032367,891032433,66,1011,508,3.6923076923076925
401,3,2,-1,891032433,891032453,20,508,405,3.25
401,2,2,0,891032453,891032495,42,405,1289,2.0
401,2,3,1,891032495,891032518,23,1289,181,3.98974358974359
401,3,3,0,891032518,891032563,45,181,117,3.689189189189189
401,3,3,0,891032563,891032584,21,117,282,3.610526315789474
401,3,4,1,891032584,891032626,42,282,1009,3.2962962962962963
401,4,3,-1,891032626,891032662,36,1009,815,3.135135135135135
401,3,3,0,891032662,891032697,35,815,866,3.3962264150943398
401,3,4,1,891032697,891032737,40,866,318,4.5046728971962615
401,4,3,-1,891032737,891032757,20,318,64,4.373737373737374
401,3,4,1,891032757,891032803,46,64,216,3.8454545454545452
401,4,3,-1,891032803,891032847,44,216,429,3.742857142857143
401,3,4,1,891032847,891032868,21,429,44,3.1333333333333333
401,4,4,0,891032868,891032919,51,44,527,3.823529411764706
401,4,3,-1,891032919,891032937,18,527,173,4.1441441441441444
401,3,4,1,891032937,891032976,39,173,210,3.921259842519685
401,4,3,-1,891032976,891033014,38,210,481,3.8421052631578947
401,3,4,1,891033014,891033034,20,481,143,3.56
401,4,3,-1,891033034,891033061,27,143,659,4.027777777777778
401,3,4,1,891033061,891033092,31,659,485,3.717948717948718
401,4,4,0,891033092,891033121,29,485,483,4.475609756097561
401,4,4,0,891033121,891033122,1,483,356,3.2
401,4,3,-1,891033122,891033158,36,356,661,4.133333333333334
401,3,1,-2,891033158,891033184,26,661,154,3.6031746031746033
401,1,2,1,891033184,891033227,43,154,11,3.8904109589041096
401,2,5,3,891033227,891033250,23,11,435,3.8933333333333335
401,5,1,-4,891033250,891033267,17,435,188,3.625
401,1,3,2,891033267,891033319,52,188,499,4.0
401,3,4,1,891033319,891033370,51,499,198,4.04
401,4,3,-1,891033370,891033442,72,198,520,4.136363636363637
401,3,1,-2,891033442,891033549,107,520,663,3.948717948717949
401,1,3,2,891033549,891033550,1,663,371,3.0
401,3,4,1,891033550,891033582,32,371,509,3.7058823529411766
401,4,2,-2,891033582,891033603,21,509,161,3.5844155844155843
401,2,3,1,891033603,891033651,48,161,125,3.5555555555555554
401,3,5,2,891033651,891033684,33,125,204,3.6744186046511627
402,3,5,2,876266701,876266741,40,13,275,4.087912087912088
402,5,4,-1,876266741,876266775,34,275,529,4.142857142857143
402,4,4,0,876266775,876266826,51,529,234,3.7674418604651163
402,4,1,-3,876266826,876266860,34,234,245,3.056179775280899
402,1,3,2,876266860,876266886,26,245,455,3.1702127659574466
402,3,4,1,876266886,876266948,62,455,222,3.578125
402,4,3,-1,876266948,876266984,36,222,1284,2.5454545454545454
402,3,3,0,876266984,876266985,1,1284,476,3.1216216216216215
402,3,5,2,876266985,876267014,29,476,276,3.6036036036036037
402,5,4,-1,876267014,876267041,27,276,591,3.7169811320754715
402,4,3,-1,876267041,876267067,26,591,628,3.573529411764706
402,3,4,1,876267067,876267068,1,628,7,3.76056338028169
402,4,5,1,876267068,876267115,47,7,15,3.725663716814159
402,5,4,-1,876267115,876267173,58,15,42,3.893617021276596
402,4,2,-2,876267173,876267206,33,42,710,3.41025641025641
402,2,4,2,876267206,876267234,28,710,1101,3.793103448275862
402,4,3,-1,876267234,876267235,1,1101,32,3.7222222222222223
384,4,5,1,891273649,891273683,34,286,313,4.323076923076923
384,5,3,-2,891273683,891273716,33,313,343,3.0
384,3,4,1,891273716,891273809,93,343,300,3.6861313868613137
384,4,4,0,891273809,891273874,65,300,879,3.2291666666666665
384,4,4,0,891273874,891273905,31,879,989,3.142857142857143
384,4,4,0,891273905,891274055,150,989,355,2.75
384,4,4,0,891274055,891274091,36,355,328,3.4895833333333335
384,4,4,0,891274091,891274232,141,328,689,3.1538461538461537
395,3,5,2,883762135,883762266,131,313,750,4.027777777777778
395,5,4,-1,883762266,883762309,43,750,258,3.7547169811320753
395,4,3,-1,883762309,883762577,268,258,748,3.1043478260869564
395,3,5,2,883762577,883762614,37,748,343,3.0
395,5,3,-2,883762614,883762681,67,343,892,2.9615384615384617
395,3,4,1,883762681,883762733,52,892,338,2.75
395,4,5,1,883762733,883763041,308,338,172,4.225225225225225
395,5,5,0,883763041,883763136,95,172,210,3.921259842519685
395,5,5,0,883763136,883763800,664,210,97,3.7282608695652173
395,5,4,-1,883763800,883764004,204,97,318,4.5046728971962615
395,4,5,1,883764004,883764061,57,318,98,4.240875912408759
395,5,5,0,883764061,883764336,275,98,181,3.98974358974359
395,5,4,-1,883764336,883764378,42,181,196,3.9404761904761907
395,4,5,1,883764378,883764421,43,196,378,3.6904761904761907
395,5,4,-1,883764421,883764456,35,378,231,2.938775510204082
395,4,5,1,883764456,883764817,361,231,186,3.905263157894737
395,5,5,0,883764817,883764845,28,186,632,3.9523809523809526
395,5,5,0,883764845,883764878,33,632,154,3.6031746031746033
395,5,4,-1,883764878,883764974,96,154,237,3.7315436241610738
395,4,5,1,883764974,883765034,60,237,127,4.162790697674419
395,5,4,-1,883765034,883765156,122,127,924,3.3703703703703702
395,4,3,-1,883765156,883765297,141,924,151,3.6544117647058822
395,3,3,0,883765297,883765791,494,151,118,3.2764227642276422
395,3,3,0,883765791,883765897,106,118,252,2.911392405063291
395,3,3,0,883765897,883765965,68,252,472,2.984375
395,3,3,0,883765965,883766119,154,472,866,3.3962264150943398
353,4,3,-1,891401992,891402310,318,331,300,3.6861313868613137
353,3,2,-1,891402310,891402358,48,300,270,3.7804878048780486
353,2,4,2,891402358,891402405,47,270,245,3.056179775280899
353,4,2,-2,891402405,891402443,38,245,327,3.5076923076923077
353,2,2,0,891402443,891402444,1,327,326,3.262295081967213
353,2,2,0,891402444,891402567,123,326,271,3.3134328358208953
353,2,2,0,891402567,891402587,20,271,898,3.0869565217391304
353,2,1,-1,891402587,891402617,30,898,260,2.4716981132075473
353,1,2,1,891402617,891402636,19,260,343,3.0
353,2,4,2,891402636,891402674,38,343,905,3.357142857142857
403,5,4,-1,879785736,879785916,180,50,181,3.98974358974359
403,4,4,0,879785916,879785941,25,181,276,3.6036036036036037
403,4,4,0,879785941,879786052,111,276,845,3.661290322580645
403,4,2,-2,879786052,879786112,60,845,257,3.7154471544715446
403,2,5,3,879786112,879786165,53,257,235,3.106382978723404
403,5,1,-4,879786165,879786190,25,235,1012,3.2916666666666665
403,1,5,4,879786190,879786221,31,1012,121,3.521212121212121
403,5,4,-1,879786221,879786270,49,121,151,3.6544117647058822
403,4,5,1,879786270,879786351,81,151,148,3.2131147540983607
403,5,5,0,879786351,879786406,55,148,748,3.1043478260869564
403,5,4,-1,879786406,879786662,256,748,685,3.2666666666666666
403,4,5,1,879786662,879786747,85,685,405,3.25
403,5,1,-4,879786747,879790343,3596,405,760,2.35
403,1,3,2,879790343,879790344,1,760,370,2.8125
403,3,1,-2,879790344,879790389,45,370,284,3.1547619047619047
403,1,4,3,879790389,879790468,79,284,925,3.0
403,4,2,-2,879790468,879790506,38,925,1199,2.6666666666666665
405,3,5,2,885544698,885544739,41,468,187,4.215189873417722
405,5,4,-1,885544739,885544769,30,187,185,3.9726027397260273
405,4,3,-1,885544769,885544881,112,185,96,3.9130434782608696
405,3,4,1,885544881,885544911,30,96,56,4.051724137931035
405,4,5,1,885544911,885544947,36,56,50,4.306532663316583
405,5,5,0,885544947,885544974,27,50,357,4.063291139240507
405,5,4,-1,885544974,885545015,41,357,8,3.903225806451613
405,4,4,0,885545015,885545167,152,8,197,4.112676056338028
405,4,4,0,885545167,885545200,33,197,467,4.071428571428571
405,4,5,1,885545200,885545263,63,467,215,3.662921348314607
405,5,5,0,885545263,885545306,43,215,423,3.7016129032258065
405,5,5,0,885545306,885545333,27,423,135,3.7974683544303796
405,5,5,0,885545333,885545372,39,135,23,3.9047619047619047
405,5,5,0,885545372,885545401,29,23,192,4.090909090909091
405,5,5,0,885545401,885545429,28,192,47,3.5869565217391304
405,5,5,0,885545429,885545456,27,47,732,3.6266666666666665
405,5,4,-1,885545456,885545516,60,732,658,3.393939393939394
405,4,3,-1,885545516,885545606,90,658,76,3.1875
405,3,2,-1,885545606,885545638,32,76,97,3.7282608695652173
405,2,3,1,885545638,885545639,1,97,461,3.3333333333333335
405,3,3,0,885545639,885545672,33,461,644,3.7
405,3,5,2,885545672,885545702,30,644,949,3.392857142857143
405,5,1,-4,885545702,885545883,181,949,697,2.7777777777777777
405,1,1,0,885545883,885545974,91,697,182,3.842857142857143
405,1,2,1,885545974,885546025,51,182,1103,3.5555555555555554
405,2,2,0,885546025,885546069,44,1103,75,3.3333333333333335
405,2,1,-1,885546069,885546112,43,75,196,3.9404761904761907
405,1,1,0,885546112,885546155,43,196,662,3.4583333333333335
405,1,3,2,885546155,885546202,47,662,1055,3.125
405,3,1,-2,885546202,885546248,46,1055,77,3.3857142857142857
405,1,1,0,885546248,885546287,39,77,695,3.0
405,1,1,0,885546287,885546288,1,695,469,3.6842105263157894
405,1,1,0,885546288,885546336,48,469,1308,1.0
405,1,1,0,885546336,885546379,43,1308,464,3.8
405,1,1,0,885546379,885546445,66,464,537,3.5
405,1,1,0,885546445,885546487,42,537,708,3.3157894736842106
405,1,1,0,885546487,885546530,43,708,724,3.64
405,1,1,0,885546530,885546577,47,724,1004,2.0
405,1,3,2,885546577,885546635,58,1004,1227,2.6
405,3,1,-2,885546635,885546636,1,1227,1478,2.7
405,1,1,0,885546636,885546680,44,1478,569,2.4285714285714284
405,1,1,0,885546680,885546681,1,569,1247,1.5
405,1,1,0,885546681,885546724,43,1247,664,3.15
405,1,1,0,885546724,885546725,1,664,1423,2.25
405,1,1,0,885546725,885546859,134,1423,1311,2.125
405,1,1,0,885546859,885547124,265,1311,853,2.75
405,1,1,0,885547124,885547176,52,853,435,3.8933333333333335
405,1,1,0,885547176,885547177,1,435,211,3.958904109589041
405,1,1,0,885547177,885547222,45,211,367,3.4242424242424243
405,1,4,3,885547222,885547268,46,367,710,3.41025641025641
405,4,1,-3,885547268,885547313,45,710,793,3.0
405,1,1,0,885547313,885547314,1,793,516,4.055555555555555
405,1,1,0,885547314,885547360,46,516,33,3.2941176470588234
405,1,1,0,885547360,885547407,47,33,702,2.764705882352941
405,1,1,0,885547407,885547408,1,702,399,3.317073170731707
405,1,3,2,885547408,885547447,39,399,796,2.923076923076923
405,3,1,-2,885547447,885547448,1,796,401,2.6774193548387095
405,1,1,0,885547448,885547506,58,401,1036,3.0
405,1,1,0,885547506,885547557,51,1036,579,2.727272727272727
405,1,4,3,885547557,885547558,1,579,388,2.5833333333333335
405,4,3,-1,885547558,885547605,47,388,384,2.7941176470588234
405,3,1,-2,885547605,885547606,1,384,564,2.0
405,1,1,0,885547606,885547644,38,564,1305,2.3333333333333335
405,1,3,2,885547644,885547645,1,1305,1209,2.3333333333333335
405,3,1,-2,885547645,885547690,45,1209,1178,2.375
405,1,3,2,885547690,885547691,1,1178,780,3.08
405,3,1,-2,885547691,885547735,44,780,41,3.0625
405,1,1,0,885547735,885547766,31,41,364,2.8095238095238093
405,1,1,0,885547766,885547909,143,364,183,3.951219512195122
405,1,1,0,885547909,885547910,1,183,228,3.7246376811594204
405,1,4,3,885547910,885547952,42,228,82,3.6741573033707864
405,4,1,-3,885547952,885547953,1,82,2,3.0851063829787235
405,1,3,2,885547953,885547996,43,2,431,3.422222222222222
405,3,1,-2,885547996,885547997,1,431,1250,1.6
405,1,1,0,885547997,885548048,51,1250,947,2.6666666666666665
405,1,5,4,885548048,885548093,45,947,38,2.784313725490196
405,5,1,-4,885548093,885548094,1,38,810,2.9473684210526314
405,1,1,0,885548094,885548136,42,810,1231,2.7
405,1,1,0,885548136,885548137,1,1231,391,2.4285714285714284
405,1,1,0,885548137,885548162,25,391,771,2.5714285714285716
405,1,1,0,885548162,885548163,1,771,540,2.4615384615384617
405,1,1,0,885548163,885548275,112,540,656,3.75
405,1,5,4,885548275,885548330,55,656,559,3.477272727272727
405,5,4,-1,885548330,885548331,1,559,448,3.466666666666667
405,4,1,-3,885548331,885548385,54,448,446,2.0
405,1,1,0,885548385,885548434,49,446,672,2.7222222222222223
405,1,1,0,885548434,885548435,1,672,669,2.0
405,1,2,1,885548435,885548474,39,669,565,2.4285714285714284
405,2,1,-1,885548474,885548475,1,565,551,1.6666666666666667
405,1,1,0,885548475,885548578,103,551,1073,3.6315789473684212
405,1,1,0,885548578,885548633,55,1073,466,3.5
405,1,1,0,885548633,885548670,37,466,1582,1.0
405,1,1,0,885548670,885548671,1,1582,1253,1.3333333333333333
405,1,1,0,885548671,885548686,15,1253,1207,2.125
405,1,2,1,885548686,885548836,150,1207,417,3.0588235294117645
405,2,3,1,885548836,885548837,1,417,501,3.289473684210526
405,3,1,-2,885548837,885548877,40,501,951,2.6666666666666665
405,1,4,3,885548877,885548932,55,951,404,3.6578947368421053
405,4,1,-3,885548932,885549004,72,404,1078,2.625
405,1,2,1,885549004,885549005,1,1078,843,2.933333333333333
405,2,1,-1,885549005,885549044,39,843,1032,2.7142857142857144
405,1,2,1,885549044,885549045,1,1032,78,2.3636363636363638
405,2,1,-1,885549045,885549094,49,78,374,2.111111111111111
405,1,1,0,885549094,885549095,1,374,1544,2.0
405,1,1,0,885549095,885549111,16,1544,1066,3.2
405,1,1,0,885549111,885549192,81,1066,1240,3.5454545454545454
405,1,1,0,885549192,885549308,116,1240,955,3.2666666666666666
405,1,2,1,885549308,885549309,1,955,739,3.391304347826087
405,2,1,-1,885549309,885549407,98,739,1575,1.0
405,1,1,0,885549407,885549408,1,1575,1104,2.5
405,1,1,0,885549408,885549463,55,1104,1565,1.0
405,1,2,1,885549463,885549464,1,1565,923,4.142857142857143
405,2,1,-1,885549464,885549465,1,923,1019,3.7777777777777777
405,1,1,0,885549465,885549505,40,1019,1569,1.0
405,1,2,1,885549505,885549506,1,1569,198,4.04
405,2,1,-1,885549506,885549507,1,198,59,4.0
405,1,1,0,885549507,885549544,37,59,171,4.090909090909091
405,1,1,0,885549544,885549589,45,171,1018,3.0714285714285716
405,1,1,0,885549589,885549634,45,1018,921,3.611111111111111
405,1,1,0,885549634,885549635,1,921,1529,3.0
405,1,1,0,885549635,885549650,15,1529,557,3.090909090909091
405,1,1,0,885549650,885549745,95,557,1405,3.3333333333333335
405,1,1,0,885549745,885549746,1,1405,149,2.4
405,1,1,0,885549746,885549789,43,149,1588,1.0
405,1,1,0,885549789,885549903,114,1588,350,3.2
405,1,1,0,885549903,885549904,1,350,303,3.75
405,1,1,0,885549904,885549942,38,303,351,2.4444444444444446
405,1,1,0,885549942,885549943,1,351,1591,2.5
400,4,4,0,885676411,885676452,41,301,749,3.2777777777777777
400,4,4,0,885676452,885676490,38,749,304,3.5306122448979593
400,4,4,0,885676490,885676552,62,304,343,3.0
400,4,4,0,885676552,885676582,30,343,323,3.0
406,5,4,-1,879445378,879445430,52,513,64,4.373737373737374
406,4,5,1,879445430,879445474,44,64,589,4.384615384615385
406,5,3,-2,879445474,879445475,1,589,531,3.7435897435897436
406,3,3,0,879445475,879445522,47,531,153,3.7865168539325844
406,3,1,-2,879445522,879445562,40,153,514,4.033333333333333
406,1,3,2,879445562,879445599,37,514,170,4.242424242424242
406,3,4,1,879445599,879445642,43,170,488,4.277777777777778
406,4,5,1,879445642,879445684,42,488,135,3.7974683544303796
406,5,4,-1,879445684,879445771,87,135,193,3.883720930232558
406,4,3,-1,879445771,879445809,38,193,87,3.9
406,3,5,2,879445809,879445810,1,87,199,4.191489361702128
406,5,4,-1,879445810,879445859,49,199,504,4.085714285714285
406,4,2,-2,879445859,879445897,38,504,187,4.215189873417722
406,2,4,2,879445897,879445935,38,187,705,3.7857142857142856
406,4,3,-1,879445935,879446061,126,705,275,4.087912087912088
406,3,3,0,879446061,879446062,1,275,523,4.159090909090909
406,3,4,1,879446062,879446107,45,523,1,3.902439024390244
406,4,1,-3,879446107,879446228,121,1,610,3.1818181818181817
406,1,5,4,879446228,879446268,40,610,661,4.133333333333334
406,5,5,0,879446268,879446269,1,661,701,4.5
406,5,1,-4,879446269,879446361,92,701,468,3.380952380952381
406,1,4,3,879446361,879446529,168,468,23,3.9047619047619047
406,4,5,1,879446529,879446639,110,23,32,3.7222222222222223
406,5,4,-1,879446639,879446684,45,32,638,3.923076923076923
406,4,4,0,879446684,879446718,34,638,58,3.543859649122807
406,4,4,0,879446718,879446748,30,58,69,3.8015873015873014
406,4,4,0,879446748,879539883,93135,69,508,3.6923076923076925
406,4,4,0,879539883,879539909,26,508,1008,3.5
406,4,4,0,879539909,879539929,20,1008,1010,3.611111111111111
406,4,2,-2,879539929,879539987,58,1010,13,3.5454545454545454
406,2,4,2,879539987,879540026,39,13,410,3.0434782608695654
406,4,4,0,879540026,879540078,52,410,240,3.0350877192982457
406,4,1,-3,879540078,879540106,28,240,25,3.3185840707964602
406,1,4,3,879540106,879540147,41,25,476,3.1216216216216215
406,4,4,0,879540147,879540173,26,476,123,3.297872340425532
406,4,4,0,879540173,879540199,26,123,411,2.911764705882353
406,4,3,-1,879540199,879540296,97,411,405,3.25
406,3,4,1,879540296,879540330,34,405,235,3.106382978723404
406,4,3,-1,879540330,879540358,28,235,1047,2.6923076923076925
406,3,3,0,879540358,879540388,30,1047,220,3.433333333333333
406,3,3,0,879540388,879540515,127,220,509,3.7058823529411766
406,3,3,0,879540515,879792863,252348,509,218,3.5555555555555554
406,3,3,0,879792863,879792928,65,218,665,2.72972972972973
406,3,3,0,879792928,879792974,46,665,561,3.1515151515151514
406,3,1,-2,879792974,879792975,1,561,563,2.0
406,1,1,0,879792975,879793011,36,563,769,2.2222222222222223
406,1,4,3,879793011,879793081,70,769,588,3.8358208955223883
406,4,3,-1,879793081,879793112,31,588,101,3.4827586206896552
406,3,2,-1,879793112,879793179,67,101,198,4.04
406,2,3,1,879793179,879793261,82,198,381,3.2758620689655173
406,3,4,1,879793261,879793295,34,381,639,4.083333333333333
406,4,3,-1,879793295,879793328,33,639,640,2.75
406,3,3,0,879793328,880131582,338254,640,163,3.53125
406,3,2,-1,880131582,880131608,26,163,88,3.433734939759036
406,2,1,-1,880131608,880131642,34,88,502,3.272727272727273
406,1,4,3,880131642,880131666,24,502,732,3.6266666666666665
406,4,5,1,880131666,880131703,37,732,210,3.921259842519685
406,5,3,-2,880131703,880131704,1,210,655,3.7857142857142856
406,3,4,1,880131704,880131741,37,655,47,3.5869565217391304
406,4,3,-1,880131741,880131791,50,47,433,3.8035714285714284
406,3,2,-1,880131791,880131792,1,433,4,3.5538461538461537
406,2,4,2,880131792,880131821,29,4,715,3.257142857142857
406,4,4,0,880131821,880131851,30,715,1170,3.1666666666666665
406,4,3,-1,880131851,880131875,24,1170,40,2.7037037037037037
406,3,4,1,880131875,880131929,54,40,367,3.4242424242424243
406,4,2,-2,880131929,880131954,25,367,451,3.207792207792208
406,2,3,1,880131954,880131977,23,451,629,3.3333333333333335
406,3,3,0,880131977,880132047,70,629,787,2.75
406,3,2,-1,880132047,880132048,1,787,1079,2.1923076923076925
406,2,3,1,880132048,880132091,43,1079,712,3.0434782608695654
406,3,2,-1,880132091,880132115,24,712,368,1.8823529411764706
406,2,3,1,880132115,880132276,161,368,558,3.75
406,3,3,0,880132276,880132319,43,558,573,2.909090909090909
406,3,3,0,880132319,882480481,2348162,573,79,3.956989247311828
406,3,2,-1,882480481,882480567,86,79,1065,3.1578947368421053
406,2,3,1,882480567,882480595,28,1065,651,3.8627450980392157
406,3,4,1,882480595,882480710,115,651,197,4.112676056338028
406,4,5,1,882480710,882480748,38,197,164,3.6140350877192984
406,5,5,0,882480748,882480749,1,164,605,3.3333333333333335
406,5,4,-1,882480749,882480772,23,605,188,3.625
406,4,3,-1,882480772,882480802,30,188,1220,2.9166666666666665
406,3,4,1,882480802,882480836,34,1220,92,3.7142857142857144
406,4,4,0,882480836,882480891,55,92,203,3.826923076923077
406,4,4,0,882480891,884630523,2149632,203,39,3.107142857142857
406,4,4,0,884630523,884630583,60,39,608,4.285714285714286
406,4,4,0,884630583,884630617,34,608,699,3.736842105263158
406,4,3,-1,884630617,884630973,356,699,724,3.64
406,3,3,0,884630973,884630974,1,724,228,3.7246376811594204
406,3,3,0,884630974,884631033,59,228,642,3.4285714285714284
407,5,5,0,875042378,875042424,46,238,168,4.0476190476190474
407,5,5,0,875042424,875042425,1,168,496,4.094594594594595
407,5,4,-1,875042425,875042466,41,496,214,3.272727272727273
407,4,3,-1,875042466,875042569,103,214,96,3.9130434782608696
407,3,4,1,875042569,875042642,73,96,483,4.475609756097561
407,4,4,0,875042642,875042826,184,483,28,3.923076923076923
407,4,4,0,875042826,875042865,39,28,175,3.8354430379746836
407,4,4,0,875042865,875043826,961,175,152,3.6785714285714284
407,4,4,0,875043826,875043948,122,152,89,3.9615384615384617
407,4,4,0,875043948,875044037,89,89,655,3.7857142857142856
407,4,4,0,875044037,875044400,363,655,211,3.958904109589041
407,4,4,0,875044400,875044473,73,211,184,3.393939393939394
407,4,5,1,875044473,875044510,37,184,98,4.240875912408759
407,5,4,-1,875044510,875044531,21,98,235,3.106382978723404
407,4,2,-2,875044531,875045190,659,235,227,3.169811320754717
407,2,4,2,875045190,875045240,50,227,479,4.25
407,4,3,-1,875045240,875045268,28,479,684,3.847826086956522
407,3,4,1,875045268,875045269,1,684,68,3.5714285714285716
407,4,4,0,875045269,875045371,102,68,205,3.717391304347826
407,4,3,-1,875045371,875045658,287,205,215,3.662921348314607
407,3,3,0,875045658,875045685,27,215,949,3.392857142857143
407,3,3,0,875045685,875045814,129,949,436,3.5
407,3,4,1,875045814,875046427,613,436,176,3.967032967032967
407,4,4,0,875046427,875046460,33,176,710,3.41025641025641
407,4,4,0,875046460,875116167,69707,710,97,3.7282608695652173
407,4,4,0,875116167,875117053,886,97,433,3.8035714285714284
407,4,3,-1,875117053,875548522,431469,433,869,3.0
407,3,3,0,875548522,875550223,1701,869,117,3.689189189189189
407,3,4,1,875550223,875550328,105,117,491,3.55
407,4,3,-1,875550328,875552400,2072,491,131,3.731707317073171
407,3,4,1,875552400,875552401,1,131,216,3.8454545454545452
407,4,4,0,875552401,875552445,44,216,408,4.4772727272727275
407,4,3,-1,875552445,875552496,51,408,493,3.909090909090909
407,3,3,0,875552496,875552647,151,493,648,3.9545454545454546
407,3,4,1,875552647,875552685,38,648,432,3.719298245614035
407,4,3,-1,875552685,875553018,333,432,616,3.1052631578947367
407,3,3,0,875553018,875553154,136,616,428,3.744186046511628
407,3,3,0,875553154,875553509,355,428,755,3.085714285714286
407,3,4,1,875553509,875553625,116,755,657,4.341463414634147
407,4,4,0,875553625,875553731,106,657,197,4.112676056338028
407,4,3,-1,875553731,876338186,784455,197,101,3.4827586206896552
407,3,4,1,876338186,876338278,92,101,1,3.902439024390244
407,4,2,-2,876338278,876338279,1,1,161,3.5844155844155843
407,2,3,1,876338279,876338309,30,161,118,3.2764227642276422
407,3,3,0,876338309,876338691,382,118,229,3.185185185185185
407,3,1,-2,876338691,876338799,108,229,40,2.7037037037037037
407,1,2,1,876338799,876338883,84,40,502,3.272727272727273
407,2,4,2,876338883,876338910,27,502,418,3.825
407,4,4,0,876338910,876338946,36,418,218,3.5555555555555554
407,4,4,0,876338946,876338966,20,218,427,4.2025316455696204
407,4,3,-1,876338966,876338986,20,427,660,3.71875
407,3,3,0,876338986,876339101,115,660,466,3.5
407,3,3,0,876339101,876339975,874,466,629,3.3333333333333335
407,3,4,1,876339975,876340001,26,629,423,3.7016129032258065
407,4,2,-2,876340001,876340043,42,423,712,3.0434782608695654
407,2,3,1,876340043,876340120,77,712,972,3.375
407,3,4,1,876340120,876340144,24,972,4,3.5538461538461537
407,4,4,0,876340144,876340239,95,4,715,3.257142857142857
407,4,4,0,876340239,876340318,79,715,196,3.9404761904761907
407,4,4,0,876340318,876341443,1125,196,732,3.6266666666666665
407,4,3,-1,876341443,876341444,1,732,785,3.4375
407,3,4,1,876341444,876341467,23,785,203,3.826923076923077
407,4,3,-1,876341467,876341493,26,203,443,3.8421052631578947
407,3,3,0,876341493,876342706,1213,443,382,3.764705882352941
407,3,2,-1,876342706,876342927,221,382,158,2.7027027027027026
407,2,4,2,876342927,876343028,101,158,121,3.521212121212121
407,4,2,-2,876343028,876344329,1301,121,402,3.3076923076923075
407,2,3,1,876344329,876344410,81,402,29,2.5714285714285716
407,3,3,0,876344410,876344712,302,29,708,3.3157894736842106
407,3,2,-1,876344712,876344736,24,708,393,3.5125
407,2,4,2,876344736,876344772,36,393,72,3.175438596491228
407,4,2,-2,876344772,876348232,3460,72,756,2.6885245901639343
407,2,3,1,876348232,876348296,64,756,569,2.4285714285714284
407,3,3,0,876348296,876348318,22,569,405,3.25
407,3,3,0,876348318,876348639,321,405,1044,3.2777777777777777
407,3,4,1,876348639,876348660,21,1044,729,3.3793103448275863
407,4,4,0,876348660,876348681,21,729,291,3.2
407,4,3,-1,876348681,876348702,21,291,565,2.4285714285714284
407,3,2,-1,876348702,876348799,97,565,1090,2.3529411764705883
407,2,3,1,876348799,876348832,33,1090,1028,2.857142857142857
407,3,2,-1,876348832,876348849,17,1028,388,2.5833333333333335
407,2,1,-1,876348849,876348957,108,388,395,2.5714285714285716
407,1,4,3,876348957,884197006,7848049,395,248,3.746268656716418
407,4,4,0,884197006,884197027,21,248,222,3.578125
407,4,4,0,884197027,884197052,25,222,255,3.2027027027027026
407,4,4,0,884197052,884201736,4684,255,969,3.8947368421052633
407,4,3,-1,884201736,884201774,38,969,455,3.1702127659574466
407,3,3,0,884201774,884614753,412979,455,244,2.9411764705882355
407,3,4,1,884614753,887833034,3218281,244,177,3.875
407,4,4,0,887833034,890687564,2854530,177,250,3.4698795180722892
409,4,3,-1,881104727,881104756,29,303,538,3.25
409,3,2,-1,881104756,881104837,81,538,321,3.0172413793103448
409,2,3,1,881104837,881104916,79,321,338,2.75
409,3,2,-1,881104916,881104966,50,338,937,3.5
409,2,4,2,881104966,881105077,111,937,325,2.625
409,4,3,-1,881105077,881105367,290,325,749,3.2777777777777777
409,3,3,0,881105367,881106451,1084,749,1379,3.0
409,3,4,1,881106451,881106605,154,1379,127,4.162790697674419
409,4,2,-2,881106605,881106682,77,127,504,4.085714285714285
409,2,5,3,881106682,881106734,52,504,134,4.174603174603175
409,5,4,-1,881106734,881107011,277,134,618,3.5
409,4,4,0,881107011,881107056,45,618,12,4.358974358974359
409,4,5,1,881107056,881107084,28,12,615,3.8333333333333335
409,5,4,-1,881107084,881107117,33,615,199,4.191489361702128
409,4,4,0,881107117,881107251,134,199,663,3.948717948717949
409,4,4,0,881107251,881107281,30,663,528,4.241379310344827
409,4,5,1,881107281,881107351,70,528,603,4.315789473684211
409,5,5,0,881107351,881107410,59,603,168,4.0476190476190474
409,5,4,-1,881107410,881107539,129,168,223,4.108695652173913
409,4,3,-1,881107539,881107602,63,223,481,3.8421052631578947
409,3,4,1,881107602,881107666,64,481,192,4.090909090909091
409,4,3,-1,881107666,881107697,31,192,654,4.119047619047619
409,3,5,2,881107697,881107750,53,654,1194,4.181818181818182
409,5,5,0,881107750,881107817,67,1194,178,4.378378378378378
409,5,5,0,881107817,881107860,43,178,135,3.7974683544303796
409,5,5,0,881107860,881107943,83,135,511,4.096153846153846
409,5,3,-2,881107943,881107992,49,511,205,3.717391304347826
409,3,3,0,881107992,881108077,85,205,631,3.581818181818182
409,3,4,1,881108077,881108170,93,631,58,3.543859649122807
409,4,4,0,881108170,881108246,76,58,79,3.956989247311828
409,4,4,0,881108246,881108364,118,79,493,3.909090909090909
409,4,2,-2,881108364,881108455,91,493,48,4.055555555555555
409,2,5,3,881108455,881108496,41,48,204,3.6744186046511627
409,5,5,0,881108496,881108648,152,204,154,3.6031746031746033
409,5,3,-2,881108648,881108715,67,154,207,3.4761904761904763
409,3,2,-1,881108715,881108777,62,207,676,3.3142857142857145
409,2,4,2,881108777,881108881,104,676,30,3.8181818181818183
409,4,3,-1,881108881,881108971,90,30,945,3.4
409,3,5,2,881108971,881109019,48,945,529,4.142857142857143
409,5,4,-1,881109019,881109175,156,529,210,3.921259842519685
409,4,3,-1,881109175,881109215,40,210,197,4.112676056338028
409,3,4,1,881109215,881109216,1,197,214,3.272727272727273
409,4,4,0,881109216,881109264,48,214,162,3.4651162790697674
409,4,4,0,881109264,881109306,42,162,195,3.9072164948453607
409,4,4,0,881109306,881168604,59298,195,430,4.136363636363637
409,4,3,-1,881168604,881168631,27,430,497,3.35
409,3,4,1,881168631,881168712,81,497,482,3.9444444444444446
404,4,3,-1,883790218,883790249,31,302,331,3.5517241379310347
404,3,2,-1,883790249,883790286,37,331,333,3.546666666666667
404,2,3,1,883790286,883790314,28,333,288,3.5214285714285714
404,3,4,1,883790314,883790366,52,288,683,2.176470588235294
404,4,4,0,883790366,883790400,34,683,678,2.8181818181818183
404,4,3,-1,883790400,883790401,1,678,245,3.056179775280899
404,3,4,1,883790401,883790430,29,245,294,3.1052631578947367
404,4,1,-3,883790430,883790492,62,294,289,2.988888888888889
404,1,2,1,883790492,883790550,58,289,892,2.9615384615384617
404,2,2,0,883790550,883790585,35,892,901,2.0
404,2,1,-1,883790585,883790656,71,901,343,3.0
404,1,4,3,883790656,883790749,93,343,328,3.4895833333333335
404,4,4,0,883790749,883790851,102,328,739,3.391304347826087
404,4,4,0,883790851,883790883,32,739,66,3.4705882352941178
413,2,3,1,879968794,879968890,96,302,332,3.6511627906976742
413,3,3,0,879968890,879968933,43,332,328,3.4895833333333335
413,3,4,1,879968933,879969027,94,328,289,2.988888888888889
413,4,3,-1,879969027,879969100,73,289,877,2.619047619047619
413,3,1,-2,879969100,879969148,48,877,260,2.4716981132075473
413,1,3,2,879969148,879969259,111,260,321,3.0172413793103448
413,3,5,2,879969259,879969513,254,321,14,4.101694915254237
413,5,4,-1,879969513,879969535,22,14,100,4.0162162162162165
413,4,3,-1,879969535,879969536,1,100,460,3.0
413,3,5,2,879969536,879969557,21,460,275,4.087912087912088
413,5,3,-2,879969557,879969614,57,275,7,3.76056338028169
413,3,4,1,879969614,879969642,28,7,471,3.5714285714285716
413,4,4,0,879969642,879969709,67,471,284,3.1547619047619047
413,4,5,1,879969709,879969734,25,284,124,4.052631578947368
413,5,4,-1,879969734,879969755,21,124,237,3.7315436241610738
413,4,4,0,879969755,879969791,36,237,628,3.573529411764706
413,4,2,-2,879969791,879969860,69,628,147,3.3142857142857145
416,4,2,-2,876696687,876696788,101,748,245,3.056179775280899
416,2,4,2,876696788,876696823,35,245,300,3.6861313868613137
416,4,1,-3,876696823,876696853,30,300,874,3.230769230769231
416,1,2,1,876696853,876696938,85,874,875,2.736842105263158
416,2,4,2,876696938,876697074,136,875,250,3.4698795180722892
416,4,3,-1,876697074,876697105,31,250,151,3.6544117647058822
416,3,3,0,876697105,876697165,60,151,985,2.9
416,3,3,0,876697165,876697205,40,985,257,3.7154471544715446
416,3,3,0,876697205,876697283,78,257,253,3.5
416,3,3,0,876697283,876697330,47,253,237,3.7315436241610738
416,3,4,1,876697330,876697361,31,237,845,3.661290322580645
416,4,2,-2,876697361,876697387,26,845,473,2.9166666666666665
416,2,3,1,876697387,876697415,28,473,21,2.9210526315789473
416,3,4,1,876697415,876697448,33,21,713,3.5
416,4,2,-2,876697448,876697479,31,713,118,3.2764227642276422
416,2,3,1,876697479,876697524,45,118,696,3.138888888888889
416,3,3,0,876697524,876697558,34,696,249,3.3275862068965516
416,3,4,1,876697558,876697592,34,249,111,3.5106382978723403
416,4,2,-2,876697592,876697695,103,111,1089,2.1363636363636362
416,2,4,2,876697695,876697760,65,1089,1160,4.1
416,4,3,-1,876697760,876697807,47,1160,546,2.9789473684210526
416,3,4,1,876697807,876697847,40,546,535,3.380952380952381
416,4,3,-1,876697847,876697913,66,535,106,2.8125
416,3,3,0,876697913,876697955,42,106,685,3.2666666666666666
416,3,3,0,876697955,876698006,51,685,411,2.911764705882353
416,3,3,0,876698006,876698083,77,411,1054,2.5454545454545454
416,3,4,1,876698083,876698115,32,1054,252,2.911392405063291
416,4,3,-1,876698115,876698178,63,252,597,3.2771084337349397
416,3,4,1,876698178,876698204,26,597,472,2.984375
416,4,3,-1,876698204,876698255,51,472,1048,2.857142857142857
416,3,3,0,876698255,876698280,25,1048,278,3.0357142857142856
416,3,3,0,876698280,876698364,84,278,10,3.85
416,3,2,-1,876698364,876698430,66,10,105,2.6176470588235294
416,2,4,2,876698430,876698934,504,105,182,3.842857142857143
416,4,4,0,876698934,876699027,93,182,69,3.8015873015873014
416,4,4,0,876699027,876699102,75,69,90,3.0
416,4,4,0,876699102,876699179,77,90,707,3.909090909090909
416,4,4,0,876699179,876699238,59,707,11,3.8904109589041096
416,4,4,0,876699238,876699287,49,11,498,4.290909090909091
416,4,4,0,876699287,876699334,47,498,202,3.730337078651685
416,4,3,-1,876699334,876699488,154,202,218,3.5555555555555554
416,3,4,1,876699488,876699526,38,218,652,3.9642857142857144
416,4,3,-1,876699526,876699578,52,652,42,3.893617021276596
416,3,4,1,876699578,876699757,179,42,633,3.9
416,4,4,0,876699757,876699793,36,633,418,3.825
416,4,4,0,876699793,876699839,46,418,154,3.6031746031746033
416,4,2,-2,876699839,876699903,64,154,133,3.7777777777777777
416,2,4,2,876699903,876699946,43,133,219,2.735294117647059
416,4,4,0,876699946,876699994,48,219,662,3.4583333333333335
416,4,4,0,876699994,876700137,143,662,99,3.8392857142857144
416,4,3,-1,876700137,878878814,2178677,99,930,2.793103448275862
416,3,4,1,878878814,878879168,354,930,220,3.433333333333333
416,4,4,0,878879168,878879237,69,220,620,3.0
416,4,1,-3,878879237,878879350,113,620,1336,1.75
416,1,2,1,878879350,878879391,41,1336,254,2.7419354838709675
416,2,4,2,878879391,878879619,228,254,134,4.174603174603175
416,4,3,-1,878879619,878879688,69,134,95,3.8194444444444446
416,3,2,-1,878879688,878879809,121,95,36,2.4
416,2,4,2,878879809,878879861,52,36,568,3.5853658536585367
416,4,4,0,878879861,878880154,293,568,470,3.72
416,4,3,-1,878880154,878880195,41,470,1469,3.4
416,3,3,0,878880195,878880244,49,1469,231,2.938775510204082
416,3,3,0,878880244,885114480,6234236,231,312,3.0
416,3,2,-1,885114480,885114559,79,312,259,2.492063492063492
416,2,4,2,885114559,885114578,19,259,689,3.1538461538461537
416,4,3,-1,885114578,886314660,1200082,689,348,3.2
416,3,3,0,886314660,886314877,217,348,311,3.761904761904762
416,3,4,1,886314877,886314987,110,311,980,3.142857142857143
416,4,1,-3,886314987,886315446,459,980,240,3.0350877192982457
416,1,4,3,886315446,886315536,90,240,840,3.090909090909091
416,4,3,-1,886315536,886315885,349,840,122,2.282608695652174
416,3,3,0,886315885,886316140,255,122,88,3.433734939759036
416,3,4,1,886316140,886316164,24,88,431,3.422222222222222
416,4,3,-1,886316164,886316190,26,431,404,3.6578947368421053
416,3,4,1,886316190,886316226,36,404,433,3.8035714285714284
416,4,3,-1,886316226,886316271,45,433,1098,3.533333333333333
416,3,3,0,886316271,886316295,24,1098,631,3.581818181818182
416,3,4,1,886316295,886316381,86,631,1264,3.5
416,4,4,0,886316381,886316409,28,1264,724,3.64
416,4,1,-3,886316409,886316439,30,724,86,3.869565217391304
416,1,3,2,886316439,886316477,38,86,865,2.6666666666666665
416,3,4,1,886316477,886316647,170,865,425,3.7027027027027026
416,4,4,0,886316647,886316703,56,425,463,3.6818181818181817
416,4,4,0,886316703,886316739,36,463,161,3.5844155844155843
416,4,4,0,886316739,886316797,58,161,230,3.3518518518518516
416,4,3,-1,886316797,886316835,38,230,778,3.5925925925925926
416,3,4,1,886316835,886316922,87,778,549,3.4871794871794872
416,4,4,0,886316922,886317030,108,549,226,3.378787878787879
416,4,4,0,886317030,886317079,49,226,553,3.5
416,4,4,0,886317079,886317115,36,553,2,3.0851063829787235
416,4,4,0,886317115,886317146,31,2,821,3.076923076923077
416,4,3,-1,886317146,886317237,91,821,624,3.0
416,3,4,1,886317237,886317272,35,624,153,3.7865168539325844
416,4,4,0,886317272,886317316,44,153,157,3.5714285714285716
416,4,4,0,886317316,886317350,34,157,842,3.0
416,4,1,-3,886317350,886317412,62,842,159,3.3902439024390243
416,1,3,2,886317412,886317540,128,159,721,3.4583333333333335
416,3,3,0,886317540,886317568,28,721,417,3.0588235294117645
416,3,4,1,886317568,886317599,31,417,550,3.272727272727273
416,4,3,-1,886317599,886317748,149,550,843,2.933333333333333
416,3,2,-1,886317748,886317825,77,843,80,2.967741935483871
416,2,4,2,886317825,886317880,55,80,217,3.1538461538461537
416,4,1,-3,886317880,886318085,205,217,585,2.5384615384615383
416,1,3,2,886318085,886318155,70,585,420,3.5652173913043477
416,3,2,-1,886318155,886318228,73,420,29,2.5714285714285716
416,2,4,2,886318228,886318270,42,29,27,3.235294117647059
416,4,3,-1,886318270,886318394,124,27,554,2.9555555555555557
416,3,4,1,886318394,886318546,152,554,578,3.066666666666667
416,4,2,-2,886318546,886318587,41,578,396,2.84
416,2,3,1,886318587,886318613,26,396,737,3.12
416,3,2,-1,886318613,886318651,38,737,401,2.6774193548387095
416,2,3,1,886318651,886318676,25,401,849,2.5625
416,3,4,1,886318676,886318708,32,849,761,3.0588235294117645
416,4,4,0,886318708,886318740,32,761,67,3.106382978723404
416,4,3,-1,886318740,886318768,28,67,783,2.388888888888889
416,3,4,1,886318768,886318795,27,783,712,3.0434782608695654
416,4,3,-1,886318795,886318860,65,712,571,2.5
416,3,3,0,886318860,886318953,93,571,1188,2.45
416,3,4,1,886318953,886319038,85,1188,416,3.3846153846153846
416,4,3,-1,886319038,886319079,41,416,560,3.111111111111111
416,3,3,0,886319079,886319106,27,560,452,2.6129032258064515
416,3,3,0,886319106,886319177,71,452,803,2.75
416,3,3,0,886319177,886319204,27,803,1428,3.2857142857142856
416,3,2,-1,886319204,886319234,30,1428,1135,3.0526315789473686
416,2,3,1,886319234,886319235,1,1135,158,2.7027027027027026
416,3,3,0,886319235,886319288,53,158,387,3.5357142857142856
416,3,4,1,886319288,886319340,52,387,142,3.1481481481481484
416,4,4,0,886319340,886319366,26,142,1217,3.4166666666666665
416,4,4,0,886319366,886319434,68,1217,1053,3.3846153846153846
416,4,4,0,886319434,886319522,88,1053,765,3.0
416,4,2,-2,886319522,886319550,28,765,791,3.0
416,2,2,0,886319550,886319620,70,791,395,2.5714285714285716
416,2,4,2,886319620,886319649,29,395,807,4.0
416,4,2,-2,886319649,886319785,136,807,78,2.3636363636363638
416,2,2,0,886319785,886319825,40,78,738,3.0
416,2,2,0,886319825,886319855,30,738,364,2.8095238095238093
416,2,2,0,886319855,886319906,51,364,1478,2.7
416,2,1,-1,886319906,886319930,24,1478,375,2.076923076923077
416,1,3,2,886319930,886320054,124,375,1092,2.5714285714285716
416,3,2,-1,886320054,886320112,58,1092,1407,2.375
416,2,2,0,886320112,886320177,65,1407,388,2.5833333333333335
416,2,2,0,886320177,888700566,2380389,388,544,3.185185185185185
416,2,3,1,888700566,888700659,93,544,532,2.7777777777777777
416,3,3,0,888700659,888700719,60,532,833,2.9444444444444446
416,3,3,0,888700719,888700844,125,833,819,2.6666666666666665
416,3,2,-1,888700844,888701033,189,819,369,2.5714285714285716
416,2,2,0,888701033,888702297,1264,369,32,3.7222222222222223
416,2,2,0,888702297,892440060,3737763,32,795,2.4
416,2,2,0,892440060,892440119,59,795,412,2.272727272727273
416,2,2,0,892440119,892440156,37,412,1037,2.0
416,2,3,1,892440156,892440206,50,1037,1521,3.0
416,3,4,1,892440206,892441448,1242,1521,419,3.8208955223880596
416,4,4,0,892441448,892441480,32,419,477,3.1666666666666665
416,4,4,0,892441480,893142244,700764,477,1133,3.076923076923077
416,4,4,0,893142244,893142245,1,1133,96,3.9130434782608696
416,4,4,0,893142245,893142283,38,96,781,3.4166666666666665
416,4,4,0,893142283,893142480,197,781,77,3.3857142857142857
416,4,3,-1,893142480,893210246,67766,77,85,3.3157894736842106
416,3,5,2,893210246,893212572,2326,85,277,3.6
416,5,5,0,893212572,893212573,1,277,500,4.285714285714286
416,5,5,0,893212573,893212895,322,500,155,3.0588235294117645
416,5,5,0,893212895,893212896,1,155,739,3.391304347826087
416,5,5,0,893212896,893213019,123,739,794,3.6
416,5,5,0,893213019,893213103,84,794,248,3.746268656716418
416,5,5,0,893213103,893213443,340,248,213,3.943396226415094
416,5,5,0,893213443,893213444,1,213,392,3.5555555555555554
416,5,5,0,893213444,893213549,105,392,258,3.7547169811320753
416,5,5,0,893213549,893213645,96,258,121,3.521212121212121
416,5,5,0,893213645,893213796,151,121,241,3.5625
416,5,5,0,893213796,893213917,121,241,174,4.253521126760563
416,5,5,0,893213917,893213918,1,174,501,3.289473684210526
416,5,5,0,893213918,893214041,123,501,515,4.202898550724638
416,5,5,0,893214041,893214127,86,515,183,3.951219512195122
416,5,5,0,893214127,893214128,1,183,196,3.9404761904761907
416,5,5,0,893214128,893214225,97,196,520,4.136363636363637
416,5,5,0,893214225,893214226,1,520,526,3.909090909090909
416,5,4,-1,893214226,893214332,106,526,918,3.3333333333333335
408,5,4,-1,889679715,889679761,46,315,310,3.6666666666666665
408,4,4,0,889679761,889679791,30,310,288,3.5214285714285714
408,4,3,-1,889679791,889679857,66,288,300,3.6861313868613137
408,3,4,1,889679857,889679947,90,300,242,3.5217391304347827
408,4,3,-1,889679947,889679982,35,242,683,2.176470588235294
408,3,4,1,889679982,889680045,63,683,358,2.6551724137931036
410,2,3,1,888626506,888626538,32,340,300,3.6861313868613137
410,3,3,0,888626538,888626583,45,300,303,3.75
410,3,3,0,888626583,888626612,29,303,882,3.6666666666666665
410,3,3,0,888626612,888626682,70,882,352,1.8333333333333333
410,3,3,0,888626682,888626710,28,352,754,3.5789473684210527
410,3,3,0,888626710,888626786,76,754,328,3.4895833333333335
410,3,1,-2,888626786,888626819,33,328,289,2.988888888888889
410,1,2,1,888626819,888626881,62,289,689,3.1538461538461537
410,2,3,1,888626881,888626913,32,689,311,3.761904761904762
410,3,3,0,888626913,888626990,77,311,323,3.0
410,3,2,-1,888626990,888627018,28,323,886,2.857142857142857
410,2,5,3,888627018,888627137,119,886,269,4.085106382978723
410,5,4,-1,888627137,888627138,1,269,690,3.260869565217391
411,4,3,-1,891035152,891035239,87,405,195,3.9072164948453607
411,3,4,1,891035239,891035278,39,195,56,4.051724137931035
411,4,3,-1,891035278,891035309,31,56,228,3.7246376811594204
411,3,4,1,891035309,891035405,96,228,38,2.784313725490196
411,4,3,-1,891035405,891035478,73,38,435,3.8933333333333335
411,3,3,0,891035478,891035525,47,435,238,3.888888888888889
411,3,4,1,891035525,891035550,25,238,209,3.8275862068965516
411,4,4,0,891035550,891035617,67,209,208,3.8125
411,4,4,0,891035617,891035639,22,208,655,3.7857142857142856
411,4,4,0,891035639,891035663,24,655,202,3.730337078651685
411,4,3,-1,891035663,891035761,98,202,720,3.2
411,3,4,1,891035761,891035827,66,720,9,3.8878504672897196
411,4,5,1,891035827,892845604,1809777,9,50,4.306532663316583
411,5,5,0,892845604,892845605,1,50,186,3.905263157894737
411,5,4,-1,892845605,892845634,29,186,732,3.6266666666666665
411,4,4,0,892845634,892845712,78,732,318,4.5046728971962615
411,4,3,-1,892845712,892845804,92,318,58,3.543859649122807
411,3,4,1,892845804,892845926,122,58,527,3.823529411764706
417,2,4,2,879646052,879646144,92,713,127,4.162790697674419
417,4,3,-1,879646144,879646166,22,127,100,4.0162162162162165
417,3,4,1,879646166,879646225,59,100,515,4.202898550724638
417,4,3,-1,879646225,879646244,19,515,596,3.180327868852459
417,3,3,0,879646244,879646260,16,596,7,3.76056338028169
417,3,3,0,879646260,879646286,26,7,181,3.98974358974359
417,3,4,1,879646286,879646369,83,181,1086,3.857142857142857
417,4,4,0,879646369,879646388,19,1086,1047,2.6923076923076925
417,4,4,0,879646388,879646413,25,1047,1,3.902439024390244
417,4,4,0,879646413,879646484,71,1,117,3.689189189189189
417,4,3,-1,879646484,879646530,46,117,252,2.911392405063291
417,3,3,0,879646530,879646531,1,252,405,3.25
417,3,4,1,879646531,879646548,17,405,118,3.2764227642276422
417,4,1,-3,879646548,879646570,22,118,685,3.2666666666666666
417,1,3,2,879646570,879646591,21,685,121,3.521212121212121
417,3,3,0,879646591,879646661,70,121,544,3.185185185185185
417,3,3,0,879646661,879646677,16,544,764,3.1176470588235294
417,3,3,0,879646677,879646692,15,764,16,3.411764705882353
417,3,3,0,879646692,879646712,20,16,546,2.9789473684210526
417,3,1,-2,879646712,879646741,29,546,1288,2.5
417,1,4,3,879646741,879646785,44,1288,748,3.1043478260869564
417,4,3,-1,879646785,879646800,15,748,993,3.4838709677419355
417,3,3,0,879646800,879646820,20,993,323,3.0
417,3,2,-1,879646820,879646838,18,323,122,2.282608695652174
417,2,5,3,879646838,879646891,53,122,176,3.967032967032967
417,5,5,0,879646891,879646965,74,176,95,3.8194444444444446
417,5,4,-1,879646965,879646986,21,95,419,3.8208955223880596
417,4,4,0,879646986,879647011,25,419,65,3.511111111111111
417,4,5,1,879647011,879647040,29,65,98,4.240875912408759
417,5,5,0,879647040,879647090,50,98,196,3.9404761904761907
417,5,3,-2,879647090,879647140,50,196,461,3.3333333333333335
417,3,4,1,879647140,879647196,56,461,134,4.174603174603175
417,4,4,0,879647196,879647254,58,134,131,3.731707317073171
417,4,4,0,879647254,879647299,45,131,209,3.8275862068965516
417,4,4,0,879647299,879647326,27,209,97,3.7282608695652173
417,4,5,1,879647326,879647355,29,97,483,4.475609756097561
417,5,4,-1,879647355,879647431,76,483,431,3.422222222222222
417,4,2,-2,879647431,879647450,19,431,855,3.590909090909091
417,2,3,1,879647450,879647498,48,855,169,4.548387096774194
417,3,4,1,879647498,879647540,42,169,498,4.290909090909091
417,4,4,0,879647540,879647561,21,498,421,3.462962962962963
417,4,5,1,879647561,879647580,19,421,153,3.7865168539325844
417,5,4,-1,879647580,879647708,128,153,200,3.8157894736842106
417,4,4,0,879647708,879647749,41,200,70,3.5833333333333335
417,4,4,0,879647749,879647768,19,70,238,3.888888888888889
417,4,2,-2,879647768,879647800,32,238,91,3.6
417,2,4,2,879647800,879647825,25,91,732,3.6266666666666665
417,4,5,1,879647825,879647900,75,732,55,4.051282051282051
417,5,3,-2,879647900,879647924,24,55,549,3.4871794871794872
417,3,5,2,879647924,879647947,23,549,642,3.4285714285714284
417,5,3,-2,879647947,879647966,19,642,428,3.744186046511628
417,3,3,0,879647966,879648004,38,428,47,3.5869565217391304
417,3,3,0,879648004,879648026,22,47,208,3.8125
417,3,5,2,879648026,879648048,22,208,746,3.7560975609756095
417,5,4,-1,879648048,879648078,30,746,638,3.923076923076923
417,4,4,0,879648078,879648079,1,638,792,3.793103448275862
417,4,3,-1,879648079,879648096,17,792,226,3.378787878787879
417,3,5,2,879648096,879648132,36,226,83,4.204081632653061
417,5,2,-3,879648132,879648155,23,83,568,3.5853658536585367
417,2,3,1,879648155,879648156,1,568,164,3.6140350877192984
417,3,3,0,879648156,879648184,28,164,142,3.1481481481481484
417,3,5,2,879648184,879648325,141,142,727,3.5517241379310347
417,5,3,-2,879648325,879648343,18,727,73,3.588235294117647
417,3,3,0,879648343,879648360,17,73,4,3.5538461538461537
417,3,3,0,879648360,879648382,22,4,1119,3.5185185185185186
417,3,4,1,879648382,879648403,21,1119,1000,3.3333333333333335
417,4,4,0,879648403,879648452,49,1000,420,3.5652173913043477
417,4,3,-1,879648452,879648478,26,420,1041,3.3333333333333335
417,3,3,0,879648478,879648510,32,1041,232,3.0789473684210527
417,3,3,0,879648510,879648526,16,232,51,3.5277777777777777
417,3,4,1,879648526,879648594,68,51,217,3.1538461538461537
417,4,3,-1,879648594,879648611,17,217,441,2.4
417,3,3,0,879648611,879648707,96,441,561,3.1515151515151514
417,3,4,1,879648707,879648742,35,561,778,3.5925925925925926
417,4,3,-1,879648742,879648761,19,778,943,3.6666666666666665
417,3,2,-1,879648761,879648778,17,943,206,3.0
417,2,4,2,879648778,879648798,20,206,231,2.938775510204082
417,4,3,-1,879648798,879648881,83,231,728,3.05
417,3,3,0,879648881,879648898,17,728,399,3.317073170731707
417,3,5,2,879648898,879648938,40,399,723,3.5384615384615383
417,5,3,-2,879648938,879648939,1,723,62,3.048780487804878
417,3,4,1,879648939,879648955,16,62,562,3.2941176470588234
417,4,3,-1,879648955,879648979,24,562,219,2.735294117647059
417,3,3,0,879648979,879649021,42,219,63,3.125
417,3,2,-1,879649021,879649044,23,63,1210,2.7142857142857144
417,2,4,2,879649044,879649064,20,1210,625,3.25
417,4,4,0,879649064,879649107,43,625,72,3.175438596491228
417,4,3,-1,879649107,879649153,46,72,804,3.0
417,3,3,0,879649153,879649178,25,804,388,2.5833333333333335
417,3,3,0,879649178,879649199,21,388,40,2.7037037037037037
417,3,4,1,879649199,879649266,67,40,451,3.207792207792208
417,4,4,0,879649266,879649284,18,451,384,2.7941176470588234
417,4,3,-1,879649284,879649322,38,384,1095,2.8
417,3,2,-1,879649322,879649337,15,1095,940,2.4
417,2,3,1,879649337,879649368,31,940,771,2.5714285714285716
417,3,2,-1,879649368,879649369,1,771,1232,2.6666666666666665
417,2,2,0,879649369,879649389,20,1232,541,2.9473684210526314
417,2,3,1,879649389,879649410,21,541,576,3.125
417,3,3,0,879649410,879649448,38,576,1139,2.611111111111111
417,3,2,-1,879649448,879649467,19,1139,800,3.2222222222222223
417,2,3,1,879649467,879649484,17,800,1036,3.0
417,3,2,-1,879649484,879649539,55,1036,1539,2.0
417,2,2,0,879649539,879649560,21,1539,674,2.6875
417,2,3,1,879649560,879649577,17,674,1090,2.3529411764705883
417,3,3,0,879649577,879649610,33,1090,578,3.066666666666667
417,3,1,-2,879649610,879649632,22,578,849,2.5625
417,1,4,3,879649632,879649669,37,849,326,3.262295081967213
417,4,2,-2,879649669,879649763,94,326,358,2.6551724137931036
417,2,3,1,879649763,879649779,16,358,260,2.4716981132075473
417,3,2,-1,879649779,880949231,1299452,260,325,2.625
417,2,3,1,880949231,880949438,207,325,1011,3.1
417,3,4,1,880949438,880949479,41,1011,1023,2.5714285714285716
417,4,3,-1,880949479,880949880,401,1023,485,3.717948717948718
417,3,4,1,880949880,880949907,27,485,211,3.958904109589041
417,4,2,-2,880949907,880949941,34,211,382,3.764705882352941
417,2,4,2,880949941,880950324,383,382,946,3.1153846153846154
417,4,2,-2,880950324,880951252,928,946,44,3.1333333333333333
417,2,4,2,880951252,880951717,465,44,1135,3.0526315789473686
417,4,3,-1,880951717,880951737,20,1135,49,3.3
417,3,3,0,880951737,880951886,149,49,162,3.4651162790697674
417,3,2,-1,880951886,880952066,180,162,552,2.8095238095238093
417,2,4,2,880952066,880952141,75,552,944,2.75
417,4,2,-2,880952141,880952400,259,944,665,2.72972972972973
417,2,3,1,880952400,880952434,34,665,999,2.75
417,3,2,-1,880952434,880952534,100,999,1416,2.5
417,2,4,2,880952534,880952616,82,1416,1157,3.142857142857143
417,4,3,-1,880952616,880952656,40,1157,797,3.1538461538461537
417,3,4,1,880952656,880952691,35,797,444,2.6842105263157894
417,4,4,0,880952691,880952837,146,444,67,3.106382978723404
417,4,4,0,880952837,880952880,43,67,780,3.08
417,4,4,0,880952880,880952970,90,780,725,3.0
417,4,3,-1,880952970,880953014,44,725,364,2.8095238095238093
417,3,1,-2,880953014,880953033,19,364,545,1.7142857142857142
417,1,2,1,880953033,880953053,20,545,743,1.9545454545454546
417,2,1,-1,880953053,880953071,18,743,769,2.2222222222222223
417,1,2,1,880953071,880953088,17,769,1230,1.8888888888888888
417,2,3,1,880953088,886186520,5233432,1230,895,3.142857142857143
417,3,2,-1,886186520,886186925,405,895,818,2.769230769230769
417,2,2,0,886186925,886187012,87,818,871,2.3823529411764706
412,4,5,1,879716637,879716918,281,340,318,4.5046728971962615
412,5,3,-2,879716918,879716961,43,318,969,3.8947368421052633
412,3,4,1,879716961,879716962,1,969,1,3.902439024390244
412,4,4,0,879716962,879716983,21,1,182,3.842857142857143
412,4,4,0,879716983,879717016,33,182,408,4.4772727272727275
412,4,4,0,879717016,879717038,22,408,169,4.548387096774194
412,4,4,0,879717038,879717095,57,169,724,3.64
412,4,3,-1,879717095,879717118,23,724,487,4.043478260869565
412,3,4,1,879717118,879717147,29,487,23,3.9047619047619047
412,4,4,0,879717147,879717177,30,23,211,3.958904109589041
412,4,3,-1,879717177,879717253,76,211,214,3.272727272727273
412,3,4,1,879717253,879717313,60,214,684,3.847826086956522
412,4,5,1,879717313,879717449,136,684,172,4.225225225225225
412,5,4,-1,879717449,879717505,56,172,64,4.373737373737374
412,4,4,0,879717505,879717548,43,64,651,3.8627450980392157
412,4,4,0,879717548,879717549,1,651,431,3.422222222222222
412,4,5,1,879717549,879717572,23,431,276,3.6036036036036037
412,5,4,-1,879717572,879717621,49,276,150,3.803921568627451
412,4,4,0,879717621,879717649,28,150,436,3.5
412,4,2,-2,879717649,879717829,180,436,81,3.2857142857142856
420,3,5,2,891356864,891356891,27,173,124,4.052631578947368
420,5,3,-2,891356891,891356927,36,124,19,3.9615384615384617
420,3,5,2,891356927,891357021,94,19,855,3.590909090909091
420,5,5,0,891357021,891357071,50,855,275,4.087912087912088
420,5,4,-1,891357071,891357162,91,275,475,3.956043956043956
422,1,3,2,875129602,875129603,1,299,327,3.5076923076923077
422,3,3,0,875129603,875129668,65,327,260,2.4716981132075473
422,3,2,-1,875129668,875129692,24,260,325,2.625
422,2,4,2,875129692,875129839,147,325,257,3.7154471544715446
422,4,4,0,875129839,875129881,42,257,475,3.956043956043956
422,4,4,0,875129881,875129882,1,475,93,3.5641025641025643
422,4,4,0,875129882,875129911,29,93,50,4.306532663316583
422,4,3,-1,875129911,875129975,64,50,1199,2.6666666666666665
422,3,3,0,875129975,875130027,52,1199,293,3.630434782608696
422,3,3,0,875130027,875130063,36,293,1,3.902439024390244
422,3,3,0,875130063,875130100,37,1,248,3.746268656716418
422,3,4,1,875130100,875130137,37,248,1187,4.333333333333333
422,4,3,-1,875130137,875130173,36,1187,717,2.9696969696969697
422,3,2,-1,875130173,875130204,31,717,109,3.282608695652174
422,2,5,3,875130204,875130230,26,109,410,3.0434782608695654
422,5,4,-1,875130230,877162682,2032452,410,334,3.4210526315789473
422,4,2,-2,877162682,879743787,2581105,334,682,3.0476190476190474
422,2,2,0,879743787,879743848,61,682,339,2.7058823529411766
422,2,2,0,879743848,879743948,100,339,590,1.8888888888888888
422,2,4,2,879743948,879744014,66,590,201,3.75
422,4,4,0,879744014,879744015,1,201,234,3.7674418604651163
422,4,3,-1,879744015,879744085,70,234,559,3.477272727272727
422,3,4,1,879744085,879744086,1,559,218,3.5555555555555554
422,4,2,-2,879744086,879744143,57,218,670,2.9375
422,2,4,2,879744143,879744183,40,670,53,2.9523809523809526
422,4,3,-1,879744183,879744219,36,53,563,2.0
422,3,2,-1,879744219,879744287,68,563,370,2.8125
425,5,2,-3,878737512,878737593,81,288,879,3.2291666666666665
425,2,3,1,878737593,878737657,64,879,324,3.2291666666666665
425,3,2,-1,878737657,878737684,27,324,323,3.0
425,2,2,0,878737684,878737841,157,323,318,4.5046728971962615
425,2,5,3,878737841,878737873,32,318,156,4.017857142857143
425,5,4,-1,878737873,878737908,35,156,429,3.742857142857143
425,4,5,1,878737908,878737945,37,429,56,4.051724137931035
425,5,5,0,878737945,878737981,36,56,357,4.063291139240507
425,5,3,-2,878737981,878738077,96,357,522,3.8461538461538463
425,3,3,0,878738077,878738104,27,522,201,3.75
425,3,3,0,878738104,878738149,45,201,174,4.253521126760563
425,3,4,1,878738149,878738245,96,174,195,3.9072164948453607
425,4,3,-1,878738245,878738290,45,195,7,3.76056338028169
425,3,3,0,878738290,878738334,44,7,435,3.8933333333333335
425,3,5,2,878738334,878738335,1,435,92,3.7142857142857144
425,5,2,-3,878738335,878738385,50,92,684,3.847826086956522
425,2,3,1,878738385,878738386,1,684,187,4.215189873417722
425,3,4,1,878738386,878738435,49,187,181,3.98974358974359
425,4,3,-1,878738435,878738486,51,181,183,3.951219512195122
425,3,3,0,878738486,878738548,62,183,229,3.185185185185185
425,3,4,1,878738548,878738644,96,229,230,3.3518518518518516
425,4,3,-1,878738644,878738695,51,230,1416,2.5
425,3,3,0,878738695,878738757,62,1416,686,3.9
425,3,3,0,878738757,878738813,56,686,576,3.125
425,3,3,0,878738813,878738853,40,576,234,3.7674418604651163
425,3,4,1,878738853,878738854,1,234,200,3.8157894736842106
425,4,1,-3,878738854,878738887,33,200,5,3.1481481481481484
425,1,1,0,878738887,878738914,27,5,217,3.1538461538461537
425,1,4,3,878738914,878738992,78,217,293,3.630434782608696
425,4,1,-3,878738992,878739015,23,293,244,2.9411764705882355
425,1,3,2,878739015,878739054,39,244,1016,3.559322033898305
425,3,2,-1,878739054,878739095,41,1016,1089,2.1363636363636362
425,2,4,2,878739095,890346264,11607169,1089,340,3.7419354838709675
425,4,2,-2,890346264,890346317,53,340,750,4.027777777777778
425,2,4,2,890346317,890346376,59,750,269,4.085106382978723
425,4,4,0,890346376,890346411,35,269,307,3.6031746031746033
425,4,4,0,890346411,890346517,106,307,347,3.59375
425,4,4,0,890346517,890346567,50,347,334,3.4210526315789473
425,4,3,-1,890346567,890346597,30,334,322,3.0476190476190474
425,3,4,1,890346597,890346659,62,322,327,3.5076923076923077
425,4,4,0,890346659,890346705,46,327,301,3.2465753424657535
425,4,1,-3,890346705,890346825,120,301,259,2.492063492063492
425,1,1,0,890346825,890346866,41,259,690,3.260869565217391
425,1,3,2,890346866,890346998,132,690,210,3.921259842519685
425,3,2,-1,890346998,890347085,87,210,209,3.8275862068965516
425,2,3,1,890347085,890347138,53,209,171,4.090909090909091
425,3,2,-1,890347138,890347247,109,171,97,3.7282608695652173
425,2,2,0,890347247,891986445,1639198,97,207,3.4761904761904763
419,5,5,0,879435242,879435541,299,306,50,4.306532663316583
419,5,4,-1,879435541,879435590,49,50,79,3.956989247311828
419,4,4,0,879435590,879435628,38,79,617,3.8
419,4,5,1,879435628,879435663,35,617,705,3.7857142857142856
419,5,1,-4,879435663,879435749,86,705,212,3.230769230769231
419,1,4,3,879435749,879435785,36,212,514,4.033333333333333
419,4,5,1,879435785,879435828,43,514,14,4.101694915254237
415,2,4,2,879439205,879439311,106,323,754,3.5789473684210527
415,4,5,1,879439311,879439349,38,754,748,3.1043478260869564
415,5,1,-4,879439349,879439386,37,748,243,2.357142857142857
415,1,5,4,879439386,879439684,298,243,531,3.7435897435897436
415,5,5,0,879439684,879439685,1,531,195,3.9072164948453607
415,5,5,0,879439685,879439791,106,195,1524,5.0
415,5,5,0,879439791,879439864,73,1524,174,4.253521126760563
415,5,4,-1,879439864,879439960,96,174,185,3.9726027397260273
423,4,3,-1,891394504,891394558,54,340,310,3.6666666666666665
423,3,4,1,891394558,891394595,37,310,313,4.323076923076923
423,4,3,-1,891394595,891394632,37,313,347,3.59375
423,3,5,2,891394632,891394747,115,347,258,3.7547169811320753
423,5,3,-2,891394747,891394788,41,258,299,3.0
423,3,4,1,891394788,891394832,44,299,754,3.5789473684210527
423,4,3,-1,891394832,891394874,42,754,1238,3.0
423,3,3,0,891394874,891394910,36,1238,348,3.2
423,3,4,1,891394910,891395020,110,348,689,3.1538461538461537
423,4,5,1,891395020,891395395,375,689,9,3.8878504672897196
423,5,3,-2,891395395,891395417,22,9,148,3.2131147540983607
423,3,2,-1,891395417,891395547,130,148,125,3.5555555555555554
423,2,4,2,891395547,891395602,55,125,628,3.573529411764706
423,4,3,-1,891395602,891395626,24,628,471,3.5714285714285716
423,3,4,1,891395626,891395684,58,471,1134,2.888888888888889
423,4,4,0,891395684,891395711,27,1134,620,3.0
423,4,4,0,891395711,891395734,23,620,10,3.85
423,4,3,-1,891395734,891395759,25,10,696,3.138888888888889
423,3,1,-2,891395759,891395787,28,696,977,2.473684210526316
429,3,5,2,882384438,882384526,88,321,238,3.888888888888889
429,5,4,-1,882384526,882384579,53,238,475,3.956043956043956
429,4,3,-1,882384579,882384603,24,475,520,4.136363636363637
429,3,4,1,882384603,882384683,80,520,56,4.051724137931035
429,4,5,1,882384683,882384744,61,56,22,4.215909090909091
429,5,4,-1,882384744,882384772,28,22,651,3.8627450980392157
429,4,5,1,882384772,882384796,24,651,498,4.290909090909091
429,5,5,0,882384796,882384821,25,498,483,4.475609756097561
429,5,2,-3,882384821,882384847,26,483,466,3.5
429,2,5,3,882384847,882384870,23,466,340,3.7419354838709675
429,5,5,0,882384870,882384920,50,340,484,4.116279069767442
429,5,2,-3,882384920,882384950,30,484,806,3.6666666666666665
429,2,4,2,882384950,882384986,36,806,939,3.6333333333333333
429,4,3,-1,882384986,882385012,26,939,95,3.8194444444444446
429,3,4,1,882385012,882385034,22,95,223,4.108695652173913
429,4,4,0,882385034,882385065,31,223,177,3.875
429,4,5,1,882385065,882385090,25,177,211,3.958904109589041
429,5,4,-1,882385090,882385118,28,211,652,3.9642857142857144
429,4,4,0,882385118,882385136,18,652,93,3.5641025641025643
429,4,4,0,882385136,882385168,32,93,89,3.9615384615384617
429,4,4,0,882385168,882385210,42,89,467,4.071428571428571
429,4,4,0,882385210,882385243,33,467,631,3.581818181818182
429,4,3,-1,882385243,882385267,24,631,1418,3.6666666666666665
429,3,4,1,882385267,882385293,26,1418,419,3.8208955223880596
429,4,5,1,882385293,882385399,106,419,1101,3.793103448275862
429,5,4,-1,882385399,882385443,44,1101,432,3.719298245614035
429,4,5,1,882385443,882385464,21,432,180,3.9473684210526314
429,5,4,-1,882385464,882385489,25,180,273,3.5238095238095237
429,4,4,0,882385489,882385519,30,273,195,3.9072164948453607
429,4,3,-1,882385519,882385542,23,195,176,3.967032967032967
429,3,5,2,882385542,882385593,51,176,42,3.893617021276596
429,5,3,-2,882385593,882385612,19,42,192,4.090909090909091
429,3,2,-1,882385612,882385613,1,192,229,3.185185185185185
429,2,5,3,882385613,882385636,23,229,357,4.063291139240507
429,5,2,-3,882385636,882385684,48,357,581,3.130434782608696
429,2,3,1,882385684,882385705,21,581,71,3.6575342465753424
429,3,5,2,882385705,882385728,23,71,134,4.174603174603175
429,5,4,-1,882385728,882385729,1,134,207,3.4761904761904763
429,4,4,0,882385729,882385749,20,207,584,3.5238095238095237
429,4,3,-1,882385749,882385785,36,584,1,3.902439024390244
429,3,5,2,882385785,882385807,22,1,100,4.0162162162162165
429,5,3,-2,882385807,882385808,1,100,628,3.573529411764706
429,3,3,0,882385808,882385829,21,628,143,3.56
429,3,3,0,882385829,882385858,29,143,433,3.8035714285714284
429,3,2,-1,882385858,882385859,1,433,147,3.3142857142857145
429,2,3,1,882385859,882385934,75,147,161,3.5844155844155843
429,3,2,-1,882385934,882385962,28,161,921,3.611111111111111
429,2,4,2,882385962,882385963,1,921,1301,3.6666666666666665
429,4,2,-2,882385963,882385985,22,1301,230,3.3518518518518516
429,2,3,1,882385985,882386006,21,230,448,3.466666666666667
429,3,3,0,882386006,882386027,21,448,281,3.2
429,3,4,1,882386027,882386051,24,281,387,3.5357142857142856
429,4,4,0,882386051,882386071,20,387,480,4.283018867924528
429,4,3,-1,882386071,882386096,25,480,418,3.825
429,3,4,1,882386096,882386121,25,418,404,3.6578947368421053
429,4,5,1,882386121,882386145,24,404,298,3.779220779220779
429,5,4,-1,882386145,882386171,26,298,97,3.7282608695652173
429,4,3,-1,882386171,882386216,45,97,65,3.511111111111111
429,3,3,0,882386216,882386260,44,65,91,3.6
429,3,3,0,882386260,882386309,49,91,24,3.3728813559322033
429,3,3,0,882386309,882386333,24,24,1014,3.1
429,3,4,1,882386333,882386378,45,1014,162,3.4651162790697674
429,4,4,0,882386378,882386401,23,162,70,3.5833333333333335
429,4,3,-1,882386401,882386424,23,70,128,3.45
429,3,4,1,882386424,882386448,24,128,123,3.297872340425532
429,4,3,-1,882386448,882386485,37,123,673,3.393939393939394
429,3,4,1,882386485,882386532,47,673,1136,3.3076923076923075
429,4,3,-1,882386532,882386533,1,1136,640,2.75
429,3,4,1,882386533,882386566,33,640,188,3.625
429,4,3,-1,882386566,882386601,35,188,382,3.764705882352941
429,3,4,1,882386601,882386628,27,382,693,3.6285714285714286
429,4,3,-1,882386628,882386629,1,693,167,2.8181818181818183
429,3,3,0,882386629,882386662,33,167,559,3.477272727272727
429,3,3,0,882386662,882386684,22,559,80,2.967741935483871
429,3,4,1,882386684,882386711,27,80,742,3.5555555555555554
429,4,2,-2,882386711,882386751,40,742,409,2.9615384615384617
429,2,2,0,882386751,882386785,34,409,3,3.0625
429,2,4,2,882386785,882386814,29,3,762,3.3962264150943398
429,4,3,-1,882386814,882386848,34,762,411,2.911764705882353
429,3,5,2,882386848,882386870,22,411,151,3.6544117647058822
429,5,3,-2,882386870,882386895,25,151,587,3.4
429,3,3,0,882386895,882386915,20,587,385,3.6129032258064515
429,3,3,0,882386915,882386916,1,385,378,3.6904761904761907
429,3,5,2,882386916,882386941,25,378,15,3.725663716814159
429,5,4,-1,882386941,882386942,1,15,428,3.744186046511628
429,4,3,-1,882386942,882386966,24,428,235,3.106382978723404
429,3,4,1,882386966,882387053,87,235,96,3.9130434782608696
429,4,4,0,882387053,882387074,21,96,52,3.727272727272727
429,4,2,-2,882387074,882387114,40,52,1224,2.6666666666666665
429,2,3,1,882387114,882387139,25,1224,826,2.5555555555555554
429,3,3,0,882387139,882387140,1,826,739,3.391304347826087
429,3,2,-1,882387140,882387163,23,739,999,2.75
429,2,2,0,882387163,882387164,1,999,1079,2.1923076923076925
429,2,3,1,882387164,882387181,17,1079,366,3.4285714285714284
429,3,3,0,882387181,882387202,21,366,405,3.25
429,3,3,0,882387202,882387233,31,405,1220,2.9166666666666665
429,3,3,0,882387233,882387252,19,1220,301,3.2465753424657535
429,3,1,-2,882387252,882387350,98,301,1033,3.0
429,1,2,1,882387350,882387392,42,1033,280,3.103448275862069
429,2,1,-1,882387392,882387411,19,280,440,1.5
429,1,3,2,882387411,882387434,23,440,472,2.984375
429,3,2,-1,882387434,882387506,72,472,569,2.4285714285714284
429,2,3,1,882387506,882387576,70,569,808,2.4444444444444446
429,3,2,-1,882387576,882387599,23,808,225,3.0714285714285716
429,2,3,1,882387599,882387633,34,225,1425,2.6
429,3,4,1,882387633,882387653,20,1425,679,3.2432432432432434
429,4,3,-1,882387653,882387685,32,679,319,3.0408163265306123
429,3,2,-1,882387685,882387715,30,319,371,3.0
429,2,4,2,882387715,882387731,16,371,710,3.41025641025641
429,4,5,1,882387731,882387757,26,710,702,2.764705882352941
429,5,4,-1,882387757,882387773,16,702,537,3.5
428,5,4,-1,885943685,885943749,64,877,332,3.6511627906976742
428,4,5,1,885943749,885943818,69,332,751,3.3896103896103895
428,5,4,-1,885943818,885943847,29,751,288,3.5214285714285714
428,4,3,-1,885943847,885943869,22,288,323,3.0
428,3,1,-2,885943869,885943955,86,323,988,2.5555555555555554
428,1,4,3,885943955,885944005,50,988,312,3.0
428,4,4,0,885944005,885944024,19,312,908,2.5714285714285716
428,4,4,0,885944024,885944044,20,908,892,2.9615384615384617
428,4,3,-1,885944044,885944069,25,892,1280,2.3333333333333335
428,3,2,-1,885944069,885944093,24,1280,343,3.0
428,2,4,2,885944093,885944110,17,343,307,3.6031746031746033
428,4,4,0,885944110,885944136,26,307,875,2.736842105263158
428,4,3,-1,885944136,892572335,6628199,875,329,3.25
428,3,4,1,892572335,892572362,27,329,1313,3.142857142857143
428,4,4,0,892572362,892572382,20,1313,316,4.285714285714286
428,4,2,-2,892572382,892572448,66,316,271,3.3134328358208953
427,4,4,0,879700792,879700850,58,258,331,3.5517241379310347
427,4,4,0,879700850,879700908,58,331,328,3.4895833333333335
427,4,2,-2,879700908,879701127,219,328,292,3.6666666666666665
427,2,5,3,879701127,879701225,98,292,1296,3.2222222222222223
427,5,5,0,879701225,879701325,100,1296,682,3.0476190476190474
418,2,5,3,891282521,891282551,30,315,258,3.7547169811320753
418,5,4,-1,891282551,891282595,44,258,895,3.142857142857143
418,4,2,-2,891282595,891282626,31,895,750,4.027777777777778
418,2,3,1,891282626,891282656,30,750,300,3.6861313868613137
418,3,3,0,891282656,891282680,24,300,313,4.323076923076923
418,3,2,-1,891282680,891282738,58,313,301,3.2465753424657535
418,2,1,-1,891282738,891282765,27,301,362,2.1666666666666665
418,1,2,1,891282765,891282813,48,362,1313,3.142857142857143
418,2,5,3,891282813,891282836,23,1313,288,3.5214285714285714
424,3,4,1,880858829,880858861,32,310,304,3.5306122448979593
424,4,1,-3,880858861,880858887,26,304,689,3.1538461538461537
424,1,5,4,880858887,880858924,37,689,289,2.988888888888889
424,5,2,-3,880858924,880858979,55,289,259,2.492063492063492
424,2,5,3,880858979,880859084,105,259,323,3.0
424,5,2,-3,880859084,880859199,115,323,300,3.6861313868613137
424,2,2,0,880859199,880859228,29,300,688,2.111111111111111
424,2,4,2,880859228,880859346,118,688,427,4.2025316455696204
424,4,1,-3,880859346,880859385,39,427,115,3.6666666666666665
424,1,5,4,880859385,880859410,25,115,275,4.087912087912088
424,5,5,0,880859410,880859446,36,275,100,4.0162162162162165
424,5,4,-1,880859446,880859493,47,100,127,4.162790697674419
424,4,4,0,880859493,880859552,59,127,14,4.101694915254237
424,4,5,1,880859552,880859591,39,14,1084,4.0
424,5,5,0,880859591,880859623,32,1084,9,3.8878504672897196
424,5,5,0,880859623,880859674,51,9,740,3.423076923076923
424,5,4,-1,880859674,880859693,19,740,840,3.090909090909091
424,4,2,-2,880859693,880859722,29,840,151,3.6544117647058822
424,2,4,2,880859722,880859723,1,151,25,3.3185840707964602
432,5,3,-2,889415812,889415852,40,293,298,3.779220779220779
432,3,5,2,889415852,889415853,1,298,508,3.6923076923076925
432,5,1,-4,889415853,889415895,42,508,250,3.4698795180722892
432,1,4,3,889415895,889415947,52,250,276,3.6036036036036037
432,4,2,-2,889415947,889415983,36,276,1049,2.5714285714285716
432,2,5,3,889415983,889416012,29,1049,50,4.306532663316583
432,5,5,0,889416012,889416118,106,50,1047,2.6923076923076925
432,5,4,-1,889416118,889416147,29,1047,475,3.956043956043956
432,4,1,-3,889416147,889416188,41,475,24,3.3728813559322033
432,1,3,2,889416188,889416229,41,24,274,3.5609756097560976
432,3,3,0,889416229,889416260,31,274,3,3.0625
432,3,4,1,889416260,889416312,52,3,121,3.521212121212121
432,4,3,-1,889416312,889416397,85,121,1016,3.559322033898305
432,3,5,2,889416397,889416398,1,1016,628,3.573529411764706
432,5,4,-1,889416398,889416456,58,628,111,3.5106382978723403
432,4,4,0,889416456,889416490,34,111,405,3.25
432,4,4,0,889416490,889416521,31,405,284,3.1547619047619047
432,4,5,1,889416521,889416570,49,284,763,3.347826086956522
432,5,5,0,889416570,889416608,38,763,255,3.2027027027027026
432,5,3,-2,889416608,889416657,49,255,322,3.0476190476190474
421,4,4,0,892241236,892241252,16,302,915,4.0
421,4,4,0,892241252,892241274,22,915,879,3.2291666666666665
421,4,5,1,892241274,892241294,20,879,50,4.306532663316583
421,5,1,-4,892241294,892241319,25,50,173,4.1441441441441444
421,1,4,3,892241319,892241343,24,173,96,3.9130434782608696
421,4,4,0,892241343,892241344,1,96,498,4.290909090909091
421,4,4,0,892241344,892241389,45,498,709,4.171428571428572
421,4,4,0,892241389,892241422,33,709,100,4.0162162162162165
421,4,5,1,892241422,892241458,36,100,98,4.240875912408759
421,5,5,0,892241458,892241459,1,98,443,3.8421052631578947
421,5,3,-2,892241459,892241491,32,443,197,4.112676056338028
421,3,2,-1,892241491,892241532,41,197,509,3.7058823529411766
421,2,5,3,892241532,892241554,22,509,516,4.055555555555555
421,5,2,-3,892241554,892241576,22,516,175,3.8354430379746836
421,2,4,2,892241576,892241624,48,175,127,4.162790697674419
421,4,3,-1,892241624,892241646,22,127,7,3.76056338028169
421,3,4,1,892241646,892241687,41,7,218,3.5555555555555554
421,4,4,0,892241687,892241736,49,218,87,3.9
435,4,3,-1,884130605,884130647,42,288,895,3.142857142857143
435,3,5,2,884130647,884130744,97,895,307,3.6031746031746033
435,5,2,-3,884130744,884130834,90,307,687,2.1481481481481484
435,2,1,-1,884130834,884130883,49,687,890,1.7692307692307692
435,1,4,3,884130883,884130995,112,890,527,3.823529411764706
435,4,4,0,884130995,884131016,21,527,79,3.956989247311828
435,4,5,1,884131016,884131036,20,79,64,4.373737373737374
435,5,5,0,884131036,884131055,19,64,56,4.051724137931035
435,5,5,0,884131055,884131085,30,56,173,4.1441441441441444
435,5,3,-2,884131085,884131118,33,173,216,3.8454545454545452
435,3,4,1,884131118,884131156,38,216,22,4.215909090909091
435,4,2,-2,884131156,884131157,1,22,423,3.7016129032258065
435,2,4,2,884131157,884131200,43,423,191,4.168674698795181
435,4,3,-1,884131200,884131267,67,191,42,3.893617021276596
435,3,5,2,884131267,884131298,31,42,273,3.5238095238095237
435,5,3,-2,884131298,884131328,30,273,58,3.543859649122807
435,3,3,0,884131328,884131356,28,58,117,3.689189189189189
435,3,5,2,884131356,884131385,29,117,318,4.5046728971962615
435,5,3,-2,884131385,884131404,19,318,392,3.5555555555555554
435,3,5,2,884131404,884131434,30,392,55,4.051282051282051
435,5,3,-2,884131434,884131489,55,55,163,3.53125
435,3,5,2,884131489,884131515,26,163,168,4.0476190476190474
435,5,4,-1,884131515,884131597,82,168,7,3.76056338028169
435,4,4,0,884131597,884131627,30,7,194,4.029411764705882
435,4,2,-2,884131627,884131661,34,194,470,3.72
435,2,5,3,884131661,884131681,20,470,45,4.130434782608695
435,5,3,-2,884131681,884131711,30,45,100,4.0162162162162165
435,3,5,2,884131711,884131712,1,100,1,3.902439024390244
435,5,4,-1,884131712,884131741,29,1,214,3.272727272727273
435,4,2,-2,884131741,884131799,58,214,655,3.7857142857142856
435,2,5,3,884131799,884131822,23,655,96,3.9130434782608696
435,5,4,-1,884131822,884131844,22,96,778,3.5925925925925926
435,4,2,-2,884131844,884131868,24,778,568,3.5853658536585367
435,2,4,2,884131868,884131901,33,568,68,3.5714285714285716
435,4,3,-1,884131901,884131949,48,68,382,3.764705882352941
435,3,5,2,884131949,884131950,1,382,10,3.85
435,5,5,0,884131950,884131967,17,10,171,4.090909090909091
435,5,4,-1,884131967,884131996,29,171,588,3.8358208955223883
435,4,4,0,884131996,884132027,31,588,520,4.136363636363637
435,4,3,-1,884132027,884132072,45,520,924,3.3703703703703702
435,3,5,2,884132072,884132100,28,924,82,3.6741573033707864
435,5,4,-1,884132100,884132146,46,82,157,3.5714285714285716
435,4,3,-1,884132146,884132184,38,157,101,3.4827586206896552
435,3,5,2,884132184,884132208,24,101,181,3.98974358974359
435,5,3,-2,884132208,884132230,22,181,448,3.466666666666667
435,3,2,-1,884132230,884132266,36,448,755,3.085714285714286
435,2,4,2,884132266,884132296,30,755,1240,3.5454545454545454
435,4,3,-1,884132296,884132297,1,1240,584,3.5238095238095237
435,3,4,1,884132297,884132341,44,584,732,3.6266666666666665
435,4,3,-1,884132341,884132342,1,732,696,3.138888888888889
435,3,3,0,884132342,884132366,24,696,204,3.6744186046511627
435,3,1,-2,884132366,884132367,1,204,820,3.0444444444444443
435,1,4,3,884132367,884132403,36,820,54,3.3714285714285714
435,4,4,0,884132403,884132434,31,54,136,3.764705882352941
435,4,2,-2,884132434,884132458,24,136,118,3.2764227642276422
435,2,2,0,884132458,884132483,25,118,317,3.774193548387097
435,2,3,1,884132483,884132484,1,317,411,2.911764705882353
435,3,2,-1,884132484,884132515,31,411,465,3.75
435,2,4,2,884132515,884132540,25,465,405,3.25
435,4,4,0,884132540,884132561,21,405,420,3.5652173913043477
435,4,4,0,884132561,884132588,27,420,175,3.8354430379746836
435,4,5,1,884132588,884132619,31,175,183,3.951219512195122
435,5,2,-3,884132619,884132643,24,183,674,2.6875
435,2,3,1,884132643,884132672,29,674,33,3.2941176470588234
435,3,4,1,884132672,884132691,19,33,637,2.888888888888889
435,4,1,-3,884132691,884132755,64,637,162,3.4651162790697674
435,1,4,3,884132755,884132756,1,162,90,3.0
435,4,4,0,884132756,884132809,53,90,72,3.175438596491228
435,4,4,0,884132809,884132840,31,72,742,3.5555555555555554
435,4,3,-1,884132840,884132873,33,742,675,3.625
435,3,4,1,884132873,884132919,46,675,67,3.106382978723404
435,4,4,0,884132919,884132942,23,67,546,2.9789473684210526
435,4,4,0,884132942,884132968,26,546,239,3.423076923076923
435,4,5,1,884132968,884132990,22,239,628,3.573529411764706
435,5,2,-3,884132990,884133064,74,628,561,3.1515151515151514
435,2,4,2,884133064,884133084,20,561,24,3.3728813559322033
435,4,4,0,884133084,884133161,77,24,226,3.378787878787879
435,4,3,-1,884133161,884133194,33,226,627,3.3823529411764706
435,3,1,-2,884133194,884133253,59,627,672,2.7222222222222223
435,1,3,2,884133253,884133284,31,672,148,3.2131147540983607
435,3,1,-2,884133284,884133330,46,148,760,2.35
435,1,1,0,884133330,884133371,41,760,1185,2.111111111111111
435,1,3,2,884133371,884133372,1,1185,679,3.2432432432432434
435,3,2,-1,884133372,884133415,43,679,1074,2.857142857142857
435,2,4,2,884133415,884133446,31,1074,291,3.2
435,4,3,-1,884133446,884133447,1,291,53,2.9523809523809526
435,3,2,-1,884133447,884133466,19,53,472,2.984375
435,2,4,2,884133466,884133487,21,472,451,3.207792207792208
435,4,3,-1,884133487,884133544,57,451,635,2.5
435,3,4,1,884133544,884133585,41,635,381,3.2758620689655173
435,4,2,-2,884133585,884133610,25,381,393,3.5125
435,2,2,0,884133610,884133635,25,393,929,2.8421052631578947
435,2,4,2,884133635,884133691,56,929,436,3.5
435,4,3,-1,884133691,884133710,19,436,155,3.0588235294117645
435,3,5,2,884133710,884133733,23,155,410,3.0434782608695654
435,5,2,-3,884133733,884133757,24,410,729,3.3793103448275863
435,2,3,1,884133757,884133785,28,729,567,3.272727272727273
435,3,2,-1,884133785,884133818,33,567,720,3.2
435,2,4,2,884133818,884133819,1,720,800,3.2222222222222223
435,4,1,-3,884133819,884133911,92,800,27,3.235294117647059
435,1,2,1,884133911,884133938,27,27,818,2.769230769230769
435,2,3,1,884133938,884133972,34,818,926,2.7857142857142856
435,3,3,0,884133972,884134019,47,926,569,2.4285714285714284
435,3,4,1,884134019,884134047,28,569,636,3.4146341463414633
435,4,3,-1,884134047,884134075,28,636,444,2.6842105263157894
435,3,3,0,884134075,884134076,1,444,225,3.0714285714285716
435,3,3,0,884134076,884134104,28,225,717,2.9696969696969697
435,3,3,0,884134104,884134134,30,717,756,2.6885245901639343
435,3,3,0,884134134,884134187,53,756,928,3.142857142857143
435,3,4,1,884134187,884134242,55,928,249,3.3275862068965516
435,4,5,1,884134242,884134345,103,249,246,4.0
435,5,4,-1,884134345,884134363,18,246,257,3.7154471544715446
435,4,4,0,884134363,884134377,14,257,1016,3.559322033898305
435,4,4,0,884134377,884134500,123,1016,298,3.779220779220779
435,4,1,-3,884134500,884134536,36,298,424,1.4
435,1,2,1,884134536,884134553,17,424,841,2.772727272727273
435,2,1,-1,884134553,884134627,74,841,824,2.590909090909091
435,1,2,1,884134627,884134713,86,824,826,2.5555555555555554
435,2,2,0,884134713,884134754,41,826,1034,2.6
435,2,1,-1,884134754,884134771,17,1034,369,2.5714285714285716
435,1,3,2,884134771,884134810,39,369,1215,2.0714285714285716
435,3,2,-1,884134810,884134830,20,1215,983,2.5
435,2,1,-1,884134830,884134853,23,983,1291,2.125
435,1,3,2,884134853,884134910,57,1291,743,1.9545454545454546
435,3,2,-1,884134910,887509368,3374458,743,351,2.4444444444444446
435,2,3,1,887509368,887509539,171,351,752,3.6666666666666665
433,5,2,-3,880585068,880585133,65,286,333,3.546666666666667
433,2,3,1,880585133,880585271,138,333,294,3.1052631578947367
433,3,2,-1,880585271,880585386,115,294,326,3.262295081967213
433,2,2,0,880585386,880585431,45,326,682,3.0476190476190474
433,2,3,1,880585431,880585491,60,682,245,3.056179775280899
433,3,2,-1,880585491,880585554,63,245,325,2.625
433,2,5,3,880585554,880585700,146,325,60,4.105263157894737
433,5,5,0,880585700,880585730,30,60,59,4.0
433,5,5,0,880585730,880585759,29,59,194,4.029411764705882
433,5,5,0,880585759,880585843,84,194,276,3.6036036036036037
433,5,5,0,880585843,880585885,42,276,50,4.306532663316583
433,5,5,0,880585885,880585904,19,50,137,3.9545454545454546
433,5,5,0,880585904,880585923,19,137,919,4.0
426,4,5,1,879441781,879441978,197,332,133,3.7777777777777777
426,5,5,0,879441978,879442044,66,133,318,4.5046728971962615
426,5,4,-1,879442044,879442083,39,318,504,4.085714285714285
426,4,3,-1,879442083,879442128,45,504,204,3.6744186046511627
426,3,5,2,879442128,879442160,32,204,657,4.341463414634147
426,5,4,-1,879442160,879442161,1,657,208,3.8125
426,4,4,0,879442161,879442227,66,208,525,4.0
426,4,5,1,879442227,879442737,510,525,427,4.2025316455696204
426,5,3,-2,879442737,879442841,104,427,496,4.094594594594595
426,3,5,2,879442841,879444081,1240,496,429,3.742857142857143
426,5,4,-1,879444081,879444117,36,429,519,4.291666666666667
426,4,3,-1,879444117,879444146,29,519,613,4.1
426,3,3,0,879444146,879444192,46,613,432,3.719298245614035
426,3,4,1,879444192,879444320,128,432,211,3.958904109589041
426,4,5,1,879444320,879444472,152,211,603,4.315789473684211
426,5,4,-1,879444472,879444473,1,603,493,3.909090909090909
426,4,3,-1,879444473,879444550,77,493,527,3.823529411764706
426,3,3,0,879444550,879444604,54,527,135,3.7974683544303796
426,3,5,2,879444604,879444662,58,135,484,4.116279069767442
426,5,4,-1,879444662,879444734,72,484,526,3.909090909090909
426,4,4,0,879444734,879444787,53,526,616,3.1052631578947367
426,4,4,0,879444787,879444816,29,616,197,4.112676056338028
426,4,3,-1,879444816,879444852,36,197,143,3.56
426,3,3,0,879444852,879444853,1,143,835,4.0
426,3,3,0,879444853,879444871,18,835,418,3.825
426,3,4,1,879444871,879444893,22,418,205,3.717391304347826
426,4,3,-1,879444893,879444952,59,205,968,3.75
426,3,5,2,879444952,879445005,53,968,185,3.9726027397260273
436,5,4,-1,887768445,887768521,76,340,348,3.2
436,4,5,1,887768521,887768694,173,348,327,3.5076923076923077
436,5,4,-1,887768694,887768717,23,327,895,3.142857142857143
436,4,3,-1,887768717,887768738,21,895,748,3.1043478260869564
436,3,3,0,887768738,887768756,18,748,325,2.625
436,3,3,0,887768756,887768945,189,325,172,4.225225225225225
436,3,4,1,887768945,887768982,37,172,454,3.0
436,4,4,0,887768982,887769079,97,454,642,3.4285714285714284
436,4,3,-1,887769079,887769105,26,642,427,4.2025316455696204
436,3,3,0,887769105,887769128,23,427,469,3.6842105263157894
436,3,5,2,887769128,887769150,22,469,182,3.842857142857143
436,5,4,-1,887769150,887769151,1,182,504,4.085714285714285
436,4,5,1,887769151,887769209,58,504,204,3.6744186046511627
436,5,4,-1,887769209,887769280,71,204,98,4.240875912408759
436,4,4,0,887769280,887769281,1,98,710,3.41025641025641
436,4,3,-1,887769281,887769335,54,710,174,4.253521126760563
436,3,4,1,887769335,887769368,33,174,1119,3.5185185185185186
436,4,4,0,887769368,887769415,47,1119,50,4.306532663316583
436,4,5,1,887769415,887769416,1,50,568,3.5853658536585367
436,5,1,-4,887769416,887769444,28,568,447,3.46875
436,1,3,2,887769444,887769515,71,447,200,3.8157894736842106
436,3,4,1,887769515,887769535,20,200,96,3.9130434782608696
436,4,3,-1,887769535,887769693,158,96,238,3.888888888888889
436,3,4,1,887769693,887769733,40,238,821,3.076923076923077
436,4,5,1,887769733,887769777,44,821,11,3.8904109589041096
436,5,4,-1,887769777,887769801,24,11,507,3.6285714285714286
436,4,1,-3,887769801,887769824,23,507,132,3.929411764705882
436,1,3,2,887769824,887769868,44,132,1206,2.8333333333333335
436,3,3,0,887769868,887769887,19,1206,39,3.107142857142857
436,3,5,2,887769887,887769930,43,39,127,4.162790697674419
436,5,5,0,887769930,887770015,85,127,746,3.7560975609756095
436,5,4,-1,887770015,887770037,22,746,125,3.5555555555555554
436,4,4,0,887770037,887770064,27,125,216,3.8454545454545452
436,4,2,-2,887770064,887770092,28,216,143,3.56
436,2,3,1,887770092,887770115,23,143,92,3.7142857142857144
436,3,4,1,887770115,887770169,54,92,287,3.4516129032258065
436,4,4,0,887770169,887770192,23,287,159,3.3902439024390243
436,4,4,0,887770192,887770217,25,159,367,3.4242424242424243
436,4,3,-1,887770217,887770266,49,367,90,3.0
436,3,3,0,887770266,887770300,34,90,986,2.5555555555555554
436,3,3,0,887770300,887770344,44,986,99,3.8392857142857144
436,3,2,-1,887770344,887770379,35,99,1048,2.857142857142857
436,2,3,1,887770379,887770403,24,1048,167,2.8181818181818183
436,3,3,0,887770403,887770428,25,167,790,2.8518518518518516
436,3,4,1,887770428,887770507,79,790,925,3.0
436,4,4,0,887770507,887770547,40,925,1058,3.6
436,4,4,0,887770547,887770566,19,1058,470,3.72
436,4,4,0,887770566,887770588,22,470,102,3.3684210526315788
436,4,4,0,887770588,887770668,80,102,715,3.257142857142857
436,4,2,-2,887770668,887770731,63,715,785,3.4375
436,2,4,2,887770731,887771042,311,785,763,3.347826086956522
436,4,4,0,887771042,887771093,51,763,550,3.272727272727273
436,4,2,-2,887771093,887771123,30,550,1522,2.5
436,2,4,2,887771123,887771753,630,1522,65,3.511111111111111
436,4,4,0,887771753,887771773,20,65,111,3.5106382978723403
436,4,3,-1,887771773,887771825,52,111,1178,2.375
436,3,4,1,887771825,887771853,28,1178,739,3.391304347826087
436,4,3,-1,887771853,887771875,22,739,635,2.5
436,3,4,1,887771875,887771897,22,635,161,3.5844155844155843
436,4,5,1,887771897,887771997,100,161,974,3.125
436,5,3,-2,887771997,887772028,31,974,21,2.9210526315789473
436,3,3,0,887772028,887772060,32,21,1263,3.1666666666666665
430,2,3,1,877225328,877225433,105,264,137,3.9545454545454546
430,3,4,1,877225433,877225484,51,137,181,3.98974358974359
430,4,5,1,877225484,877225547,63,181,129,3.744186046511628
430,5,5,0,877225547,877225570,23,129,100,4.0162162162162165
430,5,3,-2,877225570,877225599,29,100,1007,4.117647058823529
430,3,5,2,877225599,877225623,24,1007,19,3.9615384615384617
430,5,4,-1,877225623,877225660,37,19,1375,3.5
430,4,4,0,877225660,877225682,22,1375,222,3.578125
430,4,5,1,877225682,877225726,44,222,124,4.052631578947368
430,5,2,-3,877225726,877225727,1,124,235,3.106382978723404
430,2,1,-1,877225727,877225753,26,235,276,3.6036036036036037
430,1,2,1,877225753,877225832,79,276,121,3.521212121212121
430,2,3,1,877225832,877225865,33,121,293,3.630434782608696
430,3,2,-1,877225865,877225965,100,293,123,3.297872340425532
430,2,4,2,877225965,877226130,165,123,165,3.9130434782608696
430,4,3,-1,877226130,877226164,34,165,462,3.7954545454545454
430,3,4,1,877226164,877226209,45,462,527,3.823529411764706
430,4,4,0,877226209,877226323,114,527,234,3.7674418604651163
430,4,4,0,877226323,877226365,42,234,436,3.5
430,4,4,0,877226365,877226405,40,436,674,2.6875
430,4,4,0,877226405,877226568,163,674,168,4.0476190476190474
430,4,4,0,877226568,877226569,1,168,152,3.6785714285714284
434,3,5,2,886724453,886724540,87,15,111,3.5106382978723403
434,5,1,-4,886724540,886724563,23,111,9,3.8878504672897196
434,1,4,3,886724563,886724590,27,9,1,3.902439024390244
434,4,3,-1,886724590,886724633,43,1,275,4.087912087912088
434,3,4,1,886724633,886724666,33,275,121,3.521212121212121
434,4,3,-1,886724666,886724733,67,121,1060,3.235294117647059
434,3,5,2,886724733,886724754,21,1060,237,3.7315436241610738
434,5,5,0,886724754,886724873,119,237,975,3.411764705882353
434,5,1,-4,886724873,886724913,40,975,424,1.4
434,1,4,3,886724913,886724914,1,424,833,2.9444444444444446
434,4,5,1,886724914,886724940,26,833,1095,2.8
434,5,4,-1,886724940,886724972,32,1095,369,2.5714285714285716
434,4,1,-3,886724972,886725027,55,369,743,1.9545454545454546
434,1,4,3,886725027,886725076,49,743,476,3.1216216216216215
437,2,4,2,880139533,880139631,98,288,748,3.1043478260869564
437,4,5,1,880139631,880139951,320,748,134,4.174603174603175
437,5,5,0,880139951,880139997,46,134,208,3.8125
437,5,4,-1,880139997,880140051,54,208,484,4.116279069767442
437,4,4,0,880140051,880140100,49,484,211,3.958904109589041
437,4,3,-1,880140100,880140154,54,211,190,4.233333333333333
437,3,3,0,880140154,880140192,38,190,82,3.6741573033707864
437,3,5,2,880140192,880140221,29,82,137,3.9545454545454546
437,5,4,-1,880140221,880140257,36,137,172,4.225225225225225
437,4,4,0,880140257,880140288,31,172,23,3.9047619047619047
437,4,4,0,880140288,880140325,37,23,83,4.204081632653061
437,4,5,1,880140325,880140369,44,83,238,3.888888888888889
437,5,4,-1,880140369,880140398,29,238,200,3.8157894736842106
437,4,2,-2,880140398,880140432,34,200,182,3.842857142857143
437,2,1,-1,880140432,880140433,1,182,129,3.744186046511628
437,1,4,3,880140433,880140466,33,129,237,3.7315436241610738
437,4,4,0,880140466,880140534,68,237,47,3.5869565217391304
437,4,4,0,880140534,880140662,128,47,496,4.094594594594595
437,4,4,0,880140662,880140752,90,496,8,3.903225806451613
437,4,5,1,880140752,880140787,35,8,131,3.731707317073171
437,5,3,-2,880140787,880140822,35,131,602,3.533333333333333
437,3,5,2,880140822,880140855,33,602,582,3.7457627118644066
437,5,3,-2,880140855,880140891,36,582,87,3.9
437,3,5,2,880140891,880140892,1,87,607,4.136363636363637
437,5,4,-1,880140892,880140927,35,607,753,3.3333333333333335
437,4,5,1,880140927,880141041,114,753,216,3.8454545454545452
437,5,5,0,880141041,880141084,43,216,663,3.948717948717949
437,5,4,-1,880141084,880141129,45,663,13,3.5454545454545454
437,4,4,0,880141129,880141164,35,13,521,3.787878787878788
437,4,5,1,880141164,880141196,32,521,423,3.7016129032258065
437,5,3,-2,880141196,880141243,47,423,1098,3.533333333333333
437,3,3,0,880141243,880141286,43,1098,97,3.7282608695652173
437,3,5,2,880141286,880141335,49,97,479,4.25
437,5,5,0,880141335,880141374,39,479,404,3.6578947368421053
437,5,3,-2,880141374,880141402,28,404,71,3.6575342465753424
437,3,1,-2,880141402,880141441,39,71,642,3.4285714285714284
437,1,4,3,880141441,880141528,87,642,1267,2.909090909090909
437,4,4,0,880141528,880141529,1,1267,239,3.423076923076923
437,4,5,1,880141529,880141618,89,239,276,3.6036036036036037
437,5,5,0,880141618,880141661,43,276,1063,3.642857142857143
437,5,4,-1,880141661,880141696,35,1063,1142,4.0476190476190474
437,4,2,-2,880141696,880141716,20,1142,248,3.746268656716418
437,2,4,2,880141716,880141770,54,248,1161,3.4
437,4,1,-3,880141770,880141796,26,1161,253,3.5
437,1,5,4,880141796,880141961,165,253,419,3.8208955223880596
437,5,5,0,880141961,880141962,1,419,499,4.0
437,5,5,0,880141962,880142027,65,499,249,3.3275862068965516
437,5,4,-1,880142027,880142177,150,249,476,3.1216216216216215
437,4,4,0,880142177,880142365,188,476,207,3.4761904761904763
437,4,2,-2,880142365,880142399,34,207,26,3.36
437,2,5,3,880142399,880142426,27,26,381,3.2758620689655173
437,5,5,0,880142426,880142614,188,381,1599,5.0
437,5,3,-2,880142614,880142630,16,1599,1227,2.6
437,3,4,1,880142630,880142851,221,1227,234,3.7674418604651163
437,4,1,-3,880142851,880142942,91,234,226,3.378787878787879
437,1,3,2,880142942,880142991,49,226,696,3.138888888888889
437,3,1,-2,880142991,880143010,19,696,581,3.130434782608696
437,1,3,2,880143010,880143040,30,581,450,2.2758620689655173
437,3,1,-2,880143040,880143092,52,450,1090,2.3529411764705883
437,1,3,2,880143092,880143189,97,1090,155,3.0588235294117645
437,3,3,0,880143189,880143243,54,155,739,3.391304347826087
437,3,4,1,880143243,880143263,20,739,781,3.4166666666666665
437,4,3,-1,880143263,880143289,26,781,90,3.0
437,3,3,0,880143289,880143315,26,90,91,3.6
437,3,3,0,880143315,880143355,40,91,101,3.4827586206896552
437,3,4,1,880143355,880143419,64,101,699,3.736842105263158
437,4,4,0,880143419,880143451,32,699,378,3.6904761904761907
437,4,5,1,880143451,880143482,31,378,417,3.0588235294117645
437,5,5,0,880143482,880143505,23,417,401,2.6774193548387095
437,5,4,-1,880143505,880143520,15,401,843,2.933333333333333
437,4,5,1,880143520,880143562,42,843,1036,3.0
437,5,4,-1,880143562,880143591,29,1036,415,2.6666666666666665
437,4,1,-3,880143591,880143663,72,415,145,2.3636363636363638
437,1,2,1,880143663,880143695,32,145,665,2.72972972972973
437,2,3,1,880143695,880143714,19,665,674,2.6875
437,3,2,-1,880143714,880143809,95,674,518,3.5833333333333335
437,2,5,3,880143809,880382685,238876,518,12,4.358974358974359
437,5,3,-2,880382685,880382747,62,12,684,3.847826086956522
437,3,5,2,880382747,881000958,618211,684,50,4.306532663316583
437,5,1,-4,881000958,881001148,190,50,281,3.2
437,1,3,2,881001148,881001208,60,281,186,3.905263157894737
437,3,3,0,881001208,881001270,62,186,244,2.9411764705882355
437,3,4,1,881001270,881001436,166,244,94,2.8823529411764706
437,4,5,1,881001436,881001715,279,94,202,3.730337078651685
437,5,5,0,881001715,881001888,173,202,736,4.083333333333333
437,5,3,-2,881001888,881001945,57,736,435,3.8933333333333335
437,3,2,-1,881001945,881001946,1,435,189,3.88
437,2,4,2,881001946,881001983,37,189,421,3.462962962962963
437,4,4,0,881001983,881002026,43,421,708,3.3157894736842106
437,4,3,-1,881002026,881002067,41,708,111,3.5106382978723403
437,3,3,0,881002067,881002092,25,111,812,3.375
437,3,3,0,881002092,881002191,99,812,210,3.921259842519685
437,3,3,0,881002191,881002300,109,210,254,2.7419354838709675
437,3,5,2,881002300,881002323,23,254,478,4.161290322580645
437,5,4,-1,881002323,881002324,1,478,165,3.9130434782608696
437,4,5,1,881002324,881002345,21,165,716,3.1904761904761907
437,5,5,0,881002345,881002374,29,716,1007,4.117647058823529
437,5,3,-2,881002374,881002405,31,1007,629,3.3333333333333335
438,4,4,0,879868005,879868024,19,9,100,4.0162162162162165
438,4,4,0,879868024,879868042,18,100,845,3.661290322580645
438,4,4,0,879868042,879868096,54,845,1,3.902439024390244
438,4,4,0,879868096,879868159,63,1,257,3.7154471544715446
438,4,4,0,879868159,879868184,25,257,471,3.5714285714285716
438,4,5,1,879868184,879868264,80,471,282,3.610526315789474
438,5,2,-3,879868264,879868308,44,282,284,3.1547619047619047
438,2,4,2,879868308,879868328,20,284,220,3.433333333333333
438,4,4,0,879868328,879868364,36,220,252,2.911392405063291
438,4,5,1,879868364,879868423,59,252,280,3.103448275862069
438,5,5,0,879868423,879868443,20,280,148,3.2131147540983607
438,5,3,-2,879868443,879868547,104,148,864,3.2142857142857144
438,3,5,2,879868547,879868581,34,864,815,3.135135135135135
438,5,5,0,879868581,879868664,83,815,476,3.1216216216216215
438,5,2,-3,879868664,879868683,19,476,21,2.9210526315789473
431,4,3,-1,877844248,877844489,241,300,879,3.2291666666666665
431,3,3,0,877844489,877844559,70,879,327,3.5076923076923077
431,3,3,0,877844559,881127786,3283227,327,689,3.1538461538461537
442,2,1,-1,883388031,883388064,33,286,988,2.5555555555555554
442,1,4,3,883388064,883388092,28,988,268,3.9838709677419355
442,4,2,-2,883388092,883388120,28,268,294,3.1052631578947367
442,2,2,0,883388120,883388147,27,294,342,2.64
442,2,5,3,883388147,883388237,90,342,56,4.051724137931035
442,5,4,-1,883388237,883388283,46,56,209,3.8275862068965516
442,4,2,-2,883388283,883388325,42,209,100,4.0162162162162165
442,2,3,1,883388325,883388354,29,100,746,3.7560975609756095
442,3,3,0,883388354,883388401,47,746,239,3.423076923076923
442,3,4,1,883388401,883388429,28,239,186,3.905263157894737
442,4,4,0,883388429,883388508,79,186,410,3.0434782608695654
442,4,4,0,883388508,883388535,27,410,17,3.032258064516129
442,4,3,-1,883388535,883388609,74,17,210,3.921259842519685
442,3,4,1,883388609,883388909,300,210,1170,3.1666666666666665
442,4,2,-2,883388909,883388960,51,1170,1218,3.2
442,2,3,1,883388960,883388986,26,1218,780,3.08
442,3,3,0,883388986,883389053,67,780,1074,2.857142857142857
442,3,4,1,883389053,883389380,327,1074,635,2.5
442,4,4,0,883389380,883389491,111,635,154,3.6031746031746033
442,4,5,1,883389491,883389580,89,154,172,4.225225225225225
442,5,5,0,883389580,883389682,102,172,64,4.373737373737374
442,5,3,-2,883389682,883389747,65,64,482,3.9444444444444446
442,3,5,2,883389747,883389776,29,482,92,3.7142857142857144
442,5,3,-2,883389776,883390009,233,92,219,2.735294117647059
442,3,3,0,883390009,883390048,39,219,436,3.5
442,3,3,0,883390048,883390083,35,436,217,3.1538461538461537
442,3,2,-1,883390083,883390140,57,217,569,2.4285714285714284
442,2,3,1,883390140,883390169,29,569,452,2.6129032258064515
442,3,4,1,883390169,883390284,115,452,182,3.842857142857143
442,4,4,0,883390284,883390328,44,182,96,3.9130434782608696
442,4,4,0,883390328,883390366,38,96,177,3.875
442,4,4,0,883390366,883390416,50,177,181,3.98974358974359
442,4,4,0,883390416,883390466,50,181,403,3.298507462686567
442,4,3,-1,883390466,883390497,31,403,82,3.6741573033707864
442,3,3,0,883390497,883390544,47,82,2,3.0851063829787235
442,3,3,0,883390544,883390609,65,2,231,2.938775510204082
442,3,2,-1,883390609,883390641,32,231,62,3.048780487804878
442,2,3,1,883390641,883390674,33,62,1183,2.5
442,3,2,-1,883390674,883390703,29,1183,576,3.125
442,2,2,0,883390703,883390739,36,576,449,2.9069767441860463
442,2,2,0,883390739,883390813,74,449,22,4.215909090909091
442,2,3,1,883390813,883390935,122,22,69,3.8015873015873014
442,3,4,1,883390935,883391027,92,69,276,3.6036036036036037
442,4,4,0,883391027,883391046,19,276,318,4.5046728971962615
442,4,2,-2,883391046,883391146,100,318,44,3.1333333333333333
442,2,4,2,883391146,883391167,21,44,470,3.72
442,4,3,-1,883391167,883391249,82,470,31,3.642857142857143
442,3,3,0,883391249,883391275,26,31,229,3.185185185185185
442,3,3,0,883391275,883391299,24,229,281,3.2
442,3,3,0,883391299,883391325,26,281,77,3.3857142857142857
442,3,3,0,883391325,883391344,19,77,572,2.857142857142857
442,3,3,0,883391344,883391377,33,572,975,3.411764705882353
442,3,1,-2,883391377,883391397,20,975,769,2.2222222222222223
440,3,5,2,891546631,891546654,23,310,904,4.125
440,5,4,-1,891546654,891546698,44,904,690,3.260869565217391
440,4,3,-1,891546698,891546895,197,690,328,3.4895833333333335
440,3,3,0,891546895,891547746,851,328,749,3.2777777777777777
440,3,5,2,891547746,891577843,30097,749,923,4.142857142857143
440,5,3,-2,891577843,891577919,76,923,582,3.7457627118644066
440,3,5,2,891577919,891577949,30,582,57,4.133333333333334
440,5,3,-2,891577949,891578059,110,57,512,3.888888888888889
440,3,4,1,891578059,891578226,167,512,1504,3.5
440,4,5,1,891578226,891578264,38,1504,921,3.611111111111111
440,5,4,-1,891578264,891578301,37,921,515,4.202898550724638
445,3,3,0,890987465,890987569,104,23,144,3.9545454545454546
445,3,2,-1,890987569,890987617,48,144,433,3.8035714285714284
445,2,2,0,890987617,890987655,38,433,195,3.9072164948453607
445,2,2,0,890987655,890987712,57,195,208,3.8125
445,2,4,2,890987712,890987742,30,208,79,3.956989247311828
445,4,2,-2,890987742,890987771,29,79,64,4.373737373737374
445,2,4,2,890987771,890987772,1,64,28,3.923076923076923
445,4,5,1,890987772,891035571,47799,28,340,3.7419354838709675
445,5,2,-3,891035571,891035897,326,340,895,3.142857142857143
445,2,1,-1,891035897,891199195,163298,895,302,4.133333333333334
445,1,2,1,891199195,891199274,79,302,330,2.625
445,2,2,0,891199274,891199331,57,330,879,3.2291666666666665
445,2,4,2,891199331,891199360,29,879,1591,2.5
445,4,1,-3,891199360,891199385,25,1591,343,3.0
445,1,1,0,891199385,891199458,73,343,748,3.1043478260869564
445,1,1,0,891199458,891199533,75,748,1601,1.0
445,1,2,1,891199533,891199655,122,1601,9,3.8878504672897196
445,2,2,0,891199655,891199715,60,9,50,4.306532663316583
445,2,1,-1,891199715,891199821,106,50,117,3.689189189189189
445,1,1,0,891199821,891199843,22,117,1012,3.2916666666666665
445,1,3,2,891199843,891199869,26,1012,276,3.6036036036036037
445,3,2,-1,891199869,891199906,37,276,237,3.7315436241610738
445,2,1,-1,891199906,891199945,39,237,93,3.5641025641025643
445,1,2,1,891199945,891199974,29,93,147,3.3142857142857145
445,2,4,2,891199974,891199994,20,147,1129,3.4444444444444446
445,4,2,-2,891199994,891200020,26,1129,591,3.7169811320754715
445,2,1,-1,891200020,891200078,58,591,7,3.76056338028169
445,1,1,0,891200078,891200137,59,7,123,3.297872340425532
445,1,1,0,891200137,891200164,27,123,410,3.0434782608695654
445,1,1,0,891200164,891200203,39,410,221,3.6923076923076925
445,1,1,0,891200203,891200233,30,221,919,4.0
445,1,2,1,891200233,891200272,39,919,458,3.0588235294117645
445,2,1,-1,891200272,891200320,48,458,1011,3.1
445,1,2,1,891200320,891200355,35,1011,1528,2.0
445,2,1,-1,891200355,891200390,35,1528,1245,2.3333333333333335
445,1,1,0,891200390,891200447,57,1245,1081,2.6666666666666665
445,1,2,1,891200447,891200506,59,1081,118,3.2764227642276422
445,2,2,0,891200506,891200592,86,118,871,2.3823529411764706
445,2,1,-1,891200592,891200624,32,871,829,2.4615384615384617
445,1,1,0,891200624,891200656,32,829,818,2.769230769230769
445,1,2,1,891200656,891200736,80,818,1277,3.5555555555555554
445,2,4,2,891200736,891200869,133,1277,151,3.6544117647058822
447,4,2,-2,878854011,878854120,109,300,260,2.4716981132075473
447,2,4,2,878854120,878854195,75,260,298,3.779220779220779
447,4,4,0,878854195,878854234,39,298,237,3.7315436241610738
447,4,3,-1,878854234,878854273,39,237,1,3.902439024390244
447,3,4,1,878854273,878854315,42,1,952,3.3529411764705883
447,4,3,-1,878854315,878854340,25,952,222,3.578125
447,3,5,2,878854340,878854481,141,222,1142,4.0476190476190474
447,5,3,-2,878854481,878854520,39,1142,24,3.3728813559322033
447,3,4,1,878854520,878854552,32,24,284,3.1547619047619047
447,4,4,0,878854552,878854578,26,284,118,3.2764227642276422
447,4,2,-2,878854578,878854579,1,118,1048,2.857142857142857
447,2,2,0,878854579,878854605,26,1048,235,3.106382978723404
447,2,5,3,878854605,878854630,25,235,13,3.5454545454545454
447,5,3,-2,878854630,878854658,28,13,815,3.135135135135135
447,3,4,1,878854658,878854678,20,815,147,3.3142857142857145
447,4,2,-2,878854678,878854704,26,147,546,2.9789473684210526
447,2,4,2,878854704,878854729,25,546,148,3.2131147540983607
447,4,3,-1,878854729,878854810,81,148,278,3.0357142857142856
447,3,4,1,878854810,878854838,28,278,760,2.35
447,4,3,-1,878854838,878854857,19,760,281,3.2
447,3,2,-1,878854857,878854918,61,281,1034,2.6
447,2,3,1,878854918,878854954,36,1034,111,3.5106382978723403
447,3,3,0,878854954,878854975,21,111,252,2.911392405063291
447,3,4,1,878854975,878854997,22,252,544,3.185185185185185
447,4,3,-1,878854997,878855021,24,544,597,3.2771084337349397
447,3,2,-1,878855021,878855082,61,597,866,3.3962264150943398
447,2,3,1,878855082,878855139,57,866,762,3.3962264150943398
447,3,3,0,878855139,878855165,26,762,823,2.75
447,3,2,-1,878855165,878855723,558,823,201,3.75
447,2,3,1,878855723,878855724,1,201,447,3.46875
447,3,4,1,878855724,878855782,58,447,234,3.7674418604651163
447,4,5,1,878855782,878855818,36,234,483,4.475609756097561
447,5,5,0,878855818,878855819,1,483,68,3.5714285714285716
447,5,3,-2,878855819,878855847,28,68,175,3.8354430379746836
447,3,4,1,878855847,878855873,26,175,98,4.240875912408759
447,4,3,-1,878855873,878855907,34,98,629,3.3333333333333335
447,3,5,2,878855907,878855963,56,629,963,3.9285714285714284
447,5,5,0,878855963,878855989,26,963,135,3.7974683544303796
447,5,3,-2,878855989,878856022,33,135,474,4.172413793103448
447,3,5,2,878856022,878856052,30,474,174,4.253521126760563
447,5,3,-2,878856052,878856110,58,174,79,3.956989247311828
447,3,3,0,878856110,878856172,62,79,559,3.477272727272727
447,3,4,1,878856172,878856208,36,559,470,3.72
447,4,3,-1,878856208,878856232,24,470,367,3.4242424242424243
447,3,2,-1,878856232,878856233,1,367,227,3.169811320754717
447,2,3,1,878856233,878856262,29,227,158,2.7027027027027026
447,3,4,1,878856262,878856290,28,158,282,3.610526315789474
447,4,5,1,878856290,878856394,104,282,183,3.951219512195122
447,5,4,-1,878856394,878856422,28,183,22,4.215909090909091
447,4,5,1,878856422,878856457,35,22,484,4.116279069767442
447,5,4,-1,878856457,878856458,1,484,204,3.6744186046511627
447,4,4,0,878856458,878856526,68,204,31,3.642857142857143
447,4,4,0,878856526,878856549,23,31,91,3.6
447,4,2,-2,878856549,878856573,24,91,716,3.1904761904761907
447,2,3,1,878856573,878856601,28,716,27,3.235294117647059
447,3,3,0,878856601,878856602,1,27,1046,3.3529411764705883
447,3,5,2,878856602,878856625,23,1046,156,4.017857142857143
449,3,5,2,879958474,879958572,98,333,285,4.181818181818182
449,5,4,-1,879958572,879958624,52,285,9,3.8878504672897196
449,4,4,0,879958624,879958664,40,9,1010,3.611111111111111
449,4,4,0,879958664,879958685,21,1010,1011,3.1
449,4,5,1,879958685,879958705,20,1011,276,3.6036036036036037
449,5,5,0,879958705,879958721,16,276,936,3.727272727272727
449,5,4,-1,879958721,879958803,82,936,459,3.875
449,4,5,1,879958803,879958866,63,459,137,3.9545454545454546
449,5,4,-1,879958866,879958888,22,137,248,3.746268656716418
449,4,3,-1,879958888,879958936,48,248,106,2.8125
449,3,4,1,879958936,879958976,40,106,1367,4.0
449,4,3,-1,879958976,879959023,47,1367,544,3.185185185185185
449,3,3,0,879959023,879959082,59,544,288,3.5214285714285714
449,3,4,1,879959082,879959101,19,288,593,4.0
449,4,4,0,879959101,879959152,51,593,244,2.9411764705882355
449,4,2,-2,879959152,879959246,94,244,291,3.2
449,2,2,0,879959246,879959273,27,291,748,3.1043478260869564
449,2,5,3,879959273,880410674,451401,748,462,3.7954545454545454
449,5,5,0,880410674,880410700,26,462,639,4.083333333333333
449,5,4,-1,880410700,880410701,1,639,971,4.0
449,4,5,1,880410701,880410734,33,971,1005,4.166666666666667
449,5,4,-1,880410734,880410777,43,1005,381,3.2758620689655173
449,4,5,1,880410777,880410801,24,381,1404,3.875
449,5,3,-2,880410801,880410951,150,1404,310,3.6666666666666665
450,3,4,1,882216026,882216108,82,689,270,3.7804878048780486
450,4,4,0,882216108,882216178,70,270,340,3.7419354838709675
450,4,4,0,882216178,882370410,154232,340,748,3.1043478260869564
450,4,3,-1,882370410,882370464,54,748,336,2.4
450,3,3,0,882370464,882370581,117,336,264,2.65
450,3,5,2,882370581,882371415,834,264,427,4.2025316455696204
450,5,1,-4,882371415,882371416,1,427,214,3.272727272727273
450,1,4,3,882371416,882371526,110,214,479,4.25
450,4,4,0,882371526,882371645,119,479,56,4.051724137931035
450,4,4,0,882371645,882371732,87,56,98,4.240875912408759
450,4,5,1,882371732,882371904,172,98,523,4.159090909090909
450,5,4,-1,882371904,882372027,123,523,83,4.204081632653061
450,4,4,0,882372027,882372103,76,83,1401,3.0
450,4,5,1,882372103,882372178,75,1401,511,4.096153846153846
450,5,5,0,882372178,882373088,910,511,485,3.717948717948718
450,5,5,0,882373088,882373155,67,485,127,4.162790697674419
450,5,5,0,882373155,882373231,76,127,1172,3.4
450,5,3,-2,882373231,882373297,66,1172,491,3.55
450,3,4,1,882373297,882373385,88,491,845,3.661290322580645
450,4,2,-2,882373385,882373464,79,845,123,3.297872340425532
450,2,4,2,882373464,882373531,67,123,205,3.717391304347826
450,4,5,1,882373531,882373597,66,205,187,4.215189873417722
450,5,4,-1,882373597,882373656,59,187,705,3.7857142857142856
450,4,5,1,882373656,882373657,1,705,216,3.8454545454545452
450,5,4,-1,882373657,882373724,67,216,692,3.56
450,4,5,1,882373724,882373786,62,692,490,3.5454545454545454
450,5,5,0,882373786,882373865,79,490,211,3.958904109589041
450,5,2,-3,882373865,882373928,63,211,553,3.5
450,2,5,3,882373928,882373994,66,553,967,3.3333333333333335
450,5,4,-1,882373994,882373995,1,967,618,3.5
450,4,5,1,882373995,882374059,64,618,87,3.9
450,5,4,-1,882374059,882374134,75,87,685,3.2666666666666666
450,4,5,1,882374134,882374217,83,685,659,4.027777777777778
450,5,4,-1,882374217,882374332,115,659,435,3.8933333333333335
450,4,5,1,882374332,882374422,90,435,132,3.929411764705882
450,5,3,-2,882374422,882376282,1860,132,367,3.4242424242424243
450,3,4,1,882376282,882376365,83,367,1020,3.727272727272727
450,4,4,0,882376365,882376446,81,1020,61,4.190476190476191
450,4,4,0,882376446,882376584,138,61,969,3.8947368421052633
450,4,3,-1,882376584,882376585,1,969,140,3.238095238095238
450,3,5,2,882376585,882376658,73,140,151,3.6544117647058822
450,5,4,-1,882376658,882376803,145,151,125,3.5555555555555554
450,4,3,-1,882376803,882376885,82,125,65,3.511111111111111
450,3,4,1,882376885,882377479,594,65,614,3.727272727272727
450,4,5,1,882377479,882377590,111,614,504,4.085714285714285
450,5,4,-1,882377590,882377653,63,504,655,3.7857142857142856
450,4,3,-1,882377653,882377726,73,655,273,3.5238095238095237
450,3,4,1,882377726,882394180,16454,273,521,3.787878787878788
450,4,4,0,882394180,882394251,71,521,631,3.581818181818182
450,4,4,0,882394251,882395166,915,631,747,3.5526315789473686
450,4,5,1,882395166,882395167,1,747,736,4.083333333333333
450,5,4,-1,882395167,882395662,495,736,637,2.888888888888889
450,4,3,-1,882395662,882395778,116,637,713,3.5
450,3,5,2,882395778,882395779,1,713,416,3.3846153846153846
450,5,5,0,882395779,882395913,134,416,162,3.4651162790697674
450,5,4,-1,882395913,882395914,1,162,662,3.4583333333333335
450,4,4,0,882395914,882396050,136,662,792,3.793103448275862
450,4,5,1,882396050,882396051,1,792,215,3.662921348314607
450,5,4,-1,882396051,882396153,102,215,471,3.5714285714285716
450,4,3,-1,882396153,882396352,199,471,1112,2.9
450,3,3,0,882396352,882396489,137,1112,366,3.4285714285714284
450,3,5,2,882396489,882396564,75,366,516,4.055555555555555
450,5,4,-1,882396564,882396565,1,516,866,3.3962264150943398
450,4,4,0,882396565,882396928,363,866,462,3.7954545454545454
450,4,5,1,882396928,882397223,295,462,1153,4.666666666666667
450,5,4,-1,882397223,882397373,150,1153,117,3.689189189189189
450,4,4,0,882397373,882397939,566,117,568,3.5853658536585367
450,4,4,0,882397939,882397940,1,568,629,3.3333333333333335
450,4,5,1,882397940,882398083,143,629,33,3.2941176470588234
450,5,5,0,882398083,882398084,1,33,1220,2.9166666666666665
450,5,5,0,882398084,882398312,228,1220,609,3.7058823529411766
450,5,4,-1,882398312,882398666,354,609,696,3.138888888888889
450,4,4,0,882398666,882398770,104,696,66,3.4705882352941178
450,4,5,1,882398770,882398939,169,66,380,3.4878048780487805
450,5,3,-2,882398939,882398940,1,380,756,2.6885245901639343
450,3,4,1,882398940,882399508,568,756,951,2.6666666666666665
450,4,4,0,882399508,882399509,1,951,290,3.108108108108108
450,4,4,0,882399509,882399664,155,290,1421,3.2
450,4,3,-1,882399664,882399818,154,1421,723,3.5384615384615383
450,3,3,0,882399818,882467991,68173,723,422,3.25
450,3,4,1,882467991,882468047,56,422,102,3.3684210526315788
450,4,4,0,882468047,882468239,192,102,399,3.317073170731707
450,4,2,-2,882468239,882468307,68,399,112,2.7
450,2,3,1,882468307,882468401,94,112,1033,3.0
450,3,1,-2,882468401,882468789,388,1033,1030,2.3636363636363638
450,1,2,1,882468789,882468790,1,1030,35,1.75
450,2,3,1,882468790,882468931,141,35,710,3.41025641025641
450,3,4,1,882468931,882469166,235,710,716,3.1904761904761907
450,4,4,0,882469166,882469250,84,716,1028,2.857142857142857
450,4,4,0,882469250,882469306,56,1028,476,3.1216216216216215
450,4,1,-3,882469306,882469863,557,476,700,2.7142857142857144
450,1,2,1,882469863,882469941,78,700,396,2.84
450,2,3,1,882469941,882471524,1583,396,384,2.7941176470588234
450,3,2,-1,882471524,882471604,80,384,571,2.5
450,2,4,2,882471604,882472144,540,571,714,3.6
450,4,5,1,882472144,882472306,162,714,557,3.090909090909091
450,5,4,-1,882472306,882473826,1520,557,686,3.9
450,4,4,0,882473826,882473914,88,686,583,3.4285714285714284
450,4,4,0,882473914,882473915,1,583,550,3.272727272727273
450,4,4,0,882473915,882474001,86,550,405,3.25
450,4,5,1,882474001,882812349,338348,405,136,3.764705882352941
450,5,2,-3,882812349,882812495,146,136,821,3.076923076923077
450,2,4,2,882812495,882812635,140,821,1297,3.0
450,4,3,-1,882812635,882812636,1,1297,535,3.380952380952381
450,3,3,0,882812636,882812821,185,535,1249,3.2
450,3,5,2,882812821,886612330,3799509,1249,1160,4.1
450,5,5,0,886612330,887135833,523503,1160,611,4.384615384615385
450,5,4,-1,887135833,887136016,183,611,1303,2.857142857142857
450,4,5,1,887136016,887136083,67,1303,520,4.136363636363637
450,5,4,-1,887136083,887136139,56,520,865,2.6666666666666665
450,4,4,0,887136139,887138820,2681,865,54,3.3714285714285714
450,4,4,0,887138820,887139019,199,54,546,2.9789473684210526
450,4,4,0,887139019,887139080,61,546,43,3.1
450,4,4,0,887139080,887139143,63,43,77,3.3857142857142857
450,4,3,-1,887139143,887139594,451,77,1284,2.5454545454545454
450,3,4,1,887139594,887139728,134,1284,570,3.526315789473684
450,4,3,-1,887139728,887139729,1,570,823,2.75
450,3,4,1,887139729,887139844,115,823,1044,3.2777777777777777
450,4,5,1,887139844,887660503,520659,1044,648,3.9545454545454546
450,5,4,-1,887660503,887660504,1,648,287,3.4516129032258065
450,4,4,0,887660504,887660650,146,287,739,3.391304347826087
450,4,4,0,887660650,887660722,72,739,510,3.823529411764706
450,4,4,0,887660722,887660762,40,510,660,3.71875
450,4,4,0,887660762,887660763,1,660,91,3.6
450,4,4,0,887660763,887660820,57,91,1226,3.5454545454545454
450,4,3,-1,887660820,887661961,1141,1226,371,3.0
450,3,3,0,887661961,887662002,41,371,231,2.938775510204082
450,3,3,0,887662002,887662083,81,231,254,2.7419354838709675
450,3,3,0,887662083,887834953,172870,254,259,2.492063492063492
450,3,5,2,887834953,887835352,399,259,142,3.1481481481481484
450,5,3,-2,887835352,887835408,56,142,210,3.921259842519685
450,3,4,1,887835408,892141807,4306399,210,749,3.2777777777777777
450,4,4,0,892141807,892141986,179,749,245,3.056179775280899
446,5,3,-2,879786838,879786892,54,292,307,3.6031746031746033
446,3,2,-1,879786892,879786943,51,307,880,2.8421052631578947
446,2,3,1,879786943,879786984,41,880,289,2.988888888888889
446,3,3,0,879786984,879787149,165,289,332,3.6511627906976742
446,3,1,-2,879787149,879787859,710,332,888,3.0
439,3,5,2,882892705,882892755,50,100,276,3.6036036036036037
439,5,4,-1,882892755,882892818,63,276,591,3.7169811320754715
439,4,3,-1,882892818,882893220,402,591,475,3.956043956043956
439,3,5,2,882893220,882893245,25,475,14,4.101694915254237
439,5,5,0,882893245,882893291,46,14,1600,4.0
439,5,4,-1,882893291,882893323,32,1600,405,3.25
439,4,3,-1,882893323,882893688,365,405,125,3.5555555555555554
439,3,4,1,882893688,882893737,49,125,147,3.3142857142857145
439,4,2,-2,882893737,882893768,31,147,121,3.521212121212121
439,2,3,1,882893768,882893859,91,121,282,3.610526315789474
439,3,4,1,882893859,882893891,32,282,1328,4.0
439,4,4,0,882893891,882894084,193,1328,290,3.108108108108108
451,1,4,3,879012343,879012382,39,286,690,3.260869565217391
451,4,5,1,879012382,879012431,49,690,331,3.5517241379310347
451,5,5,0,879012431,879012470,39,331,328,3.4895833333333335
451,5,4,-1,879012470,879012471,1,328,877,2.619047619047619
451,4,5,1,879012471,879012510,39,877,678,2.8181818181818183
451,5,4,-1,879012510,879012550,40,678,300,3.6861313868613137
451,4,4,0,879012550,879012580,30,300,327,3.5076923076923077
451,4,3,-1,879012580,879012604,24,327,264,2.65
451,3,1,-2,879012604,879012647,43,264,262,3.5217391304347827
451,1,2,1,879012647,879012648,1,262,303,3.75
451,2,4,2,879012648,879012684,36,303,270,3.7804878048780486
451,4,3,-1,879012684,879012685,1,270,1296,3.2222222222222223
451,3,4,1,879012685,879012721,36,1296,329,3.25
451,4,4,0,879012721,879012772,51,329,938,2.5555555555555554
451,4,3,-1,879012772,879012773,1,938,1025,2.95
451,3,1,-2,879012773,879012811,38,1025,878,2.0
451,1,2,1,879012811,879012812,1,878,1393,2.6666666666666665
451,2,2,0,879012812,879012857,45,1393,337,2.0
451,2,4,2,879012857,879012858,1,337,1022,3.727272727272727
451,4,1,-3,879012858,879012889,31,1022,1038,2.6
451,1,3,2,879012889,879012890,1,1038,948,2.2962962962962963
452,4,3,-1,875261261,875261350,89,170,615,3.8333333333333335
452,3,4,1,875261350,875261747,397,615,515,4.202898550724638
452,4,4,0,875261747,875261819,72,515,156,4.017857142857143
452,4,2,-2,875261819,875263068,1249,156,237,3.7315436241610738
452,2,5,3,875263068,875263244,176,237,483,4.475609756097561
452,5,4,-1,875263244,875263413,169,483,174,4.253521126760563
452,4,2,-2,875263413,875264432,1019,174,432,3.719298245614035
452,2,4,2,875264432,875264491,59,432,275,4.087912087912088
452,4,2,-2,875264491,875264826,335,275,152,3.6785714285714284
452,2,4,2,875264826,875264976,150,152,427,4.2025316455696204
452,4,4,0,875264976,875265114,138,427,195,3.9072164948453607
452,4,2,-2,875265114,875265368,254,195,842,3.0
452,2,4,2,875265368,875265446,78,842,45,4.130434782608695
452,4,4,0,875265446,875266518,1072,45,64,4.373737373737374
452,4,5,1,875266518,875266680,162,64,607,4.136363636363637
452,5,3,-2,875266680,875273415,6735,607,71,3.6575342465753424
452,3,2,-1,875273415,875273543,128,71,654,4.119047619047619
452,2,2,0,875273543,875273544,1,654,504,4.085714285714285
452,2,2,0,875273544,875273609,65,504,1109,3.4545454545454546
452,2,4,2,875273609,875275700,2091,1109,418,3.825
452,4,3,-1,875275700,875275815,115,418,204,3.6744186046511627
452,3,2,-1,875275815,875276006,191,204,969,3.8947368421052633
452,2,3,1,875276006,875276081,75,969,506,3.566666666666667
452,3,2,-1,875276081,875559910,283829,506,25,3.3185840707964602
452,2,4,2,875559910,875560019,109,25,971,4.0
452,4,2,-2,875560019,875560067,48,971,624,3.0
452,2,4,2,875560067,875560068,1,624,660,3.71875
452,4,4,0,875560068,875560150,82,660,1204,4.0
452,4,2,-2,875560150,875560255,105,1204,132,3.929411764705882
452,2,4,2,875560255,875560300,45,132,180,3.9473684210526314
452,4,4,0,875560300,875561978,1678,180,404,3.6578947368421053
452,4,3,-1,875561978,875562062,84,404,530,4.125
452,3,3,0,875562062,875562159,97,530,625,3.25
452,3,3,0,875562159,875562198,39,625,614,3.727272727272727
452,3,3,0,875562198,875562245,47,614,554,2.9555555555555557
452,3,4,1,875562245,875562374,129,554,609,3.7058823529411766
452,4,4,0,875562374,875562410,36,609,76,3.1875
452,4,4,0,875562410,875562441,31,76,805,3.909090909090909
452,4,4,0,875562441,875562475,34,805,510,3.823529411764706
452,4,3,-1,875562475,875562510,35,510,420,3.5652173913043477
452,3,3,0,875562510,875562573,63,420,371,3.0
452,3,4,1,875562573,875562645,72,371,526,3.909090909090909
452,4,2,-2,875562645,875562903,258,526,290,3.108108108108108
452,2,3,1,875562903,875562997,94,290,77,3.3857142857142857
452,3,2,-1,875562997,875563050,53,77,576,3.125
452,2,2,0,875563050,875563098,48,576,62,3.048780487804878
452,2,1,-1,875563098,875875685,312587,62,201,3.75
452,1,1,0,875875685,876215773,340088,201,1013,2.388888888888889
452,1,1,0,876215773,876215899,126,1013,1089,2.1363636363636362
452,1,5,4,876215899,876299004,83105,1089,191,4.168674698795181
452,5,3,-2,876299004,885490812,9191808,191,83,4.204081632653061
452,3,1,-2,885490812,885490917,105,83,276,3.6036036036036037
452,1,3,2,885490917,885491030,113,276,467,4.071428571428571
452,3,5,2,885491030,885544110,53080,467,423,3.7016129032258065
452,5,5,0,885544110,885816769,272659,423,48,4.055555555555555
452,5,4,-1,885816769,885816884,115,48,66,3.4705882352941178
452,4,5,1,885816884,885816915,31,66,7,3.76056338028169
452,5,5,0,885816915,885816916,1,7,597,3.2771084337349397
452,5,2,-3,885816916,885817844,928,597,502,3.272727272727273
452,2,4,2,885817844,885817937,93,502,856,4.142857142857143
452,4,4,0,885817937,887719030,1901093,856,419,3.8208955223880596
452,4,3,-1,887719030,887719158,128,419,265,3.710144927536232
452,3,5,2,887719158,887890364,171206,265,792,3.793103448275862
452,5,5,0,887890364,888492838,602474,792,70,3.5833333333333335
452,5,5,0,888492838,888568251,75413,70,269,4.085106382978723
452,5,1,-4,888568251,888568349,98,269,94,2.8823529411764706
452,1,4,3,888568349,888568464,115,94,631,3.581818181818182
452,4,3,-1,888568464,888568714,250,631,781,3.4166666666666665
454,4,4,0,881958362,881958402,40,326,258,3.7547169811320753
454,4,3,-1,881958402,881958428,26,258,327,3.5076923076923077
454,3,4,1,881958428,881958464,36,327,310,3.6666666666666665
454,4,4,0,881958464,881958551,87,310,748,3.1043478260869564
454,4,4,0,881958551,881958606,55,748,259,2.492063492063492
454,4,2,-2,881958606,881958782,176,259,873,2.7586206896551726
454,2,2,0,881958782,881958783,1,873,323,3.0
454,2,4,2,881958783,881959276,493,323,257,3.7154471544715446
454,4,2,-2,881959276,881959336,60,257,252,2.911392405063291
454,2,3,1,881959336,881959437,101,252,1190,3.4285714285714284
454,3,3,0,881959437,881959468,31,1190,687,2.1481481481481484
454,3,4,1,881959468,881959607,139,687,423,3.7016129032258065
454,4,4,0,881959607,881959652,45,423,480,4.283018867924528
454,4,4,0,881959652,881959698,46,480,526,3.909090909090909
454,4,3,-1,881959698,881959745,47,526,136,3.764705882352941
454,3,2,-1,881959745,881959778,33,136,746,3.7560975609756095
454,2,3,1,881959778,881959844,66,746,357,4.063291139240507
454,3,3,0,881959844,881959876,32,357,657,4.341463414634147
454,3,4,1,881959876,881959917,41,657,215,3.662921348314607
454,4,2,-2,881959917,881959960,43,215,277,3.6
454,2,4,2,881959960,881959961,1,277,197,4.112676056338028
454,4,4,0,881959961,881959991,30,197,479,4.25
454,4,4,0,881959991,881960029,38,479,1063,3.642857142857143
454,4,4,0,881960029,881960083,54,1063,79,3.956989247311828
454,4,3,-1,881960083,881960145,62,79,632,3.9523809523809526
454,3,3,0,881960145,881960173,28,632,511,4.096153846153846
454,3,2,-1,881960173,881960174,1,511,530,4.125
454,2,2,0,881960174,881960230,56,530,509,3.7058823529411766
454,2,3,1,881960230,881960265,35,509,507,3.6285714285714286
454,3,2,-1,881960265,881960266,1,507,842,3.0
454,2,4,2,881960266,881960296,30,842,87,3.9
454,4,3,-1,881960296,881960330,34,87,131,3.731707317073171
454,3,4,1,881960330,881960361,31,131,237,3.7315436241610738
454,4,3,-1,881960361,881960385,24,237,486,3.9565217391304346
454,3,3,0,881960385,881960413,28,486,199,4.191489361702128
454,3,3,0,881960413,881960445,32,199,484,4.116279069767442
454,3,2,-1,881960445,881960446,1,484,1003,2.8
454,2,4,2,881960446,881960504,58,1003,204,3.6744186046511627
454,4,3,-1,881960504,888015988,6055484,204,1105,3.0
454,3,4,1,888015988,888266565,250577,1105,487,4.043478260869565
454,4,4,0,888266565,888266600,35,487,96,3.9130434782608696
454,4,3,-1,888266600,888266601,1,96,1035,3.03125
454,3,4,1,888266601,888266643,42,1035,174,4.253521126760563
454,4,3,-1,888266643,888266685,42,174,182,3.842857142857143
454,3,4,1,888266685,888266724,39,182,191,4.168674698795181
454,4,2,-2,888266724,888266754,30,191,490,3.5454545454545454
454,2,3,1,888266754,888266785,31,490,222,3.578125
454,3,3,0,888266785,888266810,25,222,385,3.6129032258064515
454,3,2,-1,888266810,888266874,64,385,132,3.929411764705882
454,2,4,2,888266874,888266906,32,132,568,3.5853658536585367
454,4,2,-2,888266906,888266907,1,568,1454,3.0
454,2,2,0,888266907,888266955,48,1454,1126,3.625
454,2,2,0,888266955,888266991,36,1126,1299,2.5
454,2,2,0,888266991,888267028,37,1299,659,4.027777777777778
454,2,1,-1,888267028,888267086,58,659,111,3.5106382978723403
454,1,5,4,888267086,888267158,72,111,692,3.56
454,5,2,-3,888267158,888267198,40,692,968,3.75
454,2,2,0,888267198,888267226,28,968,414,3.3076923076923075
454,2,1,-1,888267226,888267279,53,414,961,3.4545454545454546
454,1,2,1,888267279,888267280,1,961,686,3.9
454,2,2,0,888267280,888267315,35,686,693,3.6285714285714286
454,2,3,1,888267315,888267343,28,693,465,3.75
454,3,2,-1,888267343,888267387,44,465,735,3.58
454,2,2,0,888267387,888267419,32,735,275,4.087912087912088
454,2,2,0,888267419,888267521,102,275,1203,4.0
454,2,3,1,888267521,888267559,38,1203,498,4.290909090909091
454,3,3,0,888267559,888267590,31,498,614,3.727272727272727
454,3,2,-1,888267590,888267617,27,614,55,4.051282051282051
454,2,2,0,888267617,888267643,26,55,631,3.581818181818182
453,5,3,-2,877552514,877552540,26,475,456,2.2
453,3,5,2,877552540,877552564,24,456,276,3.6036036036036037
453,5,5,0,877552564,877552590,26,276,246,4.0
453,5,5,0,877552590,877552612,22,246,100,4.0162162162162165
453,5,4,-1,877552612,877552641,29,100,298,3.779220779220779
453,4,4,0,877552641,877552678,37,298,273,3.5238095238095237
453,4,4,0,877552678,877552717,39,273,3,3.0625
453,4,4,0,877552717,877552872,155,3,25,3.3185840707964602
453,4,4,0,877552872,877552951,79,25,410,3.0434782608695654
453,4,2,-2,877552951,877553051,100,410,369,2.5714285714285716
453,2,4,2,877553051,877553221,170,369,763,3.347826086956522
453,4,2,-2,877553221,877553302,81,763,412,2.272727272727273
453,2,1,-1,877553302,877553430,128,412,826,2.5555555555555554
453,1,3,2,877553430,877553532,102,826,122,2.282608695652174
453,3,1,-2,877553532,877553678,146,122,120,2.3421052631578947
453,1,4,3,877553678,877553708,30,120,168,4.0476190476190474
453,4,4,0,877553708,877553761,53,168,318,4.5046728971962615
453,4,4,0,877553761,877553850,89,318,509,3.7058823529411766
453,4,5,1,877553850,877553870,20,509,22,4.215909090909091
453,5,3,-2,877553870,877553999,129,22,655,3.7857142857142856
453,3,5,2,877553999,877554301,302,655,42,3.893617021276596
453,5,3,-2,877554301,877554419,118,42,215,3.662921348314607
453,3,4,1,877554419,877554443,24,215,144,3.9545454545454546
453,4,4,0,877554443,877554466,23,144,186,3.905263157894737
453,4,4,0,877554466,877554490,24,186,4,3.5538461538461537
453,4,4,0,877554490,877554564,74,4,174,4.253521126760563
453,4,4,0,877554564,877554587,23,174,210,3.921259842519685
453,4,4,0,877554587,877554647,60,210,69,3.8015873015873014
453,4,4,0,877554647,877554704,57,69,204,3.6744186046511627
453,4,4,0,877554704,877554743,39,204,651,3.8627450980392157
453,4,5,1,877554743,877554771,28,651,56,4.051724137931035
453,5,4,-1,877554771,877554819,48,56,423,3.7016129032258065
453,4,4,0,877554819,877554846,27,423,184,3.393939393939394
453,4,3,-1,877554846,877554871,25,184,132,3.929411764705882
453,3,5,2,877554871,877554908,37,132,156,4.017857142857143
453,5,3,-2,877554908,877554927,19,156,239,3.423076923076923
453,3,3,0,877554927,877561214,6287,239,226,3.378787878787879
453,3,4,1,877561214,877561235,21,226,697,2.7777777777777777
453,4,2,-2,877561235,877561258,23,697,1273,2.5714285714285716
453,2,3,1,877561258,877561301,43,1273,85,3.3157894736842106
453,3,3,0,877561301,877561349,48,85,125,3.5555555555555554
453,3,4,1,877561349,877561382,33,125,282,3.610526315789474
453,4,4,0,877561382,877561411,29,282,68,3.5714285714285716
453,4,3,-1,877561411,877561522,111,68,780,3.08
453,3,3,0,877561522,877561593,71,780,566,3.543859649122807
453,3,3,0,877561593,877561694,101,566,82,3.6741573033707864
453,3,3,0,877561694,877561695,1,82,732,3.6266666666666665
453,3,2,-1,877561695,877561713,18,732,552,2.8095238095238093
453,2,2,0,877561713,877561836,123,552,451,3.207792207792208
453,2,3,1,877561836,877561894,58,451,53,2.9523809523809526
453,3,1,-2,877561894,877561911,17,53,1032,2.7142857142857144
453,1,3,2,877561911,877561942,31,1032,90,3.0
453,3,4,1,877561942,877562071,129,90,288,3.5214285714285714
453,4,3,-1,877562071,877562135,64,288,1170,3.1666666666666665
453,3,2,-1,877562135,877562293,158,1170,254,2.7419354838709675
453,2,5,3,877562293,877562313,20,254,50,4.306532663316583
453,5,2,-3,877562313,887941962,10379649,50,93,3.5641025641025643
453,2,3,1,887941962,887942025,63,93,628,3.573529411764706
453,3,1,-2,887942025,887942484,459,628,1079,2.1923076923076925
453,1,2,1,887942484,888202271,259787,1079,1230,1.8888888888888888
453,2,4,2,888202271,888202307,36,1230,963,3.9285714285714284
453,4,4,0,888202307,888203066,759,963,496,4.094594594594595
453,4,4,0,888203066,888203147,81,496,223,4.108695652173913
453,4,3,-1,888203147,888205588,2441,223,99,3.8392857142857144
453,3,2,-1,888205588,888205711,123,99,384,2.7941176470588234
453,2,3,1,888205711,888205764,53,384,578,3.066666666666667
453,3,2,-1,888205764,888205783,19,578,80,2.967741935483871
453,2,2,0,888205783,888205866,83,80,356,3.2
453,2,4,2,888205866,888205882,16,356,67,3.106382978723404
453,4,2,-2,888205882,888205937,55,67,158,2.7027027027027026
453,2,2,0,888205937,888206003,66,158,233,3.323529411764706
453,2,3,1,888206003,888206022,19,233,781,3.4166666666666665
453,3,3,0,888206022,888206038,16,781,401,2.6774193548387095
453,3,2,-1,888206038,888206053,15,401,143,3.56
453,2,2,0,888206053,888206132,79,143,416,3.3846153846153846
453,2,2,0,888206132,888206219,87,416,229,3.185185185185185
453,2,1,-1,888206219,888206233,14,229,871,2.3823529411764706
453,1,2,1,888206233,888206467,234,871,717,2.9696969696969697
453,2,2,0,888206467,888206492,25,717,1145,2.6666666666666665
453,2,2,0,888206492,888206576,84,1145,1157,3.142857142857143
453,2,1,-1,888206576,888206630,54,1157,1037,2.0
453,1,3,2,888206630,888206676,46,1037,364,2.8095238095238093
453,3,2,-1,888206676,888206768,92,364,453,2.0
453,2,3,1,888206768,888207162,394,453,393,3.5125
414,5,3,-2,884998972,884998993,21,270,264,2.65
414,3,5,2,884998993,884999037,44,264,346,3.5128205128205128
414,5,4,-1,884999037,884999066,29,346,300,3.6861313868613137
414,4,4,0,884999066,884999127,61,300,324,3.2291666666666665
414,4,2,-2,884999127,884999128,1,324,294,3.1052631578947367
414,2,3,1,884999128,884999147,19,294,748,3.1043478260869564
414,3,4,1,884999147,884999170,23,748,895,3.142857142857143
414,4,4,0,884999170,884999286,116,895,886,2.857142857142857
414,4,5,1,884999286,884999394,108,886,433,3.8035714285714284
414,5,5,0,884999394,884999439,45,433,100,4.0162162162162165
455,3,4,1,878585277,878585321,44,323,270,3.7804878048780486
455,4,3,-1,878585321,878585409,88,270,304,3.5306122448979593
455,3,5,2,878585409,878585826,417,304,50,4.306532663316583
455,5,3,-2,878585826,879108829,523003,50,620,3.0
455,3,4,1,879108829,879108892,63,620,1160,4.1
455,4,3,-1,879108892,879108997,105,1160,1265,2.75
455,3,4,1,879108997,879109069,72,1265,475,3.956043956043956
455,4,4,0,879109069,879109110,41,475,293,3.630434782608696
455,4,3,-1,879109110,879109133,23,293,125,3.5555555555555554
455,3,4,1,879109133,879109594,461,125,276,3.6036036036036037
455,4,3,-1,879109594,879109664,70,276,282,3.610526315789474
455,3,4,1,879109664,879109692,28,282,628,3.573529411764706
455,4,4,0,879109692,879109733,41,628,118,3.2764227642276422
455,4,3,-1,879109733,879109764,31,118,405,3.25
455,3,3,0,879109764,879109881,117,405,744,3.5714285714285716
455,3,4,1,879109881,879109923,42,744,591,3.7169811320754715
455,4,3,-1,879109923,879109966,43,591,250,3.4698795180722892
455,3,3,0,879109966,879109984,18,250,291,3.2
455,3,3,0,879109984,879110123,139,291,597,3.2771084337349397
455,3,3,0,879110123,879110154,31,597,924,3.3703703703703702
455,3,3,0,879110154,879110260,106,924,934,3.0294117647058822
455,3,3,0,879110260,879110281,21,934,281,3.2
455,3,3,0,879110281,879110346,65,281,148,3.2131147540983607
455,3,4,1,879110346,879110544,198,148,435,3.8933333333333335
455,4,4,0,879110544,879110573,29,435,504,4.085714285714285
455,4,2,-2,879110573,879110767,194,504,1028,2.857142857142857
455,2,3,1,879110767,879110818,51,1028,252,2.911392405063291
455,3,4,1,879110818,879110870,52,252,694,4.277777777777778
455,4,3,-1,879110870,879110905,35,694,87,3.9
455,3,5,2,879110905,879110971,66,87,511,4.096153846153846
455,5,5,0,879110971,879111057,86,511,197,4.112676056338028
455,5,5,0,879111057,879111092,35,197,200,3.8157894736842106
455,5,3,-2,879111092,879111123,31,200,12,4.358974358974359
455,3,4,1,879111123,879111153,30,12,447,3.46875
455,4,4,0,879111153,879111213,60,447,7,3.76056338028169
455,4,3,-1,879111213,879111249,36,7,692,3.56
455,3,4,1,879111249,879111268,19,692,428,3.744186046511628
455,4,4,0,879111268,879111318,50,428,518,3.5833333333333335
455,4,3,-1,879111318,879111345,27,518,117,3.689189189189189
455,3,4,1,879111345,879111371,26,117,28,3.923076923076923
455,4,3,-1,879111371,879111396,25,28,65,3.511111111111111
455,3,5,2,879111396,879111422,26,65,191,4.168674698795181
455,5,4,-1,879111422,879111453,31,191,213,3.943396226415094
455,4,4,0,879111453,879111454,1,213,939,3.6333333333333333
455,4,4,0,879111454,879111528,74,939,584,3.5238095238095237
455,4,4,0,879111528,879111554,26,584,223,4.108695652173913
455,4,5,1,879111554,879111586,32,223,127,4.162790697674419
455,5,3,-2,879111586,879111705,119,127,1136,3.3076923076923075
455,3,3,0,879111705,879111786,81,1136,4,3.5538461538461537
455,3,4,1,879111786,879111808,22,4,241,3.5625
455,4,4,0,879111808,879111862,54,241,183,3.951219512195122
455,4,3,-1,879111862,879111907,45,183,385,3.6129032258064515
455,3,4,1,879111907,879111937,30,385,69,3.8015873015873014
455,4,3,-1,879111937,879111960,23,69,176,3.967032967032967
455,3,2,-1,879111960,879111982,22,176,582,3.7457627118644066
455,2,4,2,879111982,879112011,29,582,942,3.4545454545454546
455,4,4,0,879112011,879112054,43,942,172,4.225225225225225
455,4,3,-1,879112054,879112098,44,172,71,3.6575342465753424
455,3,3,0,879112098,879112122,24,71,214,3.272727272727273
455,3,4,1,879112122,879112298,176,214,568,3.5853658536585367
455,4,4,0,879112298,879112320,22,568,549,3.4871794871794872
455,4,4,0,879112320,879112356,36,549,402,3.3076923076923075
455,4,4,0,879112356,879112377,21,402,79,3.956989247311828
455,4,1,-3,879112377,879112415,38,79,53,2.9523809523809526
455,1,5,4,879112415,879112436,21,53,97,3.7282608695652173
455,5,3,-2,879112436,879112460,24,97,736,4.083333333333333
455,3,3,0,879112460,879112561,101,736,727,3.5517241379310347
455,3,4,1,879112561,879112582,21,727,449,2.9069767441860463
455,4,3,-1,879112582,879112654,72,449,380,3.4878048780487805
455,3,3,0,879112654,879112678,24,380,465,3.75
455,3,4,1,879112678,879112700,22,465,550,3.272727272727273
455,4,4,0,879112700,882141385,3028685,550,508,3.6923076923076925
455,4,3,-1,882141385,882141582,197,508,279,2.75
455,3,3,0,882141582,882141702,120,279,1171,2.857142857142857
455,3,2,-1,882141702,884027240,1885538,1171,255,3.2027027027027026
444,5,4,-1,890246907,890246940,33,306,313,4.323076923076923
444,4,4,0,890246940,890247172,232,313,751,3.3896103896103895
444,4,5,1,890247172,890247287,115,751,50,4.306532663316583
444,5,5,0,890247287,890247385,98,50,100,4.0162162162162165
444,5,2,-3,890247385,891978807,1731422,100,1483,3.25
444,2,3,1,891978807,891979403,596,1483,916,3.3333333333333335
448,5,5,0,891887216,891887337,121,896,302,4.133333333333334
448,5,2,-3,891887337,891887393,56,302,286,3.442857142857143
448,2,5,3,891887393,891887440,47,286,345,3.4782608695652173
448,5,1,-4,891887440,891888099,659,345,301,3.2465753424657535
448,1,4,3,891888099,891888509,410,301,321,3.0172413793103448
448,4,1,-3,891888509,891888653,144,321,312,3.0
448,1,4,3,891888653,891888779,126,312,902,3.9444444444444446
457,2,5,3,882392810,882392853,43,476,228,3.7246376811594204
457,5,4,-1,882392853,882392854,1,228,380,3.4878048780487805
457,4,5,1,882392854,882392906,52,380,531,3.7435897435897436
457,5,4,-1,882392906,882392950,44,531,385,3.6129032258064515
457,4,5,1,882392950,882392976,26,385,238,3.888888888888889
457,5,4,-1,882392976,882393008,32,238,248,3.746268656716418
457,4,4,0,882393008,882393066,58,248,121,3.521212121212121
457,4,2,-2,882393066,882393104,38,121,243,2.357142857142857
457,2,1,-1,882393104,882393156,52,243,948,2.2962962962962963
457,1,4,3,882393156,882393278,122,948,7,3.76056338028169
457,4,4,0,882393278,882393306,28,7,742,3.5555555555555554
457,4,4,0,882393306,882393343,37,742,125,3.5555555555555554
457,4,4,0,882393343,882393384,41,125,455,3.1702127659574466
457,4,5,1,882393384,882393485,101,455,9,3.8878504672897196
457,5,2,-3,882393485,882393514,29,9,294,3.1052631578947367
457,2,5,3,882393514,882393648,134,294,275,4.087912087912088
457,5,4,-1,882393648,882393688,40,275,628,3.573529411764706
457,4,4,0,882393688,882393712,24,628,237,3.7315436241610738
457,4,3,-1,882393712,882393765,53,237,458,3.0588235294117645
457,3,4,1,882393765,882393801,36,458,845,3.661290322580645
457,4,4,0,882393801,882393828,27,845,25,3.3185840707964602
457,4,2,-2,882393828,882393860,32,25,546,2.9789473684210526
457,2,3,1,882393860,882393883,23,546,13,3.5454545454545454
457,3,3,0,882393883,882393908,25,13,597,3.2771084337349397
457,3,4,1,882393908,882393937,29,597,410,3.0434782608695654
457,4,5,1,882393937,882393967,30,410,20,3.375
457,5,5,0,882393967,882394010,43,20,151,3.6544117647058822
457,5,5,0,882394010,882395049,1039,151,195,3.9072164948453607
457,5,4,-1,882395049,882395078,29,195,160,3.4
457,4,4,0,882395078,882395360,282,160,473,2.9166666666666665
457,4,3,-1,882395360,882395400,40,473,676,3.3142857142857145
457,3,4,1,882395400,882395516,116,676,841,2.772727272727273
457,4,2,-2,882395516,882395742,226,841,756,2.6885245901639343
457,2,4,2,882395742,882395768,26,756,472,2.984375
457,4,2,-2,882395768,882395851,83,472,456,2.2
457,2,3,1,882395851,882395894,43,456,235,3.106382978723404
457,3,2,-1,882395894,882395916,22,235,931,2.2758620689655173
457,2,2,0,882395916,882395964,48,931,1047,2.6923076923076925
457,2,3,1,882395964,882396092,128,1047,934,3.0294117647058822
457,3,3,0,882396092,882396133,41,934,370,2.8125
457,3,2,-1,882396133,882396158,25,370,122,2.282608695652174
457,2,2,0,882396158,882396217,59,122,412,2.272727272727273
457,2,5,3,882396217,882396283,66,412,462,3.7954545454545454
457,5,5,0,882396283,882396314,31,462,553,3.5
457,5,5,0,882396314,882396487,173,553,83,4.204081632653061
457,5,5,0,882396487,882396602,115,83,190,4.233333333333333
457,5,5,0,882396602,882396659,57,190,69,3.8015873015873014
457,5,5,0,882396659,882396734,75,69,223,4.108695652173913
457,5,5,0,882396734,882396735,1,223,357,4.063291139240507
457,5,5,0,882396735,882396765,30,357,216,3.8454545454545452
457,5,5,0,882396765,882396799,34,216,651,3.8627450980392157
457,5,4,-1,882396799,882396832,33,651,727,3.5517241379310347
457,4,5,1,882396832,882396868,36,727,64,4.373737373737374
457,5,5,0,882396868,882396902,34,64,127,4.162790697674419
457,5,4,-1,882396902,882396989,87,127,367,3.4242424242424243
457,4,5,1,882396989,882397020,31,367,433,3.8035714285714284
457,5,4,-1,882397020,882397059,39,433,507,3.6285714285714286
457,4,5,1,882397059,882397133,74,507,45,4.130434782608695
457,5,4,-1,882397133,882397177,44,45,403,3.298507462686567
457,4,4,0,882397177,882397208,31,403,469,3.6842105263157894
457,4,5,1,882397208,882397240,32,469,135,3.7974683544303796
457,5,5,0,882397240,882397267,27,135,239,3.423076923076923
457,5,5,0,882397267,882397375,108,239,185,3.9726027397260273
457,5,5,0,882397375,882397411,36,185,588,3.8358208955223883
457,5,5,0,882397411,882397455,44,588,183,3.951219512195122
457,5,5,0,882397455,882397494,39,183,144,3.9545454545454546
457,5,5,0,882397494,882397543,49,144,528,4.241379310344827
457,5,5,0,882397543,882397575,32,528,186,3.905263157894737
457,5,5,0,882397575,882397666,91,186,12,4.358974358974359
457,5,5,0,882397666,882397699,33,12,97,3.7282608695652173
457,5,5,0,882397699,882397734,35,97,51,3.5277777777777777
457,5,4,-1,882397734,882397787,53,51,747,3.5526315789473686
457,4,4,0,882397787,882397828,41,747,425,3.7027027027027026
457,4,4,0,882397828,882397829,1,425,673,3.393939393939394
457,4,5,1,882397829,882397879,50,673,655,3.7857142857142856
457,5,5,0,882397879,882397934,55,655,1039,3.9583333333333335
457,5,4,-1,882397934,882397963,29,1039,179,3.8823529411764706
457,4,4,0,882397963,882398002,39,179,215,3.662921348314607
457,4,4,0,882398002,882398054,52,215,559,3.477272727272727
457,4,3,-1,882398054,882398086,32,559,241,3.5625
457,3,5,2,882398086,882398178,92,241,474,4.172413793103448
457,5,5,0,882398178,882398204,26,474,470,3.72
457,5,4,-1,882398204,882398275,71,470,202,3.730337078651685
457,4,4,0,882398275,882398345,70,202,77,3.3857142857142857
457,4,4,0,882398345,882547302,148957,77,91,3.6
457,4,4,0,882547302,882547590,288,91,568,3.5853658536585367
457,4,5,1,882547590,882547619,29,568,132,3.929411764705882
457,5,4,-1,882547619,882547620,1,132,631,3.581818181818182
457,4,4,0,882547620,882547645,25,631,164,3.6140350877192984
457,4,4,0,882547645,882547670,25,164,356,3.2
457,4,4,0,882547670,882547694,24,356,66,3.4705882352941178
457,4,4,0,882547694,882547723,29,66,679,3.2432432432432434
457,4,4,0,882547723,882547794,71,679,770,3.25
457,4,4,0,882547794,882547820,26,770,133,3.7777777777777777
457,4,5,1,882547820,882547856,36,133,709,4.171428571428572
457,5,5,0,882547856,882547967,111,709,65,3.511111111111111
457,5,4,-1,882547967,882548312,345,65,378,3.6904761904761907
457,4,5,1,882548312,882548350,38,378,582,3.7457627118644066
457,5,4,-1,882548350,882548382,32,582,372,3.6666666666666665
457,4,4,0,882548382,882548426,44,372,732,3.6266666666666665
457,4,4,0,882548426,882548466,40,732,636,3.4146341463414633
457,4,4,0,882548466,882548467,1,636,640,2.75
457,4,4,0,882548467,882548537,70,640,448,3.466666666666667
457,4,3,-1,882548537,882548583,46,448,393,3.5125
457,3,4,1,882548583,882548615,32,393,699,3.736842105263158
457,4,4,0,882548615,882548645,30,699,53,2.9523809523809526
457,4,5,1,882548645,882548761,116,53,1168,3.4166666666666665
457,5,5,0,882548761,882548793,32,1168,162,3.4651162790697674
457,5,3,-2,882548793,882548825,32,162,226,3.378787878787879
457,3,4,1,882548825,882549180,355,226,959,3.4583333333333335
457,4,4,0,882549180,882549212,32,959,451,3.207792207792208
457,4,3,-1,882549212,882549287,75,451,949,3.392857142857143
457,3,4,1,882549287,882549438,151,949,1221,3.4285714285714284
457,4,4,0,882549438,882549483,45,1221,27,3.235294117647059
457,4,3,-1,882549483,882549544,61,27,94,2.8823529411764706
457,3,4,1,882549544,882549575,31,94,417,3.0588235294117645
457,4,4,0,882549575,882549601,26,417,664,3.15
457,4,3,-1,882549601,882549651,50,664,38,2.784313725490196
457,3,4,1,882549651,882549682,31,38,554,2.9555555555555557
457,4,3,-1,882549682,882549936,254,554,783,2.388888888888889
457,3,3,0,882549936,882549998,62,783,145,2.3636363636363638
457,3,3,0,882549998,882550065,67,145,623,3.0454545454545454
457,3,4,1,882550065,882550304,239,623,219,2.735294117647059
457,4,2,-2,882550304,882551135,831,219,758,2.2857142857142856
457,2,3,1,882551135,882551228,93,758,452,2.6129032258064515
457,3,2,-1,882551228,882551343,115,452,388,2.5833333333333335
457,2,2,0,882551343,882551344,1,388,120,2.3421052631578947
457,2,3,1,882551344,882551740,396,120,540,2.4615384615384617
457,3,2,-1,882551740,882551818,78,540,1037,2.0
457,2,2,0,882551818,882551854,36,1037,453,2.0
457,2,5,3,882551854,882553113,1259,453,172,4.225225225225225
456,4,4,0,881371453,881371548,95,150,919,4.0
456,4,4,0,881371548,881371660,112,919,864,3.2142857142857144
456,4,5,1,881371660,881371766,106,864,1010,3.611111111111111
456,5,3,-2,881371766,881371839,73,1010,845,3.661290322580645
456,3,3,0,881371839,881371942,103,845,111,3.5106382978723403
456,3,4,1,881371942,881372015,73,111,125,3.5555555555555554
456,4,3,-1,881372015,881372078,63,125,696,3.138888888888889
456,3,3,0,881372078,881372114,36,696,544,3.185185185185185
456,3,4,1,881372114,881372160,46,544,410,3.0434782608695654
456,4,4,0,881372160,881372191,31,410,1081,2.6666666666666665
456,4,2,-2,881372191,881372256,65,1081,743,1.9545454545454546
456,2,3,1,881372256,881372366,110,743,100,4.0162162162162165
456,3,4,1,881372366,881372604,238,100,13,3.5454545454545454
456,4,3,-1,881372604,881372687,83,13,325,2.625
456,3,4,1,881372687,881372779,92,325,427,4.2025316455696204
456,4,4,0,881372779,881372849,70,427,1604,4.0
456,4,4,0,881372849,881372911,62,1604,187,4.215189873417722
456,4,4,0,881372911,881372946,35,187,943,3.6666666666666665
456,4,4,0,881372946,881373019,73,943,23,3.9047619047619047
456,4,4,0,881373019,881373084,65,23,180,3.9473684210526314
456,4,4,0,881373084,881373168,84,180,461,3.3333333333333335
456,4,4,0,881373168,881373169,1,461,135,3.7974683544303796
456,4,5,1,881373169,881373353,184,135,474,4.172413793103448
456,5,3,-2,881373353,881373506,153,474,462,3.7954545454545454
456,3,4,1,881373506,881373573,67,462,188,3.625
456,4,3,-1,881373573,881373574,1,188,559,3.477272727272727
456,3,3,0,881373574,881373617,43,559,806,3.6666666666666665
456,3,4,1,881373617,881373655,38,806,42,3.893617021276596
456,4,3,-1,881373655,881373697,42,42,715,3.257142857142857
456,3,4,1,881373697,881373756,59,715,95,3.8194444444444446
456,4,4,0,881373756,881373793,37,95,197,4.112676056338028
456,4,4,0,881373793,881373794,1,197,168,4.0476190476190474
456,4,4,0,881373794,881373838,44,168,97,3.7282608695652173
456,4,5,1,881373838,881373900,62,97,479,4.25
456,5,4,-1,881373900,881373948,48,479,1547,4.0
456,4,4,0,881373948,881374047,99,1547,963,3.9285714285714284
456,4,4,0,881374047,881374048,1,963,92,3.7142857142857144
456,4,3,-1,881374048,881374086,38,92,421,3.462962962962963
456,3,4,1,881374086,881374162,76,421,211,3.958904109589041
456,4,4,0,881374162,881374331,169,211,747,3.5526315789473686
456,4,3,-1,881374331,881374332,1,747,1240,3.5454545454545454
456,3,2,-1,881374332,881374389,57,1240,232,3.0789473684210527
456,2,3,1,881374389,881374437,48,232,1421,3.2
456,3,3,0,881374437,881374462,25,1421,588,3.8358208955223883
456,3,4,1,881374462,881374521,59,588,57,4.133333333333334
456,4,3,-1,881374521,881374548,27,57,228,3.7246376811594204
456,3,3,0,881374548,881374586,38,228,423,3.7016129032258065
456,3,3,0,881374586,881374613,27,423,46,3.6666666666666665
456,3,3,0,881374613,881374649,36,46,710,3.41025641025641
456,3,3,0,881374649,881374710,61,710,71,3.6575342465753424
456,3,4,1,881374710,881374767,57,71,580,3.625
456,4,1,-3,881374767,881374801,34,580,72,3.175438596491228
456,1,3,2,881374801,881374849,48,72,210,3.921259842519685
456,3,3,0,881374849,881374883,34,210,217,3.1538461538461537
456,3,3,0,881374883,881374921,38,217,1218,3.2
456,3,4,1,881374921,881374993,72,1218,1478,2.7
456,4,2,-2,881374993,881375019,26,1478,1222,2.6363636363636362
456,2,3,1,881375019,881375097,78,1222,380,3.4878048780487805
456,3,2,-1,881375097,881375127,30,380,578,3.066666666666667
456,2,3,1,881375127,881375155,28,578,581,3.130434782608696
456,3,3,0,881375155,881375284,129,581,101,3.4827586206896552
456,3,3,0,881375284,881375351,67,101,658,3.393939393939394
456,3,2,-1,881375351,881375381,30,658,550,3.272727272727273
456,2,3,1,881375381,881375416,35,550,54,3.3714285714285714
456,3,3,0,881375416,881375482,66,54,229,3.185185185185185
456,3,2,-1,881375482,881375515,33,229,452,2.6129032258064515
456,2,4,2,881375515,881375587,72,452,1107,2.9
456,4,1,-3,881375587,881375667,80,1107,294,3.1052631578947367
456,1,4,3,881375667,887165802,5790135,294,258,3.7547169811320753
458,4,4,0,886394373,886394423,50,100,285,4.181818181818182
458,4,3,-1,886394423,886394471,48,285,1011,3.1
458,3,4,1,886394471,886394527,56,1011,284,3.1547619047619047
458,4,4,0,886394527,886394623,96,284,116,3.6666666666666665
458,4,5,1,886394623,886394667,44,116,980,3.142857142857143
458,5,4,-1,886394667,886394729,62,980,475,3.956043956043956
458,4,4,0,886394729,886394730,1,475,742,3.5555555555555554
458,4,4,0,886394730,886394822,92,742,124,4.052631578947368
458,4,3,-1,886394822,886394863,41,124,546,2.9789473684210526
458,3,4,1,886394863,886394916,53,546,13,3.5454545454545454
458,4,3,-1,886394916,886395065,149,13,762,3.3962264150943398
458,3,2,-1,886395065,886395119,54,762,952,3.3529411764705883
458,2,3,1,886395119,886395166,47,952,925,3.0
458,3,1,-2,886395166,886395230,64,925,717,2.9696969696969697
458,1,5,4,886395230,886395311,81,717,1067,3.533333333333333
458,5,4,-1,886395311,886395350,39,1067,596,3.180327868852459
458,4,2,-2,886395350,886395469,119,596,278,3.0357142857142856
458,2,3,1,886395469,886395512,43,278,696,3.138888888888889
458,3,1,-2,886395512,886395565,53,696,1335,2.25
458,1,4,3,886395565,886395899,334,1335,648,3.9545454545454546
458,4,4,0,886395899,886395963,64,648,32,3.7222222222222223
458,4,3,-1,886395963,886396005,42,32,28,3.923076923076923
458,3,4,1,886396005,886396140,135,28,694,4.277777777777778
458,4,5,1,886396140,886396192,52,694,191,4.168674698795181
458,5,3,-2,886396192,886396240,48,191,98,4.240875912408759
458,3,5,2,886396240,886396241,1,98,526,3.909090909090909
458,5,4,-1,886396241,886396314,73,526,513,4.526315789473684
458,4,5,1,886396314,886396390,76,513,169,4.548387096774194
458,5,4,-1,886396390,886396460,70,169,193,3.883720930232558
458,4,2,-2,886396460,886396521,61,193,50,4.306532663316583
458,2,1,-1,886396521,886396637,116,50,250,3.4698795180722892
458,1,5,4,886396637,886396677,40,250,298,3.779220779220779
458,5,4,-1,886396677,886396729,52,298,515,4.202898550724638
458,4,5,1,886396729,886396767,38,515,293,3.630434782608696
458,5,2,-3,886396767,886396824,57,293,181,3.98974358974359
458,2,2,0,886396824,886396910,86,181,1226,3.5454545454545454
458,2,2,0,886396910,886396958,48,1226,282,3.610526315789474
458,2,4,2,886396958,886397110,152,282,99,3.8392857142857144
458,4,4,0,886397110,886397155,45,99,209,3.8275862068965516
458,4,5,1,886397155,886397275,120,209,1039,3.9583333333333335
458,5,4,-1,886397275,886397318,43,1039,1109,3.4545454545454546
458,4,4,0,886397318,886397377,59,1109,521,3.787878787878788
458,4,4,0,886397377,886397413,36,521,1261,4.0
458,4,4,0,886397413,886397450,37,1261,499,4.0
458,4,2,-2,886397450,886397504,54,499,194,4.029411764705882
458,2,4,2,886397504,886397541,37,194,631,3.581818181818182
458,4,1,-3,886397541,886397726,185,631,960,3.0
458,1,4,3,886397726,886397857,131,960,509,3.7058823529411766
458,4,4,0,886397857,886397931,74,509,23,3.9047619047619047
458,4,3,-1,886397931,886397988,57,23,651,3.8627450980392157
458,3,4,1,886397988,886398025,37,651,792,3.793103448275862
458,4,4,0,886398025,886398071,46,792,83,4.204081632653061
458,4,4,0,886398071,886398121,50,83,76,3.1875
458,4,4,0,886398121,886398187,66,76,178,4.378378378378378
458,4,3,-1,886398187,886398246,59,178,425,3.7027027027027026
458,3,4,1,886398246,886398289,43,425,632,3.9523809523809526
458,4,1,-3,886398289,886398488,199,632,582,3.7457627118644066
458,1,5,4,886398488,886398543,55,582,430,4.136363636363637
458,5,1,-4,886398543,889323539,2924996,430,301,3.2465753424657535
458,1,1,0,889323539,889323582,43,301,333,3.546666666666667
458,1,3,2,889323582,889323660,78,333,338,2.75
458,3,4,1,889323660,889323714,54,338,319,3.0408163265306123
458,4,5,1,889323714,889323771,57,319,750,4.027777777777778
458,5,3,-2,889323771,889323855,84,750,321,3.0172413793103448
458,3,4,1,889323855,889323982,127,321,304,3.5306122448979593
458,4,2,-2,889323982,889324066,84,304,245,3.056179775280899
458,2,3,1,889324066,889324461,395,245,330,2.625
462,5,5,0,886365197,886365260,63,310,288,3.5214285714285714
462,5,4,-1,886365260,886365297,37,288,895,3.142857142857143
462,4,4,0,886365297,886365387,90,895,100,4.0162162162162165
462,4,4,0,886365387,886365443,56,100,181,3.98974358974359
462,4,5,1,886365443,886365498,55,181,11,3.8904109589041096
462,5,1,-4,886365498,886365638,140,11,358,2.6551724137931036
462,1,4,3,886365638,886365706,68,358,873,2.7586206896551726
462,4,5,1,886365706,886365734,28,873,321,3.0172413793103448
462,5,3,-2,886365734,886365773,39,321,259,2.492063492063492
462,3,5,2,886365773,886365837,64,259,289,2.988888888888889
462,5,1,-4,886365837,886365928,91,289,271,3.3134328358208953
459,2,4,2,879561574,879561630,56,301,259,2.492063492063492
459,4,4,0,879561630,879561654,24,259,1038,2.6
459,4,3,-1,879561654,879561708,54,1038,323,3.0
459,3,4,1,879561708,879561731,23,323,873,2.7586206896551726
459,4,3,-1,879561731,879561782,51,873,687,2.1481481481481484
459,3,2,-1,879561782,879561783,1,687,358,2.6551724137931036
459,2,4,2,879561783,879562834,1051,358,742,3.5555555555555554
459,4,1,-3,879562834,879562859,25,742,100,4.0162162162162165
459,1,3,2,879562859,879562895,36,100,298,3.779220779220779
459,3,4,1,879562895,879562960,65,298,1,3.902439024390244
459,4,4,0,879562960,879562994,34,1,222,3.578125
459,4,1,-3,879562994,879562995,1,222,477,3.1666666666666665
459,1,4,3,879562995,879563064,69,477,50,4.306532663316583
459,4,4,0,879563064,879563102,38,50,15,3.725663716814159
459,4,5,1,879563102,879563146,44,15,117,3.689189189189189
459,5,4,-1,879563146,879563169,23,117,125,3.5555555555555554
459,4,2,-2,879563169,879563201,32,125,25,3.3185840707964602
459,2,3,1,879563201,879563226,25,25,1013,2.388888888888889
459,3,4,1,879563226,879563270,44,1013,278,3.0357142857142856
459,4,2,-2,879563270,879563288,18,278,3,3.0625
459,2,3,1,879563288,879563334,46,3,405,3.25
459,3,5,2,879563334,879563367,33,405,148,3.2131147540983607
459,5,2,-3,879563367,879563392,25,148,455,3.1702127659574466
459,2,4,2,879563392,879563435,43,455,864,3.2142857142857144
459,4,3,-1,879563435,879563474,39,864,825,2.914285714285714
459,3,1,-2,879563474,879563506,32,825,1014,3.1
459,1,4,3,879563506,879563613,107,1014,255,3.2027027027027026
459,4,4,0,879563613,879563639,26,255,926,2.7857142857142856
459,4,3,-1,879563639,879563668,29,926,1047,2.6923076923076925
459,3,2,-1,879563668,879563701,33,1047,1040,2.2666666666666666
459,2,4,2,879563701,879563736,35,1040,696,3.138888888888889
459,4,3,-1,879563736,879563758,22,696,827,2.4375
459,3,3,0,879563758,879563777,19,827,225,3.0714285714285716
459,3,4,1,879563777,879563819,42,225,105,2.6176470588235294
459,4,5,1,879563819,879563902,83,105,172,4.225225225225225
459,5,5,0,879563902,879563903,1,172,22,4.215909090909091
459,5,3,-2,879563903,879564915,1012,22,1039,3.9583333333333335
459,3,3,0,879564915,879564941,26,1039,568,3.5853658536585367
459,3,4,1,879564941,879566321,1380,568,186,3.905263157894737
460,3,3,0,882910579,882910637,58,301,258,3.7547169811320753
460,3,2,-1,882910637,882910678,41,258,288,3.5214285714285714
460,2,3,1,882910678,882910722,44,288,322,3.0476190476190474
460,3,4,1,882910722,882910837,115,322,313,4.323076923076923
460,4,4,0,882910837,882911203,366,313,1142,4.0476190476190474
460,4,3,-1,882911203,882912261,1058,1142,129,3.744186046511628
460,3,4,1,882912261,882912285,24,129,221,3.6923076923076925
460,4,3,-1,882912285,882912316,31,221,253,3.5
460,3,2,-1,882912316,882912342,26,253,257,3.7154471544715446
460,2,3,1,882912342,882912370,28,257,532,2.7777777777777777
460,3,3,0,882912370,882912371,1,532,10,3.85
460,3,4,1,882912371,882912418,47,10,306,4.033333333333333
460,4,4,0,882912418,882912469,51,306,713,3.5
461,2,1,-1,885355679,885355705,26,259,682,3.0476190476190474
461,1,3,2,885355705,885355735,30,682,242,3.5217391304347827
461,3,2,-1,885355735,885355757,22,242,305,3.5789473684210527
461,2,3,1,885355757,885355778,21,305,319,3.0408163265306123
461,3,3,0,885355778,885355805,27,319,294,3.1052631578947367
461,3,2,-1,885355805,885355930,125,294,575,2.619047619047619
461,2,3,1,885355930,885356089,159,575,50,4.306532663316583
461,3,5,2,885356089,885356112,23,50,9,3.8878504672897196
467,4,4,0,879532145,879532164,19,269,327,3.5076923076923077
467,4,3,-1,879532164,879532198,34,327,340,3.7419354838709675
467,3,2,-1,879532198,879532296,98,340,264,2.65
467,2,4,2,879532296,879532385,89,264,50,4.306532663316583
467,4,2,-2,879532385,879532403,18,50,1017,3.0
467,2,5,3,879532403,879532420,17,1017,100,4.0162162162162165
467,5,2,-3,879532420,879532437,17,100,117,3.689189189189189
467,2,4,2,879532437,879532459,22,117,1,3.902439024390244
467,4,4,0,879532459,879532460,1,1,475,3.956043956043956
467,4,5,1,879532460,879532478,18,475,1142,4.0476190476190474
467,5,4,-1,879532478,879532496,18,1142,10,3.85
467,4,4,0,879532496,879532512,16,10,257,3.7154471544715446
467,4,5,1,879532512,879532534,22,257,124,4.052631578947368
467,5,4,-1,879532534,879532565,31,124,273,3.5238095238095237
467,4,4,0,879532565,879532595,30,273,93,3.5641025641025643
467,4,2,-2,879532595,879532630,35,93,1011,3.1
467,2,3,1,879532630,879532651,21,1011,222,3.578125
467,3,2,-1,879532651,879532671,20,222,742,3.5555555555555554
467,2,4,2,879532671,879532693,22,742,1059,2.764705882352941
467,4,4,0,879532693,879532744,51,1059,108,3.107142857142857
467,4,3,-1,879532744,879532773,29,108,240,3.0350877192982457
467,3,4,1,879532773,879532804,31,240,288,3.5214285714285714
468,3,4,1,875279153,875280104,951,294,285,4.181818181818182
468,4,4,0,875280104,875280126,22,285,137,3.9545454545454546
468,4,4,0,875280126,875280180,54,137,251,3.8333333333333335
468,4,4,0,875280180,875280181,1,251,237,3.7315436241610738
468,4,5,1,875280181,875280309,128,237,150,3.803921568627451
468,5,5,0,875280309,875280331,22,150,124,4.052631578947368
468,5,5,0,875280331,875280352,21,124,246,4.0
468,5,5,0,875280352,875280395,43,246,1,3.902439024390244
468,5,3,-2,875280395,875280417,22,1,118,3.2764227642276422
468,3,2,-1,875280417,875280462,45,118,405,3.25
468,2,2,0,875280462,875280499,37,405,273,3.5238095238095237
468,2,4,2,875280499,875280628,129,273,121,3.521212121212121
468,4,3,-1,875280628,875280670,42,121,1016,3.559322033898305
468,3,5,2,875280670,875287615,6945,1016,55,4.051282051282051
468,5,3,-2,875287615,875287686,71,55,5,3.1481481481481484
468,3,5,2,875287686,875287720,34,5,153,3.7865168539325844
468,5,3,-2,875287720,875287721,1,153,943,3.6666666666666665
468,3,5,2,875287721,875287895,174,943,135,3.7974683544303796
468,5,5,0,875287895,875288197,302,135,143,3.56
468,5,4,-1,875288197,875288504,307,143,955,3.2666666666666666
468,4,4,0,875288504,875291570,3066,955,662,3.4583333333333335
468,4,5,1,875291570,875291571,1,662,498,4.290909090909091
468,5,5,0,875291571,875291722,151,498,427,4.2025316455696204
468,5,5,0,875291722,875291902,180,427,180,3.9473684210526314
468,5,4,-1,875291902,875292027,125,180,435,3.8933333333333335
468,4,5,1,875292027,875292134,107,435,132,3.929411764705882
468,5,3,-2,875292134,875292320,186,132,159,3.3902439024390243
468,3,5,2,875292320,875294549,2229,159,174,4.253521126760563
468,5,4,-1,875294549,875294741,192,174,157,3.5714285714285716
468,4,5,1,875294741,875295148,407,157,96,3.9130434782608696
468,5,5,0,875295148,875296401,1253,96,178,4.378378378378378
468,5,2,-3,875296401,875301098,4697,178,372,3.6666666666666665
468,2,4,2,875301098,875302208,1110,372,44,3.1333333333333333
466,3,3,0,890282795,890282925,130,300,326,3.262295081967213
466,3,3,0,890282925,890282956,31,326,327,3.5076923076923077
466,3,2,-1,890282956,890283056,100,327,873,2.7586206896551726
466,2,4,2,890283056,890283592,536,873,260,2.4716981132075473
466,4,2,-2,890283592,890283636,44,260,349,2.5714285714285716
466,2,3,1,890283636,890283690,54,349,1313,3.142857142857143
466,3,4,1,890283690,890284652,962,1313,258,3.7547169811320753
466,4,3,-1,890284652,890284766,114,258,188,3.625
466,3,3,0,890284766,890284819,53,188,566,3.543859649122807
466,3,5,2,890284819,890284857,38,566,241,3.5625
466,5,3,-2,890284857,890285034,177,241,4,3.5538461538461537
466,3,4,1,890285034,890285113,79,4,184,3.393939393939394
466,4,3,-1,890285113,890285159,46,184,679,3.2432432432432434
466,3,2,-1,890285159,890285788,629,679,95,3.8194444444444446
472,4,4,0,875977735,875977827,92,294,260,2.4716981132075473
472,4,3,-1,875977827,875977870,43,260,264,2.65
472,3,5,2,875977870,875978010,140,264,50,4.306532663316583
472,5,5,0,875978010,875978034,24,50,181,3.98974358974359
472,5,5,0,875978034,875978059,25,181,250,3.4698795180722892
472,5,4,-1,875978059,875978096,37,250,257,3.7154471544715446
472,4,4,0,875978096,875978191,95,257,1014,3.1
472,4,5,1,875978191,875978387,196,1014,477,3.1666666666666665
472,5,5,0,875978387,875978534,147,477,100,4.0162162162162165
472,5,3,-2,875978534,875978686,152,100,150,3.803921568627451
472,3,3,0,875978686,875978740,54,150,685,3.2666666666666666
472,3,4,1,875978740,875978867,127,685,473,2.9166666666666665
472,4,4,0,875978867,875978922,55,473,763,3.347826086956522
472,4,4,0,875978922,875979082,160,763,1047,2.6923076923076925
472,4,4,0,875979082,875979113,31,1047,411,2.911764705882353
472,4,5,1,875979113,875979153,40,411,472,2.984375
472,5,4,-1,875979153,875979187,34,472,240,3.0350877192982457
472,4,4,0,875979187,875979317,130,240,123,3.297872340425532
472,4,3,-1,875979317,875979359,42,123,1034,2.6
472,3,3,0,875979359,875979402,43,1034,105,2.6176470588235294
472,3,5,2,875979402,875979439,37,105,825,2.914285714285714
472,5,5,0,875979439,875979498,59,825,831,2.6097560975609757
472,5,4,-1,875979498,875979562,64,831,1215,2.0714285714285716
472,4,3,-1,875979562,875979685,123,1215,368,1.8823529411764706
472,3,5,2,875979685,875979737,52,368,202,3.730337078651685
472,5,3,-2,875979737,875979797,60,202,588,3.8358208955223883
472,3,5,2,875979797,875979853,56,588,56,4.051724137931035
472,5,5,0,875979853,875979910,57,56,175,3.8354430379746836
472,5,4,-1,875979910,875979964,54,175,214,3.272727272727273
472,4,5,1,875979964,875980081,117,214,185,3.9726027397260273
472,5,4,-1,875980081,875980120,39,185,218,3.5555555555555554
472,4,3,-1,875980120,875980209,89,218,95,3.8194444444444446
472,3,4,1,875980209,875980283,74,95,27,3.235294117647059
472,4,1,-3,875980283,875980377,94,27,584,3.5238095238095237
472,1,3,2,875980377,875980418,41,584,4,3.5538461538461537
472,3,5,2,875980418,875981158,740,4,66,3.4705882352941178
472,5,4,-1,875981158,875981230,72,66,216,3.8454545454545452
472,4,4,0,875981230,875981358,128,216,177,3.875
472,4,4,0,875981358,875981428,70,177,633,3.9
472,4,5,1,875981428,875981429,1,633,1110,2.85
472,5,4,-1,875981429,875981503,74,1110,392,3.5555555555555554
472,4,5,1,875981503,875981551,48,392,609,3.7058823529411766
472,5,5,0,875981551,875981708,157,609,559,3.477272727272727
472,5,4,-1,875981708,875981759,51,559,233,3.323529411764706
472,4,5,1,875981759,875981876,117,233,62,3.048780487804878
472,5,4,-1,875981876,875981968,92,62,625,3.25
472,4,5,1,875981968,875982050,82,625,561,3.1515151515151514
472,5,5,0,875982050,875982051,1,561,747,3.5526315789473686
472,5,5,0,875982051,875982096,45,747,720,3.2
472,5,4,-1,875982096,875982149,53,720,443,3.8421052631578947
472,4,3,-1,875982149,875982239,90,443,540,2.4615384615384617
472,3,4,1,875982239,875982337,98,540,419,3.8208955223880596
472,4,4,0,875982337,875982397,60,419,1053,3.3846153846153846
472,4,4,0,875982397,875982511,114,1053,63,3.125
472,4,5,1,875982511,875982560,49,63,229,3.185185185185185
472,5,4,-1,875982560,875982607,47,229,715,3.257142857142857
472,4,5,1,875982607,875982641,34,715,173,4.1441441441441444
472,5,5,0,875982641,875982680,39,173,375,2.076923076923077
472,5,5,0,875982680,875982771,91,375,768,3.238095238095238
472,5,5,0,875982771,875982867,96,768,226,3.378787878787879
472,5,3,-2,875982867,875982868,1,226,501,3.289473684210526
472,3,2,-1,875982868,875982922,54,501,374,2.111111111111111
472,2,5,3,875982922,875982967,45,374,449,2.9069767441860463
472,5,4,-1,875982967,875983023,56,449,665,2.72972972972973
472,4,5,1,875983023,875983066,43,665,550,3.272727272727273
472,5,3,-2,875983066,875983129,63,550,393,3.5125
472,3,4,1,875983129,875983270,141,393,1228,2.5
472,4,4,0,875983270,875983321,51,1228,232,3.0789473684210527
472,4,1,-3,875983321,875983426,105,232,951,2.6666666666666665
472,1,4,3,875983426,875983427,1,951,1248,3.0
472,4,3,-1,875983427,875983484,57,1248,1210,2.7142857142857144
472,3,4,1,875983484,883903273,7919789,1210,689,3.1538461538461537
472,4,5,1,883903273,883903715,442,689,742,3.5555555555555554
472,5,3,-2,883903715,883904224,509,742,826,2.5555555555555554
472,3,4,1,883904224,883904360,136,826,1079,2.1923076923076925
472,4,4,0,883904360,883904504,144,1079,743,1.9545454545454546
472,4,4,0,883904504,883904614,110,743,1095,2.8
472,4,5,1,883904614,883904649,35,1095,120,2.3421052631578947
472,5,2,-3,883904649,883904681,32,120,931,2.2758620689655173
472,2,4,2,883904681,892790117,8885436,931,323,3.0
472,4,5,1,892790117,892790627,510,323,916,3.3333333333333335
472,5,5,0,892790627,892790628,1,916,313,4.323076923076923
472,5,5,0,892790628,892790953,325,313,22,4.215909090909091
472,5,5,0,892790953,892791062,109,22,597,3.2771084337349397
465,3,5,2,883529372,883529482,110,319,258,3.7547169811320753
465,5,3,-2,883529482,883529601,119,258,300,3.6861313868613137
465,3,4,1,883529601,883529984,383,300,481,3.8421052631578947
465,4,5,1,883529984,883530015,31,481,513,4.526315789473684
465,5,4,-1,883530015,883530054,39,513,1,3.902439024390244
465,4,4,0,883530054,883530088,34,1,12,4.358974358974359
465,4,4,0,883530088,883530133,45,12,191,4.168674698795181
465,4,4,0,883530133,883530190,57,191,114,4.3478260869565215
465,4,3,-1,883530190,883530313,123,114,475,3.956043956043956
465,3,5,2,883530313,883530391,78,475,408,4.4772727272727275
465,5,4,-1,883530391,883530521,130,408,275,4.087912087912088
465,4,3,-1,883530521,883530560,39,275,283,3.901639344262295
465,3,4,1,883530560,883530667,107,283,127,4.162790697674419
465,4,4,0,883530667,883530742,75,127,477,3.1666666666666665
465,4,4,0,883530742,883530743,1,477,845,3.661290322580645
465,4,4,0,883530743,883530778,35,845,50,4.306532663316583
465,4,3,-1,883530778,883530991,213,50,615,3.8333333333333335
465,3,3,0,883530991,883531026,35,615,172,4.225225225225225
465,3,4,1,883531026,883531072,46,172,169,4.548387096774194
465,4,4,0,883531072,883531110,38,169,56,4.051724137931035
465,4,3,-1,883531110,883531111,1,56,525,4.0
465,3,3,0,883531111,883531155,44,525,836,4.142857142857143
465,3,3,0,883531155,883531246,91,836,22,4.215909090909091
465,3,3,0,883531246,883531284,38,22,216,3.8454545454545452
465,3,4,1,883531284,883531325,41,216,132,3.929411764705882
465,4,4,0,883531325,883531380,55,132,143,3.56
465,4,3,-1,883531380,883531409,29,143,174,4.253521126760563
465,3,3,0,883531409,883531410,1,174,656,3.75
465,3,4,1,883531410,883531444,34,656,705,3.7857142857142856
465,4,4,0,883531444,883531487,43,705,318,4.5046728971962615
465,4,3,-1,883531487,883531533,46,318,423,3.7016129032258065
465,3,2,-1,883531533,883532120,587,423,404,3.6578947368421053
463,5,4,-1,877384835,877384836,1,302,306,4.033333333333333
463,4,4,0,877384836,877384940,104,306,268,3.9838709677419355
463,4,1,-3,877384940,877384970,30,268,243,2.357142857142857
463,1,4,3,877384970,877385125,155,243,508,3.6923076923076925
463,4,4,0,877385125,877385180,55,508,1197,3.625
463,4,3,-1,877385180,877385181,1,1197,224,3.4545454545454546
463,3,4,1,877385181,877385237,56,224,237,3.7315436241610738
463,4,2,-2,877385237,877385287,50,237,129,3.744186046511628
463,2,4,2,877385287,877385341,54,129,151,3.6544117647058822
463,4,5,1,877385341,877385381,40,151,116,3.6666666666666665
463,5,4,-1,877385381,877385415,34,116,544,3.185185185185185
463,4,2,-2,877385415,877385457,42,544,235,3.106382978723404
463,2,4,2,877385457,877385531,74,235,1115,3.3846153846153846
463,4,4,0,877385531,877385590,59,1115,125,3.5555555555555554
463,4,2,-2,877385590,877385615,25,125,870,2.75
463,2,3,1,877385615,877385664,49,870,282,3.610526315789474
463,3,3,0,877385664,877385731,67,282,596,3.180327868852459
463,3,3,0,877385731,877385797,66,596,121,3.521212121212121
463,3,4,1,877385797,877385830,33,121,16,3.411764705882353
463,4,3,-1,877385830,877385862,32,16,866,3.3962264150943398
463,3,4,1,877385862,877385922,60,866,740,3.423076923076923
463,4,1,-3,877385922,877385954,32,740,1117,3.0
463,1,4,3,877385954,877385982,28,1117,1163,2.1666666666666665
463,4,3,-1,877385982,877386047,65,1163,1009,3.2962962962962963
463,3,2,-1,877386047,877386082,35,1009,1028,2.857142857142857
463,2,2,0,877386082,877386083,1,1028,3,3.0625
463,2,4,2,877386083,889935837,12549754,3,1377,3.5
463,4,4,0,889935837,889935910,73,1377,257,3.7154471544715446
463,4,3,-1,889935910,889935953,43,257,248,3.746268656716418
463,3,2,-1,889935953,889936035,82,248,249,3.3275862068965516
463,2,3,1,889936035,889936181,146,249,107,3.45
463,3,2,-1,889936181,889936324,143,107,1014,3.1
463,2,3,1,889936324,889936490,166,1014,310,3.6666666666666665
463,3,5,2,889936490,889936512,22,310,301,3.2465753424657535
463,5,3,-2,889936512,889936535,23,301,270,3.7804878048780486
463,3,2,-1,889936535,889936565,30,270,1606,2.0
463,2,2,0,889936565,889936774,209,1606,892,2.9615384615384617
463,2,4,2,889936774,889936814,40,892,311,3.761904761904762
463,4,1,-3,889936814,889943741,6927,311,362,2.1666666666666665
463,1,4,3,889943741,889943769,28,362,751,3.3896103896103895
463,4,1,-3,889943769,889943811,42,751,271,3.3134328358208953
463,1,1,0,889943811,889943851,40,271,288,3.5214285714285714
463,1,4,3,889943851,890452525,508674,288,880,2.8421052631578947
463,4,1,-3,890452525,890530286,77761,880,410,3.0434782608695654
463,1,1,0,890530286,890530329,43,410,1244,2.7777777777777777
463,1,3,2,890530329,890530351,22,1244,864,3.2142857142857144
463,3,4,1,890530351,890530818,467,864,50,4.306532663316583
471,2,4,2,889827757,889827822,65,404,95,3.8194444444444446
471,4,5,1,889827822,889828026,204,95,225,3.0714285714285716
471,5,5,0,889828026,889828027,1,225,932,2.5
471,5,5,0,889828027,889828081,54,932,102,3.3684210526315788
471,5,2,-3,889828081,889828154,73,102,969,3.8947368421052633
474,3,1,-2,887914822,887914878,56,326,259,2.492063492063492
474,1,5,4,887914878,887914979,101,259,316,4.285714285714286
474,5,2,-3,887914979,887915020,41,316,678,2.8181818181818183
474,2,3,1,887915020,887915082,62,678,343,3.0
474,3,5,2,887915082,887915188,106,343,150,3.803921568627451
474,5,5,0,887915188,887915221,33,150,50,4.306532663316583
474,5,5,0,887915221,887915269,48,50,124,4.052631578947368
474,5,3,-2,887915269,887915306,37,124,1134,2.888888888888889
474,3,3,0,887915306,887915307,1,1134,471,3.5714285714285716
474,3,4,1,887915307,887915366,59,471,126,3.8620689655172415
474,4,5,1,887915366,887915413,47,126,100,4.0162162162162165
474,5,3,-2,887915413,887915437,24,100,283,3.901639344262295
474,3,5,2,887915437,887915511,74,283,181,3.98974358974359
474,5,3,-2,887915511,887915567,56,181,1016,3.559322033898305
474,3,2,-1,887915567,887915645,78,1016,410,3.0434782608695654
474,2,1,-1,887915645,887915646,1,410,756,2.6885245901639343
474,1,2,1,887915646,887915684,38,756,411,2.911764705882353
474,2,3,1,887915684,887915784,100,411,685,3.2666666666666666
474,3,3,0,887915784,887916260,476,685,744,3.5714285714285716
474,3,3,0,887916260,887916330,70,744,274,3.5609756097560976
474,3,3,0,887916330,887916369,39,274,676,3.3142857142857145
474,3,4,1,887916369,887916411,42,676,282,3.610526315789474
474,4,1,-3,887916411,887916438,27,282,1028,2.857142857142857
474,1,4,3,887916438,887916567,129,1028,252,2.911392405063291
474,4,5,1,887916567,887916608,41,252,25,3.3185840707964602
474,5,5,0,887916608,887923788,7180,25,234,3.7674418604651163
474,5,5,0,887923788,887923789,1,234,191,4.168674698795181
474,5,5,0,887923789,887923923,134,191,185,3.9726027397260273
474,5,5,0,887923923,887923924,1,185,182,3.842857142857143
474,5,4,-1,887923924,887923972,48,182,134,4.174603174603175
474,4,5,1,887923972,887924028,56,134,657,4.341463414634147
474,5,4,-1,887924028,887924083,55,657,238,3.888888888888889
474,4,4,0,887924083,887924084,1,238,663,3.948717948717949
474,4,4,0,887924084,887924469,385,663,971,4.0
474,4,5,1,887924469,887924618,149,971,357,4.063291139240507
474,5,4,-1,887924618,887924619,1,357,28,3.923076923076923
474,4,5,1,887924619,887924683,64,28,12,4.358974358974359
474,5,4,-1,887924683,887925187,504,12,136,3.764705882352941
474,4,3,-1,887925187,887925497,310,136,200,3.8157894736842106
474,3,3,0,887925497,887925620,123,200,60,4.105263157894737
474,3,3,0,887925620,887925621,1,60,198,4.04
474,3,5,2,887925621,887925750,129,198,174,4.253521126760563
474,5,4,-1,887925750,887925838,88,174,492,4.117647058823529
474,4,4,0,887925838,887925916,78,492,469,3.6842105263157894
474,4,4,0,887925916,887925977,61,469,58,3.543859649122807
474,4,3,-1,887925977,887926105,128,58,671,3.4285714285714284
474,3,5,2,887926105,887926106,1,671,77,3.3857142857142857
474,5,4,-1,887926106,887926271,165,77,956,3.5714285714285716
474,4,3,-1,887926271,887926436,165,956,602,3.533333333333333
474,3,5,2,887926436,887926437,1,602,188,3.625
474,5,4,-1,887926437,887926573,136,188,143,3.56
474,4,4,0,887926573,887926632,59,143,923,4.142857142857143
474,4,4,0,887926632,887926633,1,923,737,3.12
474,4,4,0,887926633,887926872,239,737,607,4.136363636363637
474,4,4,0,887926872,887926998,126,607,848,4.0
474,4,4,0,887926998,887927152,154,848,1124,3.75
474,4,4,0,887927152,887927153,1,1124,481,3.8421052631578947
474,4,3,-1,887927153,887927338,185,481,1518,3.142857142857143
474,3,5,2,887927338,887927456,118,1518,199,4.191489361702128
474,5,4,-1,887927456,887927457,1,199,618,3.5
474,4,4,0,887927457,887927509,52,618,213,3.943396226415094
474,4,4,0,887927509,887927588,79,213,649,3.625
474,4,5,1,887927588,887927670,82,649,209,3.8275862068965516
474,5,5,0,887927670,887928755,1085,209,709,4.171428571428572
474,5,3,-2,887928755,887928793,38,709,73,3.588235294117647
474,3,5,2,887928793,888628044,699251,73,285,4.181818181818182
469,4,5,1,879450473,879523803,73330,306,507,3.6285714285714286
469,5,4,-1,879523803,879523891,88,507,153,3.7865168539325844
469,4,4,0,879523891,879523947,56,153,610,3.1818181818181817
469,4,4,0,879523947,879524006,59,610,168,4.0476190476190474
469,4,4,0,879524006,879524062,56,168,136,3.764705882352941
469,4,5,1,879524062,879524117,55,136,474,4.172413793103448
469,5,4,-1,879524117,879524178,61,474,65,3.511111111111111
469,4,4,0,879524178,879524302,124,65,605,3.3333333333333335
469,4,5,1,879524302,879524376,74,605,530,4.125
469,5,5,0,879524376,879524485,109,530,499,4.0
469,5,5,0,879524485,879525373,888,499,10,3.85
464,4,4,0,878354680,878354681,1,321,748,3.1043478260869564
464,4,4,0,878354681,878354721,40,748,294,3.1052631578947367
464,4,5,1,878354721,878354722,1,294,292,3.6666666666666665
464,5,4,-1,878354722,878354761,39,292,333,3.546666666666667
464,4,4,0,878354761,878354762,1,333,270,3.7804878048780486
464,4,4,0,878354762,878354791,29,270,299,3.0
464,4,2,-2,878354791,878354829,38,299,1025,2.95
464,2,5,3,878354829,878354859,30,1025,307,3.6031746031746033
464,5,5,0,878354859,878354965,106,307,515,4.202898550724638
464,5,4,-1,878354965,878354966,1,515,50,4.306532663316583
464,4,5,1,878354966,878354998,32,50,248,3.746268656716418
464,5,5,0,878354998,878355033,35,248,295,3.769230769230769
464,5,4,-1,878355033,878355061,28,295,298,3.779220779220779
464,4,4,0,878355061,878355088,27,298,257,3.7154471544715446
464,4,4,0,878355088,878355167,79,257,116,3.6666666666666665
464,4,4,0,878355167,878355211,44,116,176,3.967032967032967
464,4,5,1,878355211,878355258,47,176,482,3.9444444444444446
464,5,5,0,878355258,878355259,1,482,194,4.029411764705882
476,3,3,0,883364218,883364295,77,435,746,3.7560975609756095
476,3,4,1,883364295,883364324,29,746,201,3.75
476,4,4,0,883364324,883364325,1,201,204,3.6744186046511627
476,4,3,-1,883364325,883364392,67,204,47,3.5869565217391304
476,3,4,1,883364392,883364475,83,47,26,3.36
476,4,4,0,883364475,883364717,242,26,88,3.433734939759036
476,4,4,0,883364717,883364745,28,88,715,3.257142857142857
476,4,2,-2,883364745,883364780,35,715,1188,2.45
476,2,3,1,883364780,883364812,32,1188,738,3.0
476,3,2,-1,883364812,883364813,1,738,944,2.75
476,2,4,2,883364813,883365135,322,944,781,3.4166666666666665
476,4,4,0,883365135,883365218,83,781,67,3.106382978723404
476,4,4,0,883365218,883365274,56,67,384,2.7941176470588234
476,4,3,-1,883365274,883365336,62,384,1180,2.6666666666666665
476,3,1,-2,883365336,883365384,48,1180,1037,2.0
476,1,2,1,883365384,883365385,1,1037,579,2.727272727272727
476,2,4,2,883365385,883365442,57,579,765,3.0
476,4,4,0,883365442,883365503,61,765,268,3.9838709677419355
476,4,5,1,883365503,883365561,58,268,300,3.6861313868613137
476,5,1,-4,883365561,883365684,123,300,325,2.625
476,1,4,3,883365684,883365734,50,325,288,3.5214285714285714
476,4,4,0,883365734,883365784,50,288,245,3.056179775280899
478,3,3,0,889387471,889387577,106,300,327,3.5076923076923077
478,3,4,1,889387577,889387931,354,327,1,3.902439024390244
478,4,3,-1,889387931,889387958,27,1,591,3.7169811320754715
478,3,5,2,889387958,889388038,80,591,151,3.6544117647058822
478,5,4,-1,889388038,889388098,60,151,150,3.803921568627451
478,4,4,0,889388098,889388137,39,150,283,3.901639344262295
478,4,4,0,889388137,889388161,24,283,762,3.3962264150943398
478,4,1,-3,889388161,889388273,112,762,866,3.3962264150943398
478,1,5,4,889388273,889388375,102,866,763,3.347826086956522
478,5,3,-2,889388375,889388429,54,763,369,2.5714285714285716
478,3,1,-2,889388429,889388534,105,369,743,1.9545454545454546
478,1,2,1,889388534,889388562,28,743,23,3.9047619047619047
478,2,4,2,889388562,889388587,25,23,48,4.055555555555555
478,4,4,0,889388587,889388658,71,48,204,3.6744186046511627
478,4,4,0,889388658,889388697,39,204,168,4.0476190476190474
478,4,5,1,889388697,889388724,27,168,357,4.063291139240507
478,5,5,0,889388724,889388763,39,357,42,3.893617021276596
478,5,3,-2,889388763,889388790,27,42,71,3.6575342465753424
478,3,5,2,889388790,889388862,72,71,288,3.5214285714285714
478,5,5,0,889388862,889388863,1,288,237,3.7315436241610738
478,5,5,0,889388863,889389014,151,237,182,3.842857142857143
478,5,5,0,889389014,889395563,6549,182,467,4.071428571428571
478,5,4,-1,889395563,889395638,75,467,518,3.5833333333333335
478,4,3,-1,889395638,889395678,40,518,32,3.7222222222222223
478,3,3,0,889395678,889395696,18,32,673,3.393939393939394
478,3,3,0,889395696,889395921,225,673,196,3.9404761904761907
478,3,3,0,889395921,889395977,56,196,658,3.393939393939394
478,3,4,1,889395977,889396005,28,658,1101,3.793103448275862
478,4,5,1,889396005,889396029,24,1101,216,3.8454545454545452
478,5,4,-1,889396029,889396049,20,216,959,3.4583333333333335
478,4,2,-2,889396049,889396102,53,959,869,3.0
478,2,2,0,889396102,889396180,78,869,17,3.032258064516129
478,2,5,3,889396180,889396212,32,17,26,3.36
478,5,4,-1,889396212,889396235,23,26,367,3.4242424242424243
478,4,4,0,889396235,889396256,21,367,202,3.730337078651685
478,4,3,-1,889396256,889396330,74,202,41,3.0625
478,3,3,0,889396330,889396449,119,41,1041,3.3333333333333335
478,3,2,-1,889396449,889396509,60,1041,96,3.9130434782608696
478,2,4,2,889396509,889396582,73,96,188,3.625
478,4,3,-1,889396582,889396645,63,188,161,3.5844155844155843
478,3,4,1,889396645,889396732,87,161,447,3.46875
478,4,5,1,889396732,889396797,65,447,143,3.56
478,5,2,-3,889396797,889396917,120,143,946,3.1153846153846154
478,2,3,1,889396917,889397239,322,946,708,3.3157894736842106
478,3,5,2,889397239,889397306,67,708,15,3.725663716814159
478,5,3,-2,889397306,889397343,37,15,1521,3.0
478,3,2,-1,889397343,889397467,124,1521,134,4.174603174603175
478,2,3,1,889397467,889397808,341,134,780,3.08
478,3,5,2,889397808,889398260,452,780,340,3.7419354838709675
478,5,4,-1,889398260,889398363,103,340,255,3.2027027027027026
478,4,4,0,889398363,889398528,165,255,739,3.391304347826087
478,4,2,-2,889398528,889398571,43,739,392,3.5555555555555554
473,3,5,2,878156857,878156932,75,327,268,3.9838709677419355
473,5,5,0,878156932,878157299,367,268,127,4.162790697674419
473,5,2,-3,878157299,878157329,30,127,7,3.76056338028169
473,2,4,2,878157329,878157357,28,7,124,4.052631578947368
473,4,3,-1,878157357,878157427,70,124,813,4.055555555555555
473,3,4,1,878157427,878157507,80,813,293,3.630434782608696
473,4,5,1,878157507,878157544,37,293,116,3.6666666666666665
473,5,3,-2,878157544,878157600,56,116,547,3.6666666666666665
473,3,4,1,878157600,878157648,48,547,256,3.5
470,3,4,1,879178237,879178257,20,294,305,3.5789473684210527
470,4,3,-1,879178257,879178274,17,305,327,3.5076923076923077
470,3,4,1,879178274,879178370,96,327,100,4.0162162162162165
470,4,3,-1,879178370,879178406,36,100,1084,4.0
470,3,3,0,879178406,879178428,22,1084,1,3.902439024390244
470,3,4,1,879178428,879178455,27,1,742,3.5555555555555554
470,4,3,-1,879178455,879178486,31,742,124,4.052631578947368
470,3,4,1,879178486,879178518,32,124,13,3.5454545454545454
470,4,3,-1,879178518,879178542,24,13,129,3.744186046511628
470,3,4,1,879178542,879178568,26,129,1067,3.533333333333333
470,4,4,0,879178568,879178593,25,1067,277,3.6
470,4,4,0,879178593,879178645,52,277,118,3.2764227642276422
470,4,4,0,879178645,879178731,86,118,824,2.590909090909091
470,4,2,-2,879178731,879178777,46,824,291,3.2
470,2,4,2,879178777,879178813,36,291,19,3.9615384615384617
470,4,3,-1,879178813,879178830,17,19,544,3.185185185185185
470,3,4,1,879178830,879178884,54,544,284,3.1547619047619047
470,4,5,1,879178884,879178932,48,284,508,3.6923076923076925
470,5,4,-1,879178932,879178950,18,508,546,2.9789473684210526
470,4,4,0,879178950,879178969,19,546,125,3.5555555555555554
470,4,2,-2,879178969,879189269,10300,125,360,2.0
470,2,2,0,879189269,879189432,163,360,246,4.0
470,2,3,1,879189432,879189434,2,246,248,3.746268656716418
480,3,4,1,891207605,891207715,110,347,1007,4.117647058823529
480,4,4,0,891207715,891207951,236,1007,50,4.306532663316583
480,4,1,-3,891207951,891207975,24,50,249,3.3275862068965516
480,1,4,3,891207975,891208037,62,249,257,3.7154471544715446
480,4,1,-3,891208037,891208058,21,257,294,3.1052631578947367
480,1,5,4,891208058,891208185,127,294,166,4.0
480,5,4,-1,891208185,891208186,1,166,485,3.717948717948718
480,4,4,0,891208186,891208215,29,485,479,4.25
480,4,4,0,891208215,891208239,24,479,603,4.315789473684211
480,4,5,1,891208239,891208265,26,603,190,4.233333333333333
480,5,3,-2,891208265,891208293,28,190,483,4.475609756097561
480,3,5,2,891208293,891208327,34,483,169,4.548387096774194
480,5,5,0,891208327,891208356,29,169,174,4.253521126760563
480,5,3,-2,891208356,891208390,34,174,265,3.710144927536232
480,3,4,1,891208390,891208460,70,265,517,3.625
480,4,4,0,891208460,891208492,32,517,56,4.051724137931035
480,4,4,0,891208492,891208520,28,56,462,3.7954545454545454
480,4,5,1,891208520,891208576,56,462,8,3.903225806451613
480,5,4,-1,891208576,891208623,47,8,96,3.9130434782608696
480,4,2,-2,891208623,891208650,27,96,208,3.8125
480,2,4,2,891208650,891208651,1,208,183,3.951219512195122
480,4,4,0,891208651,891208689,38,183,1121,3.5
480,4,4,0,891208689,891208718,29,1121,79,3.956989247311828
480,4,4,0,891208718,891208746,28,79,443,3.8421052631578947
480,4,4,0,891208746,891208769,23,443,234,3.7674418604651163
480,4,4,0,891208769,891208822,53,234,642,3.4285714285714284
441,3,3,0,891035144,891035211,67,538,259,2.492063492063492
441,3,4,1,891035211,891035247,36,259,751,3.3896103896103895
441,4,4,0,891035247,891035267,20,751,342,2.64
441,4,4,0,891035267,891035289,22,342,338,2.75
441,4,2,-2,891035289,891035350,61,338,683,2.176470588235294
441,2,3,1,891035350,891035441,91,683,100,4.0162162162162165
441,3,4,1,891035441,891035468,27,100,7,3.76056338028169
441,4,4,0,891035468,891035489,21,7,121,3.521212121212121
441,4,3,-1,891035489,891035507,18,121,405,3.25
441,3,3,0,891035507,891035699,192,405,15,3.725663716814159
479,3,4,1,879459578,879459611,33,294,328,3.4895833333333335
479,4,2,-2,879459611,879459641,30,328,300,3.6861313868613137
479,2,4,2,879459641,879459657,16,300,879,3.2291666666666665
479,4,3,-1,879459657,879459710,53,879,748,3.1043478260869564
479,3,1,-2,879459710,879459732,22,748,358,2.6551724137931036
479,1,3,2,879459732,879459752,20,358,335,2.5
479,3,3,0,879459752,879459791,39,335,266,2.6666666666666665
479,3,3,0,879459791,879459836,45,266,288,3.5214285714285714
479,3,3,0,879459836,879459909,73,288,298,3.779220779220779
479,3,5,2,879459909,879459939,30,298,1,3.902439024390244
479,5,4,-1,879459939,879459955,16,1,257,3.7154471544715446
479,4,5,1,879459955,879460028,73,257,181,3.98974358974359
479,5,5,0,879460028,879460091,63,181,408,4.4772727272727275
479,5,4,-1,879460091,879460140,49,408,283,3.901639344262295
479,4,4,0,879460140,879460160,20,283,50,4.306532663316583
479,4,1,-3,879460160,879460192,32,50,1028,2.857142857142857
479,1,3,2,879460192,879460254,62,1028,1016,3.559322033898305
479,3,3,0,879460254,879460285,31,1016,281,3.2
479,3,2,-1,879460285,879460305,20,281,546,2.9789473684210526
479,2,4,2,879460305,879460323,18,546,111,3.5106382978723403
479,4,2,-2,879460323,879460354,31,111,148,3.2131147540983607
479,2,4,2,879460354,879460370,16,148,274,3.5609756097560976
479,4,4,0,879460370,879460393,23,274,250,3.4698795180722892
479,4,4,0,879460393,879460424,31,250,108,3.107142857142857
479,4,1,-3,879460424,879460453,29,108,1013,2.388888888888889
479,1,3,2,879460453,879460503,50,1013,235,3.106382978723404
479,3,1,-2,879460503,879460547,44,235,840,3.090909090909091
479,1,2,1,879460547,879460562,15,840,831,2.6097560975609757
479,2,2,0,879460562,879460628,66,831,252,2.911392405063291
479,2,1,-1,879460628,879460648,20,252,986,2.5555555555555554
479,1,2,1,879460648,879460681,33,986,931,2.2758620689655173
479,2,4,2,879460681,879460762,81,931,421,3.462962962962963
479,4,4,0,879460762,879460785,23,421,187,4.215189873417722
479,4,4,0,879460785,879460819,34,187,180,3.9473684210526314
479,4,4,0,879460819,879460844,25,180,483,4.475609756097561
479,4,3,-1,879460844,879460893,49,483,203,3.826923076923077
479,3,4,1,879460893,879460894,1,203,523,4.159090909090909
479,4,5,1,879460894,879460917,23,523,169,4.548387096774194
479,5,4,-1,879460917,879460918,1,169,265,3.710144927536232
479,4,4,0,879460918,879460959,41,265,96,3.9130434782608696
479,4,4,0,879460959,879460984,25,96,182,3.842857142857143
479,4,3,-1,879460984,879460999,15,182,131,3.731707317073171
479,3,3,0,879460999,879461015,16,131,205,3.717391304347826
479,3,5,2,879461015,879461039,24,205,647,4.142857142857143
479,5,4,-1,879461039,879461060,21,647,528,4.241379310344827
479,4,2,-2,879461060,879461084,24,528,423,3.7016129032258065
479,2,4,2,879461084,879461102,18,423,197,4.112676056338028
479,4,4,0,879461102,879461120,18,197,732,3.6266666666666665
479,4,4,0,879461120,879461142,22,732,201,3.75
479,4,3,-1,879461142,879461161,19,201,629,3.3333333333333335
479,3,5,2,879461161,879461179,18,629,498,4.290909090909091
479,5,4,-1,879461179,879461255,76,498,500,4.285714285714286
479,4,5,1,879461255,879461279,24,500,474,4.172413793103448
479,5,4,-1,879461279,879461337,58,474,510,3.823529411764706
479,4,4,0,879461337,879461354,17,510,190,4.233333333333333
479,4,4,0,879461354,879461378,24,190,479,4.25
479,4,3,-1,879461378,879461399,21,479,161,3.5844155844155843
479,3,5,2,879461399,879461415,16,161,8,3.903225806451613
479,5,4,-1,879461415,879461432,17,8,58,3.543859649122807
479,4,4,0,879461432,879461447,15,58,136,3.764705882352941
479,4,4,0,879461447,879461492,45,136,602,3.533333333333333
479,4,3,-1,879461492,879461530,38,602,670,2.9375
479,3,2,-1,879461530,879461545,15,670,188,3.625
479,2,4,2,879461545,879461567,22,188,202,3.730337078651685
479,4,4,0,879461567,879461583,16,202,204,3.6744186046511627
479,4,4,0,879461583,879461604,21,204,185,3.9726027397260273
479,4,4,0,879461604,879461630,26,185,70,3.5833333333333335
479,4,3,-1,879461630,879461700,70,70,692,3.56
479,3,4,1,879461700,879461741,41,692,144,3.9545454545454546
479,4,4,0,879461741,879461756,15,144,509,3.7058823529411766
479,4,4,0,879461756,879461781,25,509,164,3.6140350877192984
479,4,3,-1,879461781,879461800,19,164,566,3.543859649122807
479,3,5,2,879461800,879461818,18,566,727,3.5517241379310347
479,5,4,-1,879461818,879461856,38,727,436,3.5
479,4,3,-1,879461856,879461873,17,436,584,3.5238095238095237
479,3,4,1,879461873,879461898,25,584,82,3.6741573033707864
479,4,4,0,879461898,879461914,16,82,151,3.6544117647058822
479,4,1,-3,879461914,879461932,18,151,739,3.391304347826087
479,1,5,4,879461932,879461951,19,739,609,3.7058823529411766
479,5,3,-2,879461951,879461988,37,609,403,3.298507462686567
479,3,3,0,879461988,879462007,19,403,62,3.048780487804878
479,3,4,1,879462007,879462041,34,62,88,3.433734939759036
479,4,4,0,879462041,879462062,21,88,616,3.1052631578947367
479,4,3,-1,879462062,879462121,59,616,54,3.3714285714285714
479,3,4,1,879462121,879462140,19,54,153,3.7865168539325844
479,4,1,-3,879462140,879462203,63,153,756,2.6885245901639343
479,1,1,0,879462203,879533993,71790,756,261,2.7333333333333334
479,1,1,0,879533993,887064372,7530379,261,338,2.75
479,1,3,2,887064372,887064404,32,338,680,2.8333333333333335
479,3,1,-2,887064404,887064434,30,680,688,2.111111111111111
479,1,3,2,887064434,887064690,256,688,535,3.380952380952381
479,3,3,0,887064690,887064767,77,535,118,3.2764227642276422
479,3,3,0,887064767,889125284,2060517,118,752,3.6666666666666665
479,3,1,-2,889125284,889125474,190,752,398,2.1
479,1,2,1,889125474,889125499,25,398,1608,2.25
479,2,4,2,889125499,889125562,63,1608,176,3.967032967032967
479,4,5,1,889125562,889125563,1,176,183,3.951219512195122
479,5,3,-2,889125563,889125627,64,183,117,3.689189189189189
479,3,3,0,889125627,889125665,38,117,147,3.3142857142857145
479,3,5,2,889125665,889125718,53,147,470,3.72
479,5,5,0,889125718,889125737,19,470,480,4.283018867924528
479,5,4,-1,889125737,889125759,22,480,751,3.3896103896103895
479,4,5,1,889125759,889125775,16,751,200,3.8157894736842106
479,5,4,-1,889125775,889125798,23,200,357,4.063291139240507
479,4,5,1,889125798,889125837,39,357,174,4.253521126760563
479,5,4,-1,889125837,889125853,16,174,455,3.1702127659574466
479,4,4,0,889125853,889125866,13,455,210,3.921259842519685
479,4,4,0,889125866,889125905,39,210,31,3.642857142857143
479,4,5,1,889125905,889125921,16,31,651,3.8627450980392157
479,5,5,0,889125921,889126007,86,651,168,4.0476190476190474
484,3,3,0,880270616,881449561,1178945,252,25,3.3185840707964602
484,3,4,1,881449561,881449706,145,25,7,3.76056338028169
484,4,3,-1,881449706,881449737,31,7,742,3.5555555555555554
484,3,1,-2,881449737,881449826,89,742,24,3.3728813559322033
484,1,4,3,881449826,881450017,191,24,125,3.5555555555555554
484,4,4,0,881450017,881450085,68,125,274,3.5609756097560976
484,4,3,-1,881450085,881450112,27,274,237,3.7315436241610738
484,3,4,1,881450112,881450136,24,237,926,2.7857142857142856
484,4,3,-1,881450136,882079980,629844,926,255,3.2027027027027026
484,3,5,2,882079980,883402900,1322920,255,222,3.578125
484,5,2,-3,883402900,883402932,32,222,343,3.0
484,2,3,1,883402932,883973609,570677,343,315,4.15
484,3,4,1,883973609,885237963,1264354,315,14,4.101694915254237
484,4,4,0,885237963,891194665,5956702,14,879,3.2291666666666665
484,4,4,0,891194665,891194692,27,879,431,3.422222222222222
484,4,5,1,891194692,891194716,24,431,153,3.7865168539325844
484,5,5,0,891194716,891194766,50,153,136,3.764705882352941
484,5,5,0,891194766,891194820,54,136,655,3.7857142857142856
484,5,5,0,891194820,891194841,21,655,22,4.215909090909091
484,5,5,0,891194841,891194864,23,22,732,3.6266666666666665
484,5,5,0,891194864,891194886,22,732,468,3.380952380952381
484,5,5,0,891194886,891194932,46,468,318,4.5046728971962615
484,5,5,0,891194932,891194957,25,318,97,3.7282608695652173
484,5,5,0,891194957,891194998,41,97,692,3.56
484,5,5,0,891194998,891195036,38,692,70,3.5833333333333335
484,5,5,0,891195036,891195057,21,70,204,3.6744186046511627
484,5,4,-1,891195057,891195105,48,204,216,3.8454545454545452
484,4,4,0,891195105,891195154,49,216,4,3.5538461538461537
484,4,4,0,891195154,891195179,25,4,88,3.433734939759036
484,4,4,0,891195179,891195199,20,88,73,3.588235294117647
484,4,4,0,891195199,891195219,20,73,186,3.905263157894737
484,4,5,1,891195219,891195246,27,186,778,3.5925925925925926
484,5,4,-1,891195246,891195298,52,778,176,3.967032967032967
484,4,4,0,891195298,891195323,25,176,183,3.951219512195122
484,4,5,1,891195323,891195349,26,183,195,3.9072164948453607
484,5,4,-1,891195349,891195390,41,195,550,3.272727272727273
484,4,4,0,891195390,891195416,26,550,566,3.543859649122807
484,4,4,0,891195416,891195444,28,566,161,3.5844155844155843
484,4,5,1,891195444,891195476,32,161,265,3.710144927536232
484,5,4,-1,891195476,891195506,30,265,823,2.75
484,4,3,-1,891195506,891195532,26,823,29,2.5714285714285716
484,3,4,1,891195532,891195565,33,29,399,3.317073170731707
484,4,2,-2,891195565,891195663,98,399,829,2.4615384615384617
484,2,4,2,891195663,891195687,24,829,98,4.240875912408759
484,4,4,0,891195687,891195773,86,98,95,3.8194444444444446
484,4,4,0,891195773,891195856,83,95,94,2.8823529411764706
484,4,3,-1,891195856,891195857,1,94,415,2.6666666666666665
484,3,4,1,891195857,891195886,29,415,560,3.111111111111111
484,4,4,0,891195886,891195973,87,560,197,4.112676056338028
486,1,4,3,879874017,879874018,1,262,242,3.5217391304347827
486,4,1,-3,879874018,879874063,45,242,306,4.033333333333333
486,1,3,2,879874063,879874064,1,306,268,3.9838709677419355
486,3,5,2,879874064,879874112,48,268,880,2.8421052631578947
486,5,4,-1,879874112,879874153,41,880,288,3.5214285714285714
486,4,3,-1,879874153,879874186,33,288,304,3.5306122448979593
486,3,3,0,879874186,879874218,32,304,305,3.5789473684210527
486,3,3,0,879874218,879874262,44,305,264,2.65
486,3,1,-2,879874262,879874297,35,264,678,2.8181818181818183
486,1,4,3,879874297,879874388,91,678,303,3.75
486,4,3,-1,879874388,879874417,29,303,1171,2.857142857142857
486,3,3,0,879874417,879874418,1,1171,277,3.6
486,3,5,2,879874418,879874448,30,277,127,4.162790697674419
486,5,3,-2,879874448,879874481,33,127,408,4.4772727272727275
486,3,5,2,879874481,879874482,1,408,285,4.181818181818182
486,5,3,-2,879874482,879874515,33,285,1302,4.0
486,3,5,2,879874515,879874516,1,1302,1405,3.3333333333333335
486,5,3,-2,879874516,879874582,66,1405,1369,2.0
486,3,3,0,879874582,879874629,47,1369,236,3.2666666666666666
486,3,3,0,879874629,879874630,1,236,295,3.769230769230769
486,3,4,1,879874630,879874663,33,295,1514,3.6666666666666665
486,4,3,-1,879874663,879874692,29,1514,1611,3.0
486,3,2,-1,879874692,879874693,1,1611,742,3.5555555555555554
486,2,5,3,879874693,879874725,32,742,1142,4.0476190476190474
486,5,3,-2,879874725,879874726,1,1142,1143,3.3333333333333335
486,3,5,2,879874726,879874753,27,1143,7,3.76056338028169
486,5,3,-2,879874753,879874783,30,7,975,3.411764705882353
486,3,4,1,879874783,879874810,27,975,108,3.107142857142857
486,4,2,-2,879874810,879874811,1,108,1610,2.5
486,2,2,0,879874811,879874838,27,1610,1094,3.2
486,2,4,2,879874838,879874870,32,1094,1,3.902439024390244
486,4,3,-1,879874870,879874871,1,1,298,3.779220779220779
486,3,3,0,879874871,879874902,31,298,919,4.0
486,3,2,-1,879874902,879874903,1,919,148,3.2131147540983607
486,2,3,1,879874903,879874939,36,148,222,3.578125
486,3,4,1,879874939,879874969,30,222,276,3.6036036036036037
486,4,3,-1,879874969,879874970,1,276,1017,3.0
486,3,3,0,879874970,879875040,70,1017,1134,2.888888888888889
486,3,3,0,879875040,879875041,1,1134,696,3.138888888888889
486,3,3,0,879875041,879875069,28,696,20,3.375
486,3,2,-1,879875069,879875154,85,20,846,3.1052631578947367
486,2,3,1,879875154,879875187,33,846,597,3.2771084337349397
486,3,2,-1,879875187,879875188,1,597,146,2.3333333333333335
486,2,3,1,879875188,879875220,32,146,244,2.9411764705882355
486,3,2,-1,879875220,879875221,1,244,1082,2.6666666666666665
486,2,3,1,879875221,879875278,57,1082,628,3.573529411764706
486,3,4,1,879875278,879875279,1,628,287,3.4516129032258065
486,4,3,-1,879875279,879875315,36,287,257,3.7154471544715446
486,3,3,0,879875315,879875316,1,257,831,2.6097560975609757
486,3,3,0,879875316,879875371,55,831,476,3.1216216216216215
486,3,2,-1,879875371,879875408,37,476,595,2.9166666666666665
486,2,2,0,879875408,879875440,32,595,546,2.9789473684210526
486,2,3,1,879875440,879875441,1,546,220,3.433333333333333
486,3,3,0,879875441,879875465,24,220,1120,3.1
487,2,4,2,883439831,883440540,709,286,748,3.1043478260869564
487,4,4,0,883440540,883440572,32,748,294,3.1052631578947367
487,4,1,-3,883440572,883440613,41,294,340,3.7419354838709675
487,1,2,1,883440613,883441083,470,340,259,2.492063492063492
487,2,3,1,883441083,883441956,873,259,471,3.5714285714285716
487,3,5,2,883441956,883442053,97,471,742,3.5555555555555554
487,5,5,0,883442053,883442105,52,742,100,4.0162162162162165
487,5,5,0,883442105,883442430,325,100,150,3.803921568627451
487,5,5,0,883442430,883442431,1,150,298,3.779220779220779
487,5,5,0,883442431,883444515,2084,298,1016,3.559322033898305
487,5,4,-1,883444515,883444558,43,1016,24,3.3728813559322033
487,4,5,1,883444558,883444583,25,24,3,3.0625
487,5,4,-1,883444583,883444631,48,3,274,3.5609756097560976
487,4,3,-1,883444631,883444674,43,274,825,2.914285714285714
487,3,5,2,883444674,883444736,62,825,125,3.5555555555555554
487,5,3,-2,883444736,883444768,32,125,1011,3.1
487,3,3,0,883444768,883444793,25,1011,411,2.911764705882353
487,3,4,1,883444793,883444832,39,411,121,3.521212121212121
487,4,2,-2,883444832,883444859,27,121,1244,2.7777777777777777
487,2,5,3,883444859,883444860,1,1244,280,3.103448275862069
487,5,3,-2,883444860,883444884,24,280,820,3.0444444444444443
487,3,1,-2,883444884,883445130,246,820,25,3.3185840707964602
487,1,2,1,883445130,883445168,38,25,841,2.772727272727273
487,2,1,-1,883445168,883445220,52,841,412,2.272727272727273
487,1,1,0,883445220,883445251,31,412,978,2.357142857142857
487,1,5,4,883445251,883445495,244,978,11,3.8904109589041096
487,5,5,0,883445495,883445580,85,11,12,4.358974358974359
487,5,5,0,883445580,883445606,26,12,651,3.8627450980392157
487,5,4,-1,883445606,883445721,115,651,710,3.41025641025641
487,4,5,1,883445721,883445859,138,710,64,4.373737373737374
487,5,5,0,883445859,883445943,84,64,202,3.730337078651685
487,5,4,-1,883445943,883446027,84,202,156,4.017857142857143
487,4,5,1,883446027,883446322,295,156,194,4.029411764705882
487,5,5,0,883446322,883446404,82,194,174,4.253521126760563
487,5,5,0,883446404,883446543,139,174,79,3.956989247311828
487,5,5,0,883446543,883446600,57,79,97,3.7282608695652173
487,5,5,0,883446600,883446637,37,97,183,3.951219512195122
487,5,5,0,883446637,883446685,48,183,31,3.642857142857143
487,5,5,0,883446685,883446725,40,31,144,3.9545454545454546
487,5,3,-2,883446725,883446757,32,144,939,3.6333333333333333
487,3,5,2,883446757,883446801,44,939,96,3.9130434782608696
487,5,5,0,883446801,883446830,29,96,196,3.9404761904761907
487,5,4,-1,883446830,883446872,42,196,95,3.8194444444444446
487,4,5,1,883446872,883446907,35,95,58,3.543859649122807
487,5,3,-2,883446907,883447015,108,58,432,3.719298245614035
487,3,5,2,883447015,883447117,102,432,1019,3.7777777777777777
487,5,2,-3,883447117,883447118,1,1019,53,2.9523809523809526
487,2,4,2,883447118,883529505,82387,53,210,3.921259842519685
487,4,4,0,883529505,883529540,35,210,746,3.7560975609756095
487,4,3,-1,883529540,883529593,53,746,431,3.422222222222222
487,3,5,2,883529593,883530374,781,431,652,3.9642857142857144
487,5,4,-1,883530374,883530434,60,652,99,3.8392857142857144
487,4,4,0,883530434,883530454,20,99,385,3.6129032258064515
487,4,5,1,883530454,883530484,30,385,66,3.4705882352941178
487,5,5,0,883530484,883530503,19,66,794,3.6
487,5,5,0,883530503,883530562,59,794,966,4.7
487,5,3,-2,883530562,883530644,82,966,419,3.8208955223880596
487,3,3,0,883530644,883530674,30,419,367,3.4242424242424243
487,3,4,1,883530674,883530702,28,367,956,3.5714285714285716
487,4,2,-2,883530702,883530724,22,956,679,3.2432432432432434
487,2,4,2,883530724,883530764,40,679,232,3.0789473684210527
487,4,3,-1,883530764,883530786,22,232,71,3.6575342465753424
487,3,3,0,883530786,883530814,28,71,77,3.3857142857142857
487,3,3,0,883530814,883530841,27,77,143,3.56
487,3,4,1,883530841,883530865,24,143,133,3.7777777777777777
487,4,3,-1,883530865,883530885,20,133,772,3.3333333333333335
487,3,3,0,883530885,883530929,44,772,70,3.5833333333333335
487,3,5,2,883530929,883530949,20,70,68,3.5714285714285716
487,5,5,0,883530949,883530973,24,68,378,3.6904761904761907
487,5,4,-1,883530973,883531003,30,378,4,3.5538461538461537
487,4,3,-1,883531003,883531085,82,4,226,3.378787878787879
487,3,3,0,883531085,883531279,194,226,227,3.169811320754717
487,3,5,2,883531279,883531333,54,227,128,3.45
487,5,3,-2,883531333,884025080,493747,128,1217,3.4166666666666665
487,3,3,0,884025080,884029774,4694,1217,727,3.5517241379310347
487,3,3,0,884029774,884042207,12433,727,229,3.185185185185185
487,3,3,0,884042207,884042630,423,229,62,3.048780487804878
487,3,3,0,884042630,884045361,2731,62,1188,2.45
487,3,4,1,884045361,884045494,133,1188,1440,3.0
487,4,4,0,884045494,884046879,1385,1440,549,3.4871794871794872
487,4,2,-2,884046879,884050192,3313,549,540,2.4615384615384617
487,2,3,1,884050192,884050247,55,540,67,3.106382978723404
487,3,3,0,884050247,884050838,591,67,94,2.8823529411764706
487,3,2,-1,884050838,884050879,41,94,779,2.2
487,2,1,-1,884050879,884050940,61,779,572,2.857142857142857
487,1,4,3,884050940,884051006,66,572,802,3.076923076923077
487,4,1,-3,884051006,884051840,834,802,1074,2.857142857142857
482,3,4,1,887643146,887643289,143,315,328,3.4895833333333335
482,4,4,0,887643289,887643315,26,328,301,3.2465753424657535
482,4,4,0,887643315,887643340,25,301,311,3.761904761904762
482,4,4,0,887643340,887643365,25,311,294,3.1052631578947367
482,4,4,0,887643365,887643461,96,294,245,3.056179775280899
482,4,4,0,887643461,887643499,38,245,988,2.5555555555555554
482,4,4,0,887643499,887644063,564,988,127,4.162790697674419
482,4,4,0,887644063,887644085,22,127,298,3.779220779220779
481,5,3,-2,885827974,885828072,98,181,1089,2.1363636363636362
481,3,5,2,885828072,885828165,93,1089,153,3.7865168539325844
481,5,3,-2,885828165,885828203,38,153,66,3.4705882352941178
481,3,4,1,885828203,885828245,42,66,238,3.888888888888889
481,4,4,0,885828245,885828297,52,238,663,3.948717948717949
481,4,4,0,885828297,885828339,42,663,692,3.56
481,4,4,0,885828339,885828389,50,692,163,3.53125
481,4,4,0,885828389,885828426,37,163,100,4.0162162162162165
481,4,5,1,885828426,885828510,84,100,435,3.8933333333333335
481,5,5,0,885828510,885828543,33,435,191,4.168674698795181
481,5,5,0,885828543,885828574,31,191,505,4.0625
481,5,5,0,885828574,885828619,45,505,498,4.290909090909091
481,5,4,-1,885828619,885828686,67,498,484,4.116279069767442
481,4,5,1,885828686,885828732,46,484,190,4.233333333333333
481,5,4,-1,885828732,885828773,41,190,596,3.180327868852459
481,4,5,1,885828773,885829153,380,596,659,4.027777777777778
481,5,3,-2,885829153,885829196,43,659,4,3.5538461538461537
481,3,4,1,885829196,885829240,44,4,202,3.730337078651685
492,4,3,-1,879969323,879969345,22,654,657,4.341463414634147
492,3,3,0,879969345,879969367,22,657,212,3.230769230769231
492,3,3,0,879969367,879969415,48,212,514,4.033333333333333
492,3,3,0,879969415,879969454,39,514,86,3.869565217391304
492,3,3,0,879969454,879969512,58,86,185,3.9726027397260273
492,3,3,0,879969512,879969539,27,185,186,3.905263157894737
492,3,3,0,879969539,879969583,44,186,479,4.25
492,3,3,0,879969583,879969644,61,479,134,4.174603174603175
492,3,1,-2,879969644,879969670,26,134,1147,3.4
492,1,4,3,879969670,879969692,22,1147,291,3.2
492,4,2,-2,879969692,879969720,28,291,1121,3.5
492,2,3,1,879969720,879969814,94,1121,45,4.130434782608695
493,3,4,1,884129793,884129823,30,262,879,3.2291666666666665
493,4,3,-1,884129823,884129868,45,879,754,3.5789473684210527
493,3,4,1,884129868,884129979,111,754,323,3.0
493,4,4,0,884129979,884130032,53,323,338,2.75
493,4,1,-3,884130032,884130055,23,338,687,2.1481481481481484
493,1,3,2,884130055,884130253,198,687,742,3.5555555555555554
493,3,2,-1,884130253,884130271,18,742,369,2.5714285714285716
493,2,5,3,884130271,884130308,37,369,181,3.98974358974359
493,5,3,-2,884130308,884130372,64,181,7,3.76056338028169
493,3,4,1,884130372,884130387,15,7,250,3.4698795180722892
493,4,3,-1,884130387,884130416,29,250,222,3.578125
493,3,4,1,884130416,884130439,23,222,762,3.3962264150943398
493,4,5,1,884130439,884130495,56,762,257,3.7154471544715446
493,5,3,-2,884130495,884130516,21,257,151,3.6544117647058822
493,3,4,1,884130516,884130550,34,151,1016,3.559322033898305
493,4,4,0,884130550,884130593,43,1016,763,3.347826086956522
493,4,4,0,884130593,884130619,26,763,284,3.1547619047619047
493,4,3,-1,884130619,884130668,49,284,925,3.0
493,3,4,1,884130668,884130793,125,925,180,3.9473684210526314
493,4,5,1,884130793,884130825,32,180,171,4.090909090909091
493,5,3,-2,884130825,884130852,27,171,11,3.8904109589041096
493,3,5,2,884130852,884130891,39,11,357,4.063291139240507
493,5,4,-1,884130891,884130911,20,357,56,4.051724137931035
493,4,4,0,884130911,884130933,22,56,196,3.9404761904761907
493,4,5,1,884130933,884130971,38,196,182,3.842857142857143
493,5,5,0,884130971,884131020,49,182,71,3.6575342465753424
493,5,5,0,884131020,884131048,28,71,265,3.710144927536232
493,5,4,-1,884131048,884131114,66,265,173,4.1441441441441444
493,4,5,1,884131114,884131143,29,173,168,4.0476190476190474
493,5,3,-2,884131143,884131211,68,168,174,4.253521126760563
493,3,4,1,884131211,884131263,52,174,61,4.190476190476191
493,4,5,1,884131263,884131287,24,61,95,3.8194444444444446
493,5,3,-2,884131287,884131314,27,95,195,3.9072164948453607
493,3,1,-2,884131314,884131357,43,195,275,4.087912087912088
493,1,5,4,884131357,884131480,123,275,274,3.5609756097560976
493,5,2,-3,884131480,884131517,37,274,1126,3.625
493,2,5,3,884131517,884131597,80,1126,172,4.225225225225225
493,5,4,-1,884131597,884131665,68,172,115,3.6666666666666665
493,4,5,1,884131665,884131690,25,115,121,3.521212121212121
493,5,4,-1,884131690,884131717,27,121,273,3.5238095238095237
493,4,4,0,884131717,884131738,21,273,597,3.2771084337349397
493,4,2,-2,884131738,884131777,39,597,1088,2.4
493,2,4,2,884131777,884131933,156,1088,175,3.8354430379746836
493,4,3,-1,884131933,884131985,52,175,238,3.888888888888889
493,3,2,-1,884131985,884132015,30,238,462,3.7954545454545454
493,2,5,3,884132015,884132037,22,462,234,3.7674418604651163
493,5,5,0,884132037,884132058,21,234,82,3.6741573033707864
493,5,4,-1,884132058,884132129,71,82,693,3.6285714285714286
493,4,4,0,884132129,884132146,17,693,65,3.511111111111111
493,4,4,0,884132146,884132181,35,65,550,3.272727272727273
493,4,5,1,884132181,884132197,16,550,176,3.967032967032967
493,5,5,0,884132197,884132225,28,176,183,3.951219512195122
493,5,3,-2,884132225,884132246,21,183,134,4.174603174603175
493,3,3,0,884132246,884132267,21,134,317,3.774193548387097
493,3,3,0,884132267,884132287,20,317,91,3.6
493,3,5,2,884132287,884132315,28,91,318,4.5046728971962615
493,5,4,-1,884132315,884132351,36,318,404,3.6578947368421053
493,4,4,0,884132351,884132784,433,404,249,3.3275862068965516
493,4,4,0,884132784,884132883,99,249,410,3.0434782608695654
493,4,4,0,884132883,884132898,15,410,118,3.2764227642276422
493,4,3,-1,884132898,884132914,16,118,974,3.125
493,3,1,-2,884132914,884132934,20,974,411,2.911764705882353
490,3,3,0,875427103,875427148,45,222,1,3.902439024390244
490,3,3,0,875427148,875427224,76,1,515,4.202898550724638
490,3,1,-2,875427224,875427225,1,515,596,3.180327868852459
490,1,4,3,875427225,875427629,404,596,741,3.3043478260869565
490,4,3,-1,875427629,875427739,110,741,7,3.76056338028169
490,3,2,-1,875427739,875427812,73,7,126,3.8620689655172415
490,2,3,1,875427812,875427873,61,126,847,3.7333333333333334
490,3,1,-2,875427873,875427948,75,847,117,3.689189189189189
490,1,2,1,875427948,875427993,45,117,293,3.630434782608696
490,2,4,2,875427993,875428152,159,293,455,3.1702127659574466
490,4,3,-1,875428152,875428185,33,455,292,3.6666666666666665
490,3,1,-2,875428185,875428309,124,292,255,3.2027027027027026
490,1,3,2,875428309,875428416,107,255,1012,3.2916666666666665
490,3,3,0,875428416,875428417,1,1012,458,3.0588235294117645
490,3,2,-1,875428417,875428570,153,458,123,3.297872340425532
490,2,3,1,875428570,875428702,132,123,987,2.0
490,3,2,-1,875428702,875428703,1,987,118,3.2764227642276422
490,2,5,3,875428703,875428765,62,118,50,4.306532663316583
489,5,4,-1,891362812,891366571,3759,359,749,3.2777777777777777
489,4,5,1,891366571,891366606,35,749,331,3.5517241379310347
489,5,3,-2,891366606,891366652,46,331,898,3.0869565217391304
489,3,2,-1,891366652,891366748,96,898,289,2.988888888888889
489,2,3,1,891366748,891366805,57,289,681,2.25
489,3,4,1,891366805,891366838,33,681,748,3.1043478260869564
489,4,4,0,891366838,891445277,78439,748,330,2.625
489,4,3,-1,891445277,891445320,43,330,324,3.2291666666666665
489,3,4,1,891445320,891445352,32,324,1238,3.0
489,4,5,1,891445352,891445388,36,1238,323,3.0
489,5,4,-1,891445388,891445389,1,323,243,2.357142857142857
489,4,3,-1,891445389,891445439,50,243,991,2.4545454545454546
489,3,2,-1,891445439,891445743,304,991,259,2.492063492063492
489,2,5,3,891445743,891446232,489,259,266,2.6666666666666665
489,5,3,-2,891446232,891447008,776,266,873,2.7586206896551726
489,3,2,-1,891447008,891447302,294,873,880,2.8421052631578947
489,2,2,0,891447302,891447586,284,880,881,2.769230769230769
489,2,3,1,891447586,891447653,67,881,1280,2.3333333333333335
489,3,5,2,891447653,891447823,170,1280,332,3.6511627906976742
489,5,3,-2,891447823,891447845,22,332,321,3.0172413793103448
489,3,5,2,891447845,891447990,145,321,890,1.7692307692307692
489,5,5,0,891447990,891448109,119,890,754,3.5789473684210527
489,5,4,-1,891448109,891448147,38,754,895,3.142857142857143
489,4,3,-1,891448147,891448200,53,895,338,2.75
489,3,4,1,891448200,891448222,22,338,538,3.25
489,4,4,0,891448222,891448367,145,538,340,3.7419354838709675
489,4,5,1,891448367,891448409,42,340,327,3.5076923076923077
489,5,3,-2,891448409,891448428,19,327,339,2.7058823529411766
489,3,2,-1,891448428,891448530,102,339,872,3.0
489,2,2,0,891448530,891448565,35,872,878,2.0
489,2,4,2,891448565,891448706,141,878,271,3.3134328358208953
489,4,4,0,891448706,891448834,128,271,539,2.6666666666666665
489,4,2,-2,891448834,891448861,27,539,688,2.111111111111111
489,2,4,2,891448861,891449022,161,688,310,3.6666666666666665
489,4,4,0,891449022,891449155,133,310,349,2.5714285714285716
489,4,3,-1,891449155,891449254,99,349,457,1.7
489,3,2,-1,891449254,891449466,212,457,1265,2.75
489,2,3,1,891449466,891449532,66,1265,892,2.9615384615384617
489,3,4,1,891449532,891449555,23,892,353,2.4285714285714284
483,4,3,-1,878950972,878951532,560,676,116,3.6666666666666665
483,3,3,0,878951532,878951717,185,116,107,3.45
483,3,2,-1,878951717,878952519,802,107,257,3.7154471544715446
483,2,5,3,878952519,878952582,63,257,283,3.901639344262295
483,5,3,-2,878952582,878952636,54,283,277,3.6
483,3,3,0,878952636,878952837,201,277,250,3.4698795180722892
483,3,2,-1,878952837,878952866,29,250,249,3.3275862068965516
483,2,3,1,878952866,878952966,100,249,405,3.25
483,3,2,-1,878952966,878952993,27,405,20,3.375
483,2,3,1,878952993,878953019,26,20,237,3.7315436241610738
483,3,3,0,878953019,878953090,71,237,473,2.9166666666666665
483,3,4,1,878953090,878953129,39,473,274,3.5609756097560976
483,4,3,-1,878953129,878953199,70,274,290,3.108108108108108
483,3,2,-1,878953199,878953277,78,290,365,2.95
483,2,3,1,878953277,878953592,315,365,227,3.169811320754717
483,3,4,1,878953592,878953593,1,227,450,2.2758620689655173
483,4,1,-3,878953593,878953693,100,450,68,3.5714285714285716
483,1,3,2,878953693,878953751,58,68,612,4.0
483,3,3,0,878953751,878953815,64,612,197,4.112676056338028
483,3,3,0,878953815,878953862,47,197,480,4.283018867924528
483,3,2,-1,878953862,878953999,137,480,12,4.358974358974359
483,2,2,0,878953999,878954086,87,12,180,3.9473684210526314
483,2,2,0,878954086,878954228,142,180,144,3.9545454545454546
483,2,5,3,878954228,882165734,3211506,144,109,3.282608695652174
483,5,3,-2,882165734,884046480,1880746,109,318,4.5046728971962615
483,3,3,0,884046480,884047323,843,318,99,3.8392857142857144
483,3,3,0,884047323,884047427,104,99,91,3.6
483,3,4,1,884047427,884047454,27,91,173,4.1441441441441444
483,4,4,0,884047454,893098572,9051118,173,1152,3.4375
496,2,3,1,876063810,876063848,38,288,333,3.546666666666667
496,3,4,1,876063848,876064198,350,333,246,4.0
496,4,2,-2,876064198,876064230,32,246,150,3.803921568627451
496,2,3,1,876064230,876064290,60,150,222,3.578125
496,3,3,0,876064290,876064356,66,222,147,3.3142857142857145
496,3,3,0,876064356,876064357,1,147,109,3.282608695652174
496,3,3,0,876064357,876065015,658,109,825,2.914285714285714
496,3,2,-1,876065015,876065105,90,825,252,2.911392405063291
496,2,2,0,876065105,876065259,154,252,183,3.951219512195122
496,2,3,1,876065259,876065324,65,183,168,4.0476190476190474
496,3,2,-1,876065324,876065382,58,168,1286,3.5714285714285716
496,2,3,1,876065382,876065499,117,1286,1401,3.0
496,3,5,2,876065499,876065558,59,1401,172,4.225225225225225
496,5,1,-4,876065558,876065588,30,172,228,3.7246376811594204
496,1,3,2,876065588,876065645,57,228,17,3.032258064516129
496,3,5,2,876065645,876065693,48,17,652,3.9642857142857144
496,5,4,-1,876065693,876065715,22,652,195,3.9072164948453607
496,4,4,0,876065715,876065881,166,195,96,3.9130434782608696
496,4,4,0,876065881,876065933,52,96,528,4.241379310344827
496,4,3,-1,876065933,876065962,29,528,469,3.6842105263157894
496,3,2,-1,876065962,876066038,76,469,135,3.7974683544303796
496,2,3,1,876066038,876066064,26,135,64,4.373737373737374
496,3,3,0,876066064,876066229,165,64,421,3.462962962962963
496,3,3,0,876066229,876066300,71,421,495,3.65
496,3,2,-1,876066300,876066353,53,495,443,3.8421052631578947
496,2,3,1,876066353,876066374,21,443,196,3.9404761904761907
496,3,1,-2,876066374,876066424,50,196,136,3.764705882352941
496,1,3,2,876066424,876066485,61,136,1063,3.642857142857143
496,3,4,1,876066485,876066507,22,1063,174,4.253521126760563
496,4,3,-1,876066507,876066531,24,174,204,3.6744186046511627
496,3,5,2,876066531,876066567,36,204,133,3.7777777777777777
496,5,3,-2,876066567,876066598,31,133,99,3.8392857142857144
496,3,4,1,876066598,876066652,54,99,432,3.719298245614035
496,4,5,1,876066652,876066676,24,432,42,3.893617021276596
496,5,1,-4,876066676,876066794,118,42,227,3.169811320754717
496,1,1,0,876066794,876066848,54,227,97,3.7282608695652173
496,1,2,1,876066848,876066874,26,97,419,3.8208955223880596
496,2,4,2,876066874,876066904,30,419,433,3.8035714285714284
496,4,4,0,876066904,876067022,118,433,11,3.8904109589041096
496,4,4,0,876067022,876067108,86,11,33,3.2941176470588234
496,4,3,-1,876067108,876067146,38,33,143,3.56
496,3,5,2,876067146,876067215,69,143,721,3.4583333333333335
496,5,3,-2,876067215,876067272,57,721,509,3.7058823529411766
496,3,4,1,876067272,876067306,34,509,625,3.25
496,4,1,-3,876067306,876067346,40,625,88,3.433734939759036
496,1,4,3,876067346,876067376,30,88,1459,3.6
496,4,3,-1,876067376,876067493,117,1459,141,3.4827586206896552
496,3,3,0,876067493,876067597,104,141,526,3.909090909090909
496,3,2,-1,876067597,876067686,89,526,142,3.1481481481481484
496,2,1,-1,876067686,876067754,68,142,416,3.3846153846153846
496,1,2,1,876067754,876068249,495,416,842,3.0
496,2,2,0,876068249,876068433,184,842,380,3.4878048780487805
496,2,5,3,876068433,876068582,149,380,561,3.1515151515151514
496,5,2,-3,876068582,876068615,33,561,38,2.784313725490196
496,2,2,0,876068615,876069951,1336,38,158,2.7027027027027026
496,2,3,1,876069951,876070690,739,158,1614,3.0
496,3,2,-1,876070690,876070764,74,1614,356,3.2
496,2,1,-1,876070764,876070859,95,356,155,3.0588235294117645
496,1,3,2,876070859,876070957,98,155,1133,3.076923076923077
496,3,1,-2,876070957,876070975,18,1133,94,2.8823529411764706
496,1,2,1,876070975,876070997,22,94,554,2.9555555555555557
496,2,1,-1,876070997,876071097,100,554,1229,2.4
496,1,1,0,876071097,876071243,146,1229,1060,3.235294117647059
496,1,5,4,876071243,876072633,1390,1060,277,3.6
496,5,5,0,876072633,876073320,687,277,217,3.1538461538461537
496,5,2,-3,876073320,876073882,562,217,1139,2.611111111111111
494,4,1,-3,879540593,879540630,37,294,289,2.988888888888889
494,1,1,0,879540630,879540720,90,289,748,3.1043478260869564
494,1,3,2,879540720,879540819,99,748,329,3.25
494,3,3,0,879540819,879540901,82,329,323,3.0
494,3,5,2,879540901,879541080,179,323,127,4.162790697674419
494,5,5,0,879541080,879541112,32,127,174,4.253521126760563
494,5,5,0,879541112,879541158,46,174,183,3.951219512195122
494,5,4,-1,879541158,879541207,49,183,507,3.6285714285714286
494,4,5,1,879541207,879541246,39,507,50,4.306532663316583
494,5,3,-2,879541246,879541298,52,50,86,3.869565217391304
494,3,3,0,879541298,879541374,76,86,1,3.902439024390244
494,3,4,1,879541374,879541375,1,1,237,3.7315436241610738
494,4,2,-2,879541375,879541404,29,237,9,3.8878504672897196
494,2,4,2,879541404,879541429,25,9,121,3.521212121212121
494,4,5,1,879541429,879541475,46,121,100,4.0162162162162165
495,5,1,-4,888632069,888632070,1,9,419,3.8208955223880596
495,1,5,4,888632070,888632134,64,419,208,3.8125
495,5,4,-1,888632134,888632155,21,208,204,3.6744186046511627
495,4,5,1,888632155,888632180,25,204,181,3.98974358974359
495,5,5,0,888632180,888632219,39,181,214,3.272727272727273
495,5,4,-1,888632219,888632250,31,214,188,3.625
495,4,5,1,888632250,888632319,69,188,174,4.253521126760563
495,5,5,0,888632319,888632378,59,174,172,4.225225225225225
495,5,4,-1,888632378,888632443,65,172,969,3.8947368421052633
495,4,4,0,888632443,888632546,103,969,504,4.085714285714285
495,4,2,-2,888632546,888632677,131,504,631,3.581818181818182
495,2,3,1,888632677,888632738,61,631,1116,3.5714285714285716
495,3,5,2,888632738,888632888,150,1116,742,3.5555555555555554
495,5,4,-1,888632888,888632916,28,742,132,3.929411764705882
495,4,5,1,888632916,888632969,53,132,82,3.6741573033707864
495,5,3,-2,888632969,888633011,42,82,84,3.0
495,3,3,0,888633011,888633042,31,84,385,3.6129032258064515
495,3,5,2,888633042,888633086,44,385,184,3.393939393939394
495,5,3,-2,888633086,888633129,43,184,4,3.5538461538461537
495,3,4,1,888633129,888633165,36,4,288,3.5214285714285714
495,4,5,1,888633165,888633194,29,288,211,3.958904109589041
495,5,4,-1,888633194,888633277,83,211,154,3.6031746031746033
495,4,5,1,888633277,888633316,39,154,265,3.710144927536232
495,5,3,-2,888633316,888633351,35,265,162,3.4651162790697674
495,3,5,2,888633351,888633396,45,162,195,3.9072164948453607
495,5,5,0,888633396,888633473,77,195,121,3.521212121212121
495,5,5,0,888633473,888633522,49,121,423,3.7016129032258065
495,5,4,-1,888633522,888633594,72,423,233,3.323529411764706
495,4,4,0,888633594,888634110,516,233,96,3.9130434782608696
495,4,4,0,888634110,888634111,1,96,705,3.7857142857142856
495,4,5,1,888634111,888634144,33,705,234,3.7674418604651163
495,5,1,-4,888634144,888634315,171,234,143,3.56
495,1,1,0,888634315,888634389,74,143,421,3.462962962962963
495,1,3,2,888634389,888634441,52,421,924,3.3703703703703702
495,3,4,1,888634441,888634475,34,924,77,3.3857142857142857
495,4,5,1,888634475,888634536,61,77,655,3.7857142857142856
495,5,4,-1,888634536,888634784,248,655,1119,3.5185185185185186
495,4,2,-2,888634784,888634859,75,1119,91,3.6
495,2,5,3,888634859,888634896,37,91,448,3.466666666666667
495,5,3,-2,888634896,888634918,22,448,229,3.185185185185185
495,3,5,2,888634918,888634956,38,229,684,3.847826086956522
495,5,5,0,888634956,888634987,31,684,68,3.5714285714285716
495,5,3,-2,888634987,888635050,63,68,402,3.3076923076923075
495,3,3,0,888635050,888635144,94,402,660,3.71875
495,3,5,2,888635144,888635180,36,660,465,3.75
495,5,5,0,888635180,888635202,22,465,232,3.0789473684210527
495,5,3,-2,888635202,888635235,33,232,550,3.272727272727273
495,3,5,2,888635235,888635236,1,550,151,3.6544117647058822
495,5,1,-4,888635236,888635294,58,151,568,3.5853658536585367
495,1,3,2,888635294,888635339,45,568,380,3.4878048780487805
495,3,5,2,888635339,888635419,80,380,140,3.238095238095238
495,5,4,-1,888635419,888635420,1,140,447,3.46875
495,4,3,-1,888635420,888635455,35,447,155,3.0588235294117645
495,3,4,1,888635455,888635524,69,155,797,3.1538461538461537
495,4,2,-2,888635524,888635595,71,797,2,3.0851063829787235
495,2,3,1,888635595,888635937,342,2,62,3.048780487804878
495,3,1,-2,888635937,888635995,58,62,1419,1.7142857142857142
495,1,3,2,888635995,888636032,37,1419,629,3.3333333333333335
495,3,4,1,888636032,888636062,30,629,1263,3.1666666666666665
495,4,3,-1,888636062,888636216,154,1263,768,3.238095238095238
495,3,5,2,888636216,888636511,295,768,1079,2.1923076923076925
495,5,2,-3,888636511,888636573,62,1079,29,2.5714285714285716
495,2,3,1,888636573,888636635,62,29,67,3.106382978723404
495,3,3,0,888636635,888636741,106,67,417,3.0588235294117645
495,3,4,1,888636741,888636773,32,417,240,3.0350877192982457
495,4,3,-1,888636773,888636837,64,240,386,2.769230769230769
495,3,5,2,888636837,888636870,33,386,379,3.35
495,5,3,-2,888636870,888636871,1,379,1182,2.4285714285714284
495,3,5,2,888636871,888636899,28,1182,416,3.3846153846153846
495,5,4,-1,888636899,888636928,29,416,573,2.909090909090909
495,4,3,-1,888636928,888636958,30,573,444,2.6842105263157894
495,3,3,0,888636958,888636992,34,444,80,2.967741935483871
495,3,2,-1,888636992,888637018,26,80,1444,2.3333333333333335
495,2,4,2,888637018,888637070,52,1444,796,2.923076923076923
495,4,1,-3,888637070,888637169,99,796,665,2.72972972972973
495,1,4,3,888637169,888637228,59,665,1183,2.5
495,4,5,1,888637228,888637300,72,1183,1207,2.125
495,5,1,-4,888637300,888637325,25,1207,831,2.6097560975609757
495,1,3,2,888637325,888637440,115,831,576,3.125
495,3,3,0,888637440,888637477,37,576,158,2.7027027027027026
495,3,4,1,888637477,888637503,26,158,1091,2.5384615384615383
495,4,5,1,888637503,888637643,140,1091,389,3.272727272727273
477,4,4,0,875940755,875940836,81,756,369,2.5714285714285716
477,4,4,0,875940836,875941022,186,369,280,3.103448275862069
477,4,5,1,875941022,875941085,63,280,88,3.433734939759036
477,5,4,-1,875941085,875941086,1,88,724,3.64
477,4,4,0,875941086,875941111,25,724,794,3.6
477,4,5,1,875941111,875941155,44,794,49,3.3
477,5,4,-1,875941155,875941191,36,49,778,3.5925925925925926
477,4,4,0,875941191,875941224,33,778,36,2.4
477,4,5,1,875941224,875941225,1,36,1041,3.3333333333333335
477,5,4,-1,875941225,875941275,50,1041,731,3.4
477,4,4,0,875941275,875941863,588,731,15,3.725663716814159
477,4,4,0,875941863,875941888,25,15,20,3.375
477,4,4,0,875941888,875941948,60,20,282,3.610526315789474
477,4,4,0,875941948,875942042,94,282,846,3.1052631578947367
497,4,4,0,878759378,878759432,54,358,748,3.1043478260869564
497,4,4,0,878759432,878759659,227,748,56,4.051724137931035
497,4,3,-1,878759659,878759705,46,56,194,4.029411764705882
497,3,5,2,878759705,878759777,72,194,652,3.9642857142857144
497,5,4,-1,878759777,878759806,29,652,186,3.905263157894737
497,4,2,-2,878759806,878759898,92,186,83,4.204081632653061
497,2,1,-1,878759898,878759926,28,83,412,2.272727272727273
497,1,4,3,878759926,879309673,549747,412,248,3.746268656716418
497,4,5,1,879309673,879309734,61,248,249,3.3275862068965516
497,5,2,-3,879309734,879309759,25,249,926,2.7857142857142856
497,2,3,1,879309759,879309760,1,926,108,3.107142857142857
497,3,4,1,879309760,879309780,20,108,25,3.3185840707964602
497,4,1,-3,879309780,879309802,22,25,122,2.282608695652174
497,1,2,1,879309802,879309836,34,122,105,2.6176470588235294
497,2,2,0,879309836,879309852,16,105,407,2.611111111111111
497,2,2,0,879309852,879309869,17,407,1052,2.4545454545454546
497,2,4,2,879309869,879309955,86,1052,1,3.902439024390244
497,4,4,0,879309955,879309993,38,1,189,3.88
497,4,4,0,879309993,879310021,28,189,946,3.1153846153846154
497,4,4,0,879310021,879310245,224,946,19,3.9615384615384617
497,4,4,0,879310245,879310260,15,19,24,3.3728813559322033
497,4,3,-1,879310260,879310314,54,24,237,3.7315436241610738
497,3,3,0,879310314,879310399,85,237,216,3.8454545454545452
497,3,3,0,879310399,879310419,20,216,197,4.112676056338028
497,3,3,0,879310419,879310474,55,197,731,3.4
497,3,4,1,879310474,879310508,34,731,402,3.3076923076923075
497,4,3,-1,879310508,879310522,14,402,155,3.0588235294117645
497,3,3,0,879310522,879310580,58,155,298,3.779220779220779
497,3,3,0,879310580,879310581,1,298,250,3.4698795180722892
497,3,4,1,879310581,879310604,23,250,1016,3.559322033898305
497,4,4,0,879310604,879310621,17,1016,118,3.2764227642276422
497,4,3,-1,879310621,879310650,29,118,472,2.984375
497,3,3,0,879310650,879310679,29,472,840,3.090909090909091
497,3,4,1,879310679,879310705,26,840,174,4.253521126760563
497,4,4,0,879310705,879310730,25,174,33,3.2941176470588234
497,4,4,0,879310730,879310762,32,33,651,3.8627450980392157
497,4,3,-1,879310762,879310792,30,651,184,3.393939393939394
497,3,5,2,879310792,879310825,33,184,187,4.215189873417722
497,5,4,-1,879310825,879310883,58,187,399,3.317073170731707
497,4,4,0,879310883,879310913,30,399,550,3.272727272727273
497,4,2,-2,879310913,879310941,28,550,720,3.2
497,2,3,1,879310941,879310965,24,720,38,2.784313725490196
497,3,3,0,879310965,879361727,50762,38,123,3.297872340425532
497,3,3,0,879361727,879361744,17,123,928,3.142857142857143
497,3,3,0,879361744,879361802,58,928,603,4.315789473684211
497,3,4,1,879361802,879361872,70,603,164,3.6140350877192984
497,4,4,0,879361872,879362019,147,164,943,3.6666666666666665
497,4,3,-1,879362019,879362041,22,943,1046,3.3529411764705883
497,3,3,0,879362041,879362093,52,1046,77,3.3857142857142857
497,3,2,-1,879362093,879362118,25,77,802,3.076923076923077
497,2,3,1,879362118,879362155,37,802,552,2.8095238095238093
497,3,3,0,879362155,879362178,23,552,1042,3.625
497,3,2,-1,879362178,879362202,24,1042,452,2.6129032258064515
497,2,2,0,879362202,879362292,90,452,758,2.2857142857142856
497,2,2,0,879362292,879362359,67,758,569,2.4285714285714284
497,2,4,2,879362359,879362382,23,569,217,3.1538461538461537
497,4,2,-2,879362382,879362407,25,217,441,2.4
497,2,3,1,879362407,879362430,23,441,769,2.2222222222222223
497,3,2,-1,879362430,879362461,31,769,590,1.8888888888888888
497,2,3,1,879362461,879362496,35,590,510,3.823529411764706
497,3,3,0,879362496,879362511,15,510,570,3.526315789473684
497,3,3,0,879362511,879362545,34,570,391,2.4285714285714284
497,3,4,1,879362545,879362546,1,391,541,2.9473684210526314
497,4,3,-1,879362546,879362586,40,541,797,3.1538461538461537
497,3,4,1,879362586,879362638,52,797,771,2.5714285714285716
497,4,3,-1,879362638,879362683,45,771,204,3.6744186046511627
497,3,2,-1,879362683,879362720,37,204,790,2.8518518518518516
497,2,3,1,879362720,879362740,20,790,721,3.4583333333333335
497,3,4,1,879362740,879362798,58,721,70,3.5833333333333335
497,4,3,-1,879362798,879362835,37,70,805,3.909090909090909
497,3,4,1,879362835,879362875,40,805,372,3.6666666666666665
497,4,3,-1,879362875,879362908,33,372,783,2.388888888888889
497,3,2,-1,879362908,879363111,203,783,386,2.769230769230769
497,2,3,1,879363111,879363133,22,386,94,2.8823529411764706
497,3,3,0,879363133,879363155,22,94,765,3.0
497,3,2,-1,879363155,879363181,26,765,163,3.53125
497,2,1,-1,879363181,879363205,24,163,1185,2.111111111111111
497,1,3,2,879363205,879363233,28,1185,545,1.7142857142857142
497,3,3,0,879363233,879363253,20,545,725,3.0
497,3,3,0,879363253,879363565,312,725,87,3.9
497,3,3,0,879363565,879363586,21,87,423,3.7016129032258065
497,3,3,0,879363586,879363610,24,423,465,3.75
497,3,2,-1,879363610,879363611,1,465,416,3.3846153846153846
497,2,2,0,879363611,879363627,16,416,417,3.0588235294117645
497,2,2,0,879363627,879363695,68,417,951,2.6666666666666665
497,2,3,1,879363695,879363696,1,951,139,2.7222222222222223
497,3,1,-2,879363696,879363780,84,139,1030,2.3636363636363638
488,2,3,1,891292682,891292771,89,288,751,3.3896103896103895
488,3,1,-2,891292771,891292852,81,751,286,3.442857142857143
488,1,3,2,891292852,891292897,45,286,245,3.056179775280899
488,3,3,0,891292897,891293009,112,245,322,3.0476190476190474
488,3,3,0,891293009,891293051,42,322,358,2.6551724137931036
488,3,3,0,891293051,891293152,101,358,873,2.7586206896551726
488,3,1,-2,891293152,891293263,111,873,289,2.988888888888889
488,1,2,1,891293263,891293304,41,289,260,2.4716981132075473
488,2,2,0,891293304,891293400,96,260,678,2.8181818181818183
488,2,1,-1,891293400,891293478,78,678,890,1.7692307692307692
488,1,4,3,891293478,891293606,128,890,754,3.5789473684210527
488,4,3,-1,891293606,891293660,54,754,483,4.475609756097561
488,3,4,1,891293660,891293698,38,483,183,3.951219512195122
488,4,4,0,891293698,891293699,1,183,515,4.202898550724638
488,4,3,-1,891293699,891293734,35,515,182,3.842857142857143
488,3,4,1,891293734,891293805,71,182,28,3.923076923076923
488,4,3,-1,891293805,891293863,58,28,187,4.215189873417722
488,3,4,1,891293863,891293910,47,187,168,4.0476190476190474
488,4,3,-1,891293910,891293974,64,168,196,3.9404761904761907
488,3,3,0,891293974,891294014,40,196,405,3.25
488,3,4,1,891294014,891294108,94,405,186,3.905263157894737
488,4,4,0,891294108,891294158,50,186,211,3.958904109589041
488,4,4,0,891294158,891294210,52,211,612,4.0
488,4,3,-1,891294210,891294246,36,612,655,3.7857142857142856
488,3,3,0,891294246,891294297,51,655,493,3.909090909090909
488,3,3,0,891294297,891294298,1,493,485,3.717948717948718
488,3,2,-1,891294298,891294365,67,485,509,3.7058823529411766
488,2,3,1,891294365,891294400,35,509,589,4.384615384615385
488,3,4,1,891294400,891294439,39,589,31,3.642857142857143
488,4,4,0,891294439,891294473,34,31,265,3.710144927536232
488,4,5,1,891294473,891294529,56,265,64,4.373737373737374
488,5,4,-1,891294529,891294530,1,64,526,3.909090909090909
488,4,4,0,891294530,891294568,38,526,15,3.725663716814159
488,4,2,-2,891294568,891294606,38,15,200,3.8157894736842106
488,2,3,1,891294606,891294707,101,200,498,4.290909090909091
488,3,5,2,891294707,891294742,35,498,215,3.662921348314607
488,5,2,-3,891294742,891294785,43,215,216,3.8454545454545452
488,2,4,2,891294785,891294853,68,216,174,4.253521126760563
488,4,4,0,891294853,891294854,1,174,228,3.7246376811594204
488,4,3,-1,891294854,891294896,42,228,1,3.902439024390244
488,3,3,0,891294896,891294942,46,1,207,3.4761904761904763
488,3,3,0,891294942,891295067,125,207,8,3.903225806451613
488,3,2,-1,891295067,891375784,80717,8,492,4.117647058823529
488,2,4,2,891375784,891375822,38,492,198,4.04
488,4,3,-1,891375822,891375900,78,198,230,3.3518518518518516
488,3,1,-2,891375900,891375965,65,230,238,3.888888888888889
488,1,4,3,891375965,891375991,26,238,429,3.742857142857143
488,4,4,0,891375991,891376029,38,429,222,3.578125
488,4,5,1,891376029,891376046,17,222,190,4.233333333333333
488,5,3,-2,891376046,891376110,64,190,480,4.283018867924528
488,3,4,1,891376110,891376137,27,480,185,3.9726027397260273
498,3,3,0,881953659,881954357,698,302,137,3.9545454545454546
498,3,4,1,881954357,881954451,94,137,919,4.0
498,4,3,-1,881954451,881954617,166,919,475,3.956043956043956
498,3,2,-1,881954617,881954618,1,475,262,3.5217391304347827
498,2,3,1,881954618,881954741,123,262,7,3.76056338028169
498,3,2,-1,881954741,881954931,190,7,9,3.8878504672897196
498,2,2,0,881954931,881955080,149,9,258,3.7547169811320753
498,2,3,1,881955080,881955189,109,258,109,3.282608695652174
498,3,3,0,881955189,881955291,102,109,100,4.0162162162162165
498,3,3,0,881955291,881955867,576,100,509,3.7058823529411766
498,3,4,1,881955867,881955960,93,509,187,4.215189873417722
498,4,4,0,881955960,881956140,180,187,151,3.6544117647058822
498,4,3,-1,881956140,881956362,222,151,172,4.225225225225225
498,3,4,1,881956362,881956363,1,172,663,3.948717948717949
498,4,3,-1,881956363,881956499,136,663,522,3.8461538461538463
498,3,4,1,881956499,881956575,76,522,64,4.373737373737374
498,4,3,-1,881956575,881956576,1,64,1286,3.5714285714285716
498,3,5,2,881956576,881957054,478,1286,156,4.017857142857143
498,5,4,-1,881957054,881957195,141,156,238,3.888888888888889
498,4,2,-2,881957195,881957267,72,238,548,2.0
498,2,5,3,881957267,881957353,86,548,89,3.9615384615384617
498,5,4,-1,881957353,881957431,78,89,61,4.190476190476191
498,4,2,-2,881957431,881957489,58,61,265,3.710144927536232
498,2,5,3,881957489,881957546,57,265,192,4.090909090909091
498,5,3,-2,881957546,881957625,79,192,693,3.6285714285714286
498,3,4,1,881957625,881957681,56,693,98,4.240875912408759
498,4,3,-1,881957681,881957757,76,98,527,3.823529411764706
498,3,3,0,881957757,881957846,89,527,83,4.204081632653061
498,3,4,1,881957846,881957847,1,83,1103,3.5555555555555554
498,4,3,-1,881957847,881957905,58,1103,631,3.581818181818182
498,3,4,1,881957905,881958093,188,631,514,4.033333333333333
498,4,5,1,881958093,881958174,81,514,160,3.4
498,5,3,-2,881958174,881958237,63,160,443,3.8421052631578947
498,3,3,0,881958237,881958238,1,443,212,3.230769230769231
498,3,3,0,881958238,881958343,105,212,673,3.393939393939394
498,3,5,2,881958343,881958414,71,673,197,4.112676056338028
498,5,4,-1,881958414,881958471,57,197,464,3.8
498,4,3,-1,881958471,881959018,547,464,933,2.5
498,3,3,0,881959018,881959104,86,933,79,3.956989247311828
498,3,4,1,881959104,881960591,1487,79,186,3.905263157894737
498,4,5,1,881960591,881960711,120,186,10,3.85
498,5,3,-2,881960711,881960777,66,10,1161,3.4
498,3,3,0,881960777,881961496,719,1161,1073,3.6315789473684212
498,3,4,1,881961496,881961627,131,1073,628,3.573529411764706
499,4,4,0,882995625,882995808,183,300,301,3.2465753424657535
499,4,4,0,882995808,882995923,115,301,312,3.0
499,4,3,-1,882995923,882996761,838,312,50,4.306532663316583
499,3,4,1,882996761,882996793,32,50,7,3.76056338028169
499,4,5,1,882996793,885597747,2600954,7,750,4.027777777777778
499,5,5,0,885597747,885597821,74,750,313,4.323076923076923
499,5,4,-1,885597821,885597901,80,313,898,3.0869565217391304
499,4,4,0,885597901,885597932,31,898,347,3.59375
499,4,4,0,885597932,885598312,380,347,127,4.162790697674419
499,4,5,1,885598312,885598342,30,127,257,3.7154471544715446
499,5,5,0,885598342,885598378,36,257,1302,4.0
499,5,5,0,885598378,885598854,476,1302,483,4.475609756097561
499,5,4,-1,885598854,885598895,41,483,651,3.8627450980392157
499,4,2,-2,885598895,885598932,37,651,258,3.7547169811320753
499,2,4,2,885598932,885599013,81,258,484,4.116279069767442
499,4,4,0,885599013,885599040,27,484,100,4.0162162162162165
499,4,4,0,885599040,885599073,33,100,524,4.166666666666667
499,4,4,0,885599073,885599119,46,524,521,3.787878787878788
499,4,5,1,885599119,885599182,63,521,1101,3.793103448275862
499,5,3,-2,885599182,885599201,19,1101,210,3.921259842519685
499,3,3,0,885599201,885599246,45,210,117,3.689189189189189
499,3,4,1,885599246,885599269,23,117,153,3.7865168539325844
499,4,5,1,885599269,885599286,17,153,318,4.5046728971962615
499,5,5,0,885599286,885599307,21,318,173,4.1441441441441444
499,5,4,-1,885599307,885599334,27,173,588,3.8358208955223883
499,4,5,1,885599334,885599372,38,588,357,4.063291139240507
499,5,4,-1,885599372,885599390,18,357,530,4.125
499,4,5,1,885599390,885599413,23,530,205,3.717391304347826
499,5,4,-1,885599413,885599447,34,205,176,3.967032967032967
499,4,3,-1,885599447,885599474,27,176,661,4.133333333333334
499,3,4,1,885599474,885599475,1,661,215,3.662921348314607
499,4,2,-2,885599475,885599498,23,215,497,3.35
499,2,1,-1,885599498,885599533,35,497,605,3.3333333333333335
499,1,2,1,885599533,885599551,18,605,182,3.842857142857143
499,2,3,1,885599551,885599572,21,182,520,4.136363636363637
499,3,4,1,885599572,885599660,88,520,525,4.0
499,4,5,1,885599660,885599682,22,525,8,3.903225806451613
499,5,5,0,885599682,885599718,36,8,663,3.948717948717949
499,5,4,-1,885599718,892501128,6901410,663,915,4.0
499,4,5,1,892501128,892501173,45,915,902,3.9444444444444446
499,5,1,-4,892501173,892501259,86,902,1483,3.25
491,4,2,-2,891185170,891185298,128,129,14,4.101694915254237
491,2,3,1,891185298,891185330,32,14,284,3.1547619047619047
491,3,5,2,891185330,891189306,3976,284,657,4.341463414634147
491,5,5,0,891189306,891189631,325,657,45,4.130434782608695
491,5,4,-1,891189631,891189716,85,45,340,3.7419354838709675
491,4,5,1,891189716,891189761,45,340,900,4.2
491,5,4,-1,891189761,891189815,54,900,258,3.7547169811320753
491,4,2,-2,891189815,891189842,27,258,294,3.1052631578947367
500,3,3,0,883864578,883864749,171,294,328,3.4895833333333335
500,3,4,1,883864749,883864793,44,328,319,3.0408163265306123
500,4,4,0,883864793,883864818,25,319,289,2.988888888888889
500,4,3,-1,883864818,883864992,174,289,50,4.306532663316583
500,3,4,1,883864992,883865020,28,50,1326,3.6666666666666665
500,4,4,0,883865020,883865021,1,1326,1012,3.2916666666666665
500,4,4,0,883865021,883865042,21,1012,9,3.8878504672897196
500,4,5,1,883865042,883865104,62,9,7,3.76056338028169
500,5,4,-1,883865104,883865128,24,7,295,3.769230769230769
500,4,2,-2,883865128,883865129,1,295,15,3.725663716814159
500,2,4,2,883865129,883865195,66,15,250,3.4698795180722892
500,4,5,1,883865195,883865232,37,250,475,3.956043956043956
500,5,3,-2,883865232,883865268,36,475,287,3.4516129032258065
500,3,1,-2,883865268,883865290,22,287,1163,2.1666666666666665
500,1,3,2,883865290,883865321,31,1163,257,3.7154471544715446
500,3,3,0,883865321,883865391,70,257,10,3.85
500,3,3,0,883865391,883865462,71,10,181,3.98974358974359
500,3,3,0,883865462,883865483,21,181,237,3.7315436241610738
500,3,4,1,883865483,883865532,49,237,762,3.3962264150943398
500,4,4,0,883865532,883865566,34,762,845,3.661290322580645
500,4,4,0,883865566,883865567,1,845,405,3.25
500,4,3,-1,883865567,883865632,65,405,125,3.5555555555555554
500,3,4,1,883865632,883865715,83,125,1226,3.5454545454545454
500,4,3,-1,883865715,883865755,40,1226,25,3.3185840707964602
500,3,4,1,883865755,883865786,31,25,3,3.0625
500,4,3,-1,883865786,883865826,40,3,120,2.3421052631578947
500,3,2,-1,883865826,883865889,63,120,252,2.911392405063291
500,2,3,1,883865889,883865929,40,252,930,2.793103448275862
500,3,3,0,883865929,883865952,23,930,370,2.8125
500,3,3,0,883865952,883865985,33,370,1047,2.6923076923076925
500,3,3,0,883865985,883866004,19,1047,831,2.6097560975609757
500,3,4,1,883866004,883873505,7501,831,89,3.9615384615384617
500,4,4,0,883873505,883873616,111,89,168,4.0476190476190474
500,4,4,0,883873616,883873640,24,168,709,4.171428571428572
500,4,4,0,883873640,883873679,39,709,443,3.8421052631578947
500,4,3,-1,883873679,883873745,66,443,448,3.466666666666667
500,3,4,1,883873745,883873782,37,448,179,3.8823529411764706
500,4,4,0,883873782,883873839,57,179,238,3.888888888888889
500,4,5,1,883873839,883873940,101,238,611,4.384615384615385
500,5,4,-1,883873940,883873941,1,611,735,3.58
500,4,5,1,883873941,883873976,35,735,56,4.051724137931035
500,5,5,0,883873976,883873999,23,56,708,3.3157894736842106
500,5,4,-1,883873999,883874039,40,708,483,4.475609756097561
500,4,3,-1,883874039,883874059,20,483,151,3.6544117647058822
500,3,4,1,883874059,883874139,80,151,1166,3.8
500,4,4,0,883874139,883874170,31,1166,45,4.130434782608695
500,4,4,0,883874170,883874216,46,45,509,3.7058823529411766
500,4,4,0,883874216,883874239,23,509,202,3.730337078651685
500,4,3,-1,883874239,883874265,26,202,204,3.6744186046511627
500,3,3,0,883874265,883874290,25,204,210,3.921259842519685
500,3,5,2,883874290,883874341,51,210,175,3.8354430379746836
500,5,4,-1,883874341,883874413,72,175,425,3.7027027027027026
500,4,4,0,883874413,883874469,56,425,164,3.6140350877192984
500,4,5,1,883874469,883874557,88,164,60,4.105263157894737
500,5,4,-1,883874557,883874558,1,60,529,4.142857142857143
500,4,4,0,883874558,883874621,63,529,8,3.903225806451613
500,4,4,0,883874621,883874776,155,8,640,2.75
500,4,4,0,883874776,883874835,59,640,196,3.9404761904761907
500,4,3,-1,883874835,883875092,257,196,143,3.56
500,3,3,0,883875092,883875136,44,143,557,3.090909090909091
500,3,4,1,883875136,883875195,59,557,639,4.083333333333333
500,4,1,-3,883875195,883875241,46,639,996,2.1666666666666665
500,1,4,3,883875241,883875274,33,996,464,3.8
500,4,4,0,883875274,883875275,1,464,30,3.8181818181818183
500,4,4,0,883875275,883875303,28,30,421,3.462962962962963
500,4,4,0,883875303,883875388,85,421,70,3.5833333333333335
500,4,4,0,883875388,883875431,43,70,61,4.190476190476191
500,4,4,0,883875431,883875468,37,61,1195,3.5
500,4,4,0,883875468,883875501,33,1195,1616,4.0
500,4,3,-1,883875501,883875561,60,1616,1135,3.0526315789473686
500,3,4,1,883875561,883875585,24,1135,381,3.2758620689655173
500,4,3,-1,883875585,883875610,25,381,386,2.769230769230769
500,3,3,0,883875610,883875638,28,386,234,3.7674418604651163
500,3,3,0,883875638,883875681,43,234,133,3.7777777777777777
500,3,3,0,883875681,883875756,75,133,1018,3.0714285714285716
500,3,3,0,883875756,883875793,37,1018,393,3.5125
500,3,1,-2,883875793,883875862,69,393,44,3.1333333333333333
500,1,4,3,883875862,883876053,191,44,49,3.3
500,4,5,1,883876053,883876093,40,49,971,4.0
500,5,4,-1,883876093,883876300,207,971,1069,3.6
500,4,2,-2,883876300,883876370,70,1069,553,3.5
500,2,3,1,883876370,883876690,320,553,62,3.048780487804878
500,3,2,-1,883876690,883876837,147,62,821,3.076923076923077
500,2,3,1,883876837,883876859,22,821,43,3.1
500,3,2,-1,883876859,883877001,142,43,161,3.5844155844155843
500,2,3,1,883877001,883877162,161,161,554,2.9555555555555557
500,3,3,0,883877162,883877359,197,554,1057,2.7142857142857144
500,3,3,0,883877359,890010025,6132666,1057,535,3.380952380952381
500,3,3,0,890010025,891916883,1906858,535,242,3.5217391304347827
502,5,2,-3,883701866,883701980,114,288,300,3.6861313868613137
502,2,3,1,883701980,883702255,275,300,294,3.1052631578947367
502,3,4,1,883702255,883702447,192,294,323,3.0
502,4,3,-1,883702447,883702448,1,323,678,2.8181818181818183
502,3,3,0,883702448,883702518,70,678,264,2.65
502,3,1,-2,883702518,883702631,113,264,681,2.25
502,1,2,1,883702631,883702945,314,681,261,2.7333333333333334
503,5,3,-2,879438072,879438191,119,1194,286,3.442857142857143
503,3,5,2,879438191,879438233,42,286,124,4.052631578947368
503,5,5,0,879438233,879438258,25,124,283,3.901639344262295
503,5,5,0,879438258,879438285,27,283,20,3.375
503,5,5,0,879438285,879438346,61,20,297,4.142857142857143
503,5,3,-2,879438346,879438377,31,297,13,3.5454545454545454
503,3,5,2,879438377,879438411,34,13,740,3.423076923076923
503,5,4,-1,879438411,879438505,94,740,237,3.7315436241610738
503,4,3,-1,879438505,879438685,180,237,405,3.25
503,3,3,0,879438685,879438707,22,405,121,3.521212121212121
503,3,2,-1,879438707,879438817,110,121,823,2.75
503,2,4,2,879438817,879438874,57,823,1317,3.0
503,4,2,-2,879438874,879454442,15568,1317,744,3.5714285714285716
503,2,3,1,879454442,879454576,134,744,281,3.2
503,3,3,0,879454576,879454675,99,281,12,4.358974358974359
503,3,5,2,879454675,879454753,78,12,185,3.9726027397260273
503,5,5,0,879454753,879454754,1,185,176,3.967032967032967
503,5,5,0,879454754,879454811,57,176,443,3.8421052631578947
503,5,1,-4,879454811,879454950,139,443,452,2.6129032258064515
503,1,5,4,879454950,879454977,27,452,561,3.1515151515151514
503,5,5,0,879454977,880383064,928087,561,582,3.7457627118644066
503,5,5,0,880383064,880383098,34,582,83,4.204081632653061
503,5,4,-1,880383098,880383126,28,83,714,3.6
503,4,4,0,880383126,880383174,48,714,382,3.764705882352941
503,4,2,-2,880383174,880383200,26,382,26,3.36
503,2,1,-1,880383200,880383201,1,26,640,2.75
503,1,3,2,880383201,880383236,35,640,580,3.625
503,3,5,2,880383236,880383357,121,580,216,3.8454545454545452
503,5,4,-1,880383357,880383358,1,216,387,3.5357142857142856
503,4,3,-1,880383358,880383424,66,387,747,3.5526315789473686
503,3,4,1,880383424,880383425,1,747,451,3.207792207792208
503,4,3,-1,880383425,880383467,42,451,662,3.4583333333333335
503,3,4,1,880383467,880383468,1,662,88,3.433734939759036
503,4,1,-3,880383468,880383490,22,88,739,3.391304347826087
503,1,5,4,880383490,880383624,134,739,168,4.0476190476190474
503,5,5,0,880383624,880383625,1,168,187,4.215189873417722
503,5,3,-2,880383625,880383653,28,187,603,4.315789473684211
503,3,4,1,880383653,880383679,26,603,69,3.8015873015873014
503,4,3,-1,880383679,880383703,24,69,204,3.6744186046511627
503,3,3,0,880383703,880390153,6450,204,125,3.5555555555555554
503,3,5,2,880390153,880472102,81949,125,432,3.719298245614035
503,5,5,0,880472102,880472216,114,432,488,4.277777777777778
503,5,5,0,880472216,880472250,34,488,174,4.253521126760563
503,5,5,0,880472250,880472272,22,174,607,4.136363636363637
503,5,3,-2,880472272,880472321,49,607,182,3.842857142857143
503,3,4,1,880472321,880472383,62,182,485,3.717948717948718
503,4,5,1,880472383,880472435,52,485,211,3.958904109589041
503,5,3,-2,880472435,880472454,19,211,729,3.3793103448275863
503,3,5,2,880472454,880472474,20,729,496,4.094594594594595
503,5,3,-2,880472474,880472507,33,496,164,3.6140350877192984
503,3,4,1,880472507,880472565,58,164,58,3.543859649122807
503,4,5,1,880472565,884637610,4165045,58,347,3.59375
503,5,5,0,884637610,884638548,938,347,246,4.0
503,5,5,0,884638548,892667389,8028841,246,900,4.2
504,4,4,0,887831273,887831274,1,307,323,3.0
504,4,3,-1,887831274,887831293,19,323,50,4.306532663316583
504,3,4,1,887831293,887831353,60,50,928,3.142857142857143
504,4,4,0,887831353,887831419,66,928,620,3.0
504,4,5,1,887831419,887831486,67,620,100,4.0162162162162165
504,5,5,0,887831486,887831510,24,100,127,4.162790697674419
504,5,4,-1,887831510,887831567,57,127,9,3.8878504672897196
504,4,4,0,887831567,887831622,55,9,248,3.746268656716418
504,4,4,0,887831622,887831642,20,248,121,3.521212121212121
504,4,4,0,887831642,887831678,36,121,628,3.573529411764706
504,4,4,0,887831678,887831694,16,628,117,3.689189189189189
504,4,4,0,887831694,887831717,23,117,298,3.779220779220779
504,4,3,-1,887831717,887831753,36,298,237,3.7315436241610738
504,3,3,0,887831753,887831773,20,237,181,3.98974358974359
504,3,3,0,887831773,887831790,17,181,276,3.6036036036036037
504,3,4,1,887831790,887831806,16,276,846,3.1052631578947367
504,4,4,0,887831806,887831838,32,846,282,3.610526315789474
504,4,3,-1,887831838,887831879,41,282,106,2.8125
504,3,4,1,887831879,887832097,218,106,595,2.9166666666666665
504,4,4,0,887832097,887832170,73,595,934,3.0294117647058822
504,4,4,0,887832170,887832207,37,934,225,3.0714285714285716
504,4,1,-3,887832207,887832268,61,225,122,2.282608695652174
504,1,5,4,887832268,887832364,96,122,223,4.108695652173913
504,5,3,-2,887832364,887832391,27,223,418,3.825
504,3,5,2,887832391,887832433,42,418,98,4.240875912408759
504,5,4,-1,887832433,887832531,98,98,651,3.8627450980392157
504,4,4,0,887832531,887832571,40,651,385,3.6129032258064515
504,4,5,1,887832571,887832593,22,385,318,4.5046728971962615
504,5,4,-1,887832593,887832643,50,318,210,3.921259842519685
504,4,3,-1,887832643,887832668,25,210,194,4.029411764705882
504,3,4,1,887832668,887832705,37,194,357,4.063291139240507
504,4,4,0,887832705,887832741,36,357,1147,3.4
504,4,4,0,887832741,887832760,19,1147,97,3.7282608695652173
504,4,4,0,887832760,887837739,4979,97,211,3.958904109589041
504,4,3,-1,887837739,887837740,1,211,58,3.543859649122807
504,3,4,1,887837740,887837918,178,58,82,3.6741573033707864
504,4,4,0,887837918,887837957,39,82,505,4.0625
504,4,4,0,887837957,887837958,1,505,1084,4.0
504,4,4,0,887837958,887838008,50,1084,143,3.56
504,4,4,0,887838008,887838485,477,143,514,4.033333333333333
504,4,4,0,887838485,887838510,25,514,195,3.9072164948453607
504,4,4,0,887838510,887838573,63,195,699,3.736842105263158
504,4,4,0,887838573,887838677,104,699,969,3.8947368421052633
504,4,4,0,887838677,887838717,40,969,65,3.511111111111111
504,4,3,-1,887838717,887838740,23,65,234,3.7674418604651163
504,3,5,2,887838740,887838815,75,234,132,3.929411764705882
504,5,4,-1,887838815,887838869,54,132,939,3.6333333333333333
504,4,3,-1,887838869,887838908,39,939,204,3.6744186046511627
504,3,4,1,887838908,887838935,27,204,196,3.9404761904761907
504,4,5,1,887838935,887839164,229,196,168,4.0476190476190474
504,5,4,-1,887839164,887839165,1,168,66,3.4705882352941178
504,4,4,0,887839165,887839195,30,66,660,3.71875
504,4,4,0,887839195,887839260,65,660,51,3.5277777777777777
504,4,4,0,887839260,887839810,550,51,449,2.9069767441860463
504,4,4,0,887839810,887839835,25,449,402,3.3076923076923075
504,4,3,-1,887839835,887840014,179,402,731,3.4
504,3,4,1,887840014,887840098,84,731,96,3.9130434782608696
504,4,5,1,887840098,887840134,36,96,448,3.466666666666667
504,5,3,-2,887840134,887840559,425,448,187,4.215189873417722
504,3,3,0,887840559,887840560,1,187,420,3.5652173913043477
504,3,3,0,887840560,887840589,29,420,84,3.0
504,3,3,0,887840589,887840637,48,84,1210,2.7142857142857144
504,3,5,2,887840637,887840745,108,1210,559,3.477272727272727
504,5,4,-1,887840745,887840764,19,559,214,3.272727272727273
504,4,4,0,887840764,887840882,118,214,399,3.317073170731707
504,4,4,0,887840882,887840960,78,399,423,3.7016129032258065
504,4,1,-3,887840960,887841073,113,423,1093,3.0
504,1,4,3,887841073,887841136,63,1093,629,3.3333333333333335
504,4,3,-1,887841136,887841158,22,629,142,3.1481481481481484
504,3,3,0,887841158,887841201,43,142,739,3.391304347826087
504,3,4,1,887841201,887908756,67555,739,676,3.3142857142857145
504,4,4,0,887908756,887908861,105,676,215,3.662921348314607
504,4,3,-1,887908861,887908974,113,215,728,3.05
504,3,3,0,887908974,887909347,373,728,202,3.730337078651685
504,3,4,1,887909347,887909455,108,202,174,4.253521126760563
504,4,3,-1,887909455,887909456,1,174,393,3.5125
504,3,4,1,887909456,887909532,76,393,1263,3.1666666666666665
504,4,3,-1,887909532,887909839,307,1263,88,3.433734939759036
504,3,2,-1,887909839,887909864,25,88,585,2.5384615384615383
504,2,4,2,887909864,887909890,26,585,504,4.085714285714285
504,4,3,-1,887909890,887909936,46,504,465,3.75
504,3,4,1,887909936,887910023,87,465,561,3.1515151515151514
504,4,4,0,887910023,887910267,244,561,218,3.5555555555555554
504,4,4,0,887910267,887910294,27,218,416,3.3846153846153846
504,4,3,-1,887910294,887910370,76,416,440,1.5
504,3,3,0,887910370,887910409,39,440,403,3.298507462686567
504,3,4,1,887910409,887910487,78,403,622,3.3333333333333335
504,4,3,-1,887910487,887910511,24,622,428,3.744186046511628
504,3,4,1,887910511,887910623,112,428,581,3.130434782608696
504,4,3,-1,887910623,887910694,71,581,1041,3.3333333333333335
504,3,3,0,887910694,887910718,24,1041,664,3.15
504,3,3,0,887910718,887910811,93,664,537,3.5
504,3,3,0,887910811,887910871,60,537,1133,3.076923076923077
504,3,4,1,887910871,887910961,90,1133,1090,2.3529411764705883
504,4,3,-1,887910961,887911035,74,1090,1118,3.533333333333333
504,3,3,0,887911035,887911277,242,1118,400,2.375
504,3,3,0,887911277,887911314,37,400,1030,2.3636363636363638
504,3,2,-1,887911314,887911369,55,1030,396,2.84
504,2,3,1,887911369,887911444,75,396,1442,3.0
504,3,2,-1,887911444,887911583,139,1442,1110,2.85
504,2,4,2,887911583,887911730,147,1110,717,2.9696969696969697
504,4,3,-1,887911730,887911789,59,717,791,3.0
504,3,3,0,887911789,887911808,19,791,667,2.4285714285714284
504,3,4,1,887911808,887911854,46,667,1135,3.0526315789473686
504,4,3,-1,887911854,887911973,119,1135,725,3.0
504,3,2,-1,887911973,887911974,1,725,452,2.6129032258064515
504,2,4,2,887911974,887912298,324,452,1046,3.3529411764705883
504,4,3,-1,887912298,887912335,37,1046,1415,2.8
504,3,2,-1,887912335,887912382,47,1415,364,2.8095238095238093
504,2,3,1,887912382,887912401,19,364,575,2.619047619047619
504,3,3,0,887912401,887912416,15,575,238,3.888888888888889
504,3,2,-1,887912416,887912447,31,238,384,2.7941176470588234
504,2,4,2,887912447,887912462,15,384,5,3.1481481481481484
504,4,3,-1,887912462,887912504,42,5,63,3.125
504,3,3,0,887912504,887912542,38,63,633,3.9
504,3,1,-2,887912542,887912584,42,633,451,3.207792207792208
504,1,3,2,887912584,887912634,50,451,155,3.0588235294117645
504,3,5,2,887912634,887912665,31,155,68,3.5714285714285716
504,5,2,-3,887912665,887912722,57,68,294,3.1052631578947367
504,2,4,2,887912722,889550757,1638035,294,409,2.9615384615384617
505,4,3,-1,888631046,888631208,162,300,259,2.492063492063492
505,3,3,0,888631208,888631311,103,259,294,3.1052631578947367
505,3,4,1,888631311,888631349,38,294,245,3.056179775280899
505,4,3,-1,888631349,888631371,22,245,988,2.5555555555555554
505,3,1,-2,888631371,888631438,67,988,989,3.142857142857143
505,1,3,2,888631438,888631555,117,989,358,2.6551724137931036
505,3,5,2,888631555,889332743,701188,358,313,4.323076923076923
505,5,4,-1,889332743,889333313,570,313,95,3.8194444444444446
505,4,3,-1,889333313,889333365,52,95,623,3.0454545454545454
505,3,3,0,889333365,889333392,27,623,183,3.951219512195122
505,3,3,0,889333392,889333414,22,183,1,3.902439024390244
505,3,4,1,889333414,889333442,28,1,199,4.191489361702128
505,4,4,0,889333442,889333466,24,199,568,3.5853658536585367
505,4,4,0,889333466,889333508,42,568,117,3.689189189189189
505,4,3,-1,889333508,889333534,26,117,173,4.1441441441441444
505,3,5,2,889333534,889333598,64,173,132,3.929411764705882
505,5,4,-1,889333598,889333676,78,132,97,3.7282608695652173
505,4,3,-1,889333676,889333711,35,97,1285,3.1
505,3,3,0,889333711,889333758,47,1285,705,3.7857142857142856
505,3,3,0,889333758,889333823,65,705,495,3.65
505,3,3,0,889333823,889333861,38,495,144,3.9545454545454546
505,3,2,-1,889333861,889333894,33,144,228,3.7246376811594204
505,2,5,3,889333894,889333937,43,228,402,3.3076923076923075
505,5,3,-2,889333937,889333974,37,402,1409,2.5
505,3,3,0,889333974,889333975,1,1409,422,3.25
505,3,3,0,889333975,889334067,92,422,50,4.306532663316583
505,3,4,1,889334067,889334096,29,50,468,3.380952380952381
505,4,3,-1,889334096,889334129,33,468,7,3.76056338028169
505,3,4,1,889334129,889334189,60,7,164,3.6140350877192984
505,4,3,-1,889334189,889334217,28,164,713,3.5
505,3,3,0,889334217,889334248,31,713,77,3.3857142857142857
505,3,4,1,889334248,889334334,86,77,88,3.433734939759036
505,4,3,-1,889334334,889334373,39,88,125,3.5555555555555554
505,3,3,0,889334373,889334477,104,125,193,3.883720930232558
505,3,3,0,889334477,889334503,26,193,566,3.543859649122807
505,3,3,0,889334503,889334583,80,566,692,3.56
505,3,4,1,889334583,889334614,31,692,648,3.9545454545454546
506,2,2,0,874862734,874872872,10138,10,137,3.9545454545454546
506,2,4,2,874872872,874873067,195,137,1020,3.727272727272727
506,4,5,1,874873067,874873068,1,1020,71,3.6575342465753424
506,5,5,0,874873068,874873111,43,71,234,3.7674418604651163
506,5,5,0,874873111,874873157,46,234,174,4.253521126760563
506,5,5,0,874873157,874873158,1,174,641,4.5
506,5,1,-4,874873158,874873247,89,641,772,3.3333333333333335
506,1,5,4,874873247,874873287,40,772,514,4.033333333333333
506,5,2,-3,874873287,874873327,40,514,761,3.0588235294117645
506,2,4,2,874873327,874873423,96,761,470,3.72
506,4,4,0,874873423,874873528,105,470,604,3.8181818181818183
506,4,5,1,874873528,874873529,1,604,521,3.787878787878788
506,5,4,-1,874873529,874873615,86,521,132,3.929411764705882
506,4,3,-1,874873615,874873703,88,132,33,3.2941176470588234
506,3,5,2,874873703,874873744,41,33,435,3.8933333333333335
506,5,4,-1,874873744,874873745,1,435,196,3.9404761904761907
506,4,4,0,874873745,874873794,49,196,216,3.8454545454545452
506,4,3,-1,874873794,874873795,1,216,85,3.3157894736842106
506,3,4,1,874873795,874873847,52,85,230,3.3518518518518516
506,4,5,1,874873847,874874054,207,230,79,3.956989247311828
506,5,5,0,874874054,874874055,1,79,168,4.0476190476190474
506,5,3,-2,874874055,874874110,55,168,770,3.25
506,3,5,2,874874110,874874151,41,770,710,3.41025641025641
506,5,5,0,874874151,874874308,157,710,183,3.951219512195122
506,5,4,-1,874874308,874874396,88,183,1046,3.3529411764705883
506,4,4,0,874874396,874874458,62,1046,403,3.298507462686567
506,4,5,1,874874458,874874525,67,403,611,4.384615384615385
506,5,4,-1,874874525,874874585,60,611,425,3.7027027027027026
506,4,5,1,874874585,874874676,91,425,181,3.98974358974359
506,5,3,-2,874874676,874874760,84,181,972,3.375
506,3,3,0,874874760,874874802,42,972,393,3.5125
506,3,5,2,874874802,874874850,48,393,423,3.7016129032258065
506,5,4,-1,874874850,874874851,1,423,607,4.136363636363637
506,4,2,-2,874874851,874874894,43,607,29,2.5714285714285716
506,2,4,2,874874894,874874895,1,29,229,3.185185185185185
506,4,4,0,874874895,874874947,52,229,646,3.9285714285714284
506,4,4,0,874874947,874874985,38,646,53,2.9523809523809526
506,4,4,0,874874985,874875062,77,53,836,4.142857142857143
506,4,3,-1,874875062,874876551,1489,836,86,3.869565217391304
506,3,2,-1,874876551,874876598,47,86,792,3.793103448275862
506,2,3,1,874876598,874876599,1,792,94,2.8823529411764706
506,3,4,1,874876599,874876651,52,94,489,4.076923076923077
506,4,3,-1,874876651,877861473,2984822,489,762,3.3962264150943398
506,3,5,2,877861473,878044852,183379,762,482,3.9444444444444446
506,5,4,-1,878044852,879074845,1029993,482,295,3.769230769230769
506,4,2,-2,879074845,880198224,1123379,295,250,3.4698795180722892
506,2,2,0,880198224,880198305,81,250,248,3.746268656716418
506,2,2,0,880198305,882100955,1902650,248,410,3.0434782608695654
506,2,2,0,882100955,884517295,2416340,410,1244,2.7777777777777777
506,2,2,0,884517295,885135497,618202,1244,1608,2.25
506,2,3,1,885135497,885135514,17,1608,261,2.7333333333333334
506,3,1,-2,885135514,885135560,46,261,880,2.8421052631578947
506,1,5,4,885135560,885135737,177,880,210,3.921259842519685
506,5,5,0,885135737,885135819,82,210,187,4.215189873417722
506,5,4,-1,885135819,885135844,25,187,226,3.378787878787879
506,4,4,0,885135844,885135881,37,226,550,3.272727272727273
506,4,2,-2,885135881,885135882,1,550,449,2.9069767441860463
506,2,2,0,885135882,885135954,72,449,1407,2.375
506,2,1,-1,885135954,885135955,1,1407,1110,2.85
506,1,1,0,885135955,885136005,50,1110,224,3.4545454545454546
506,1,3,2,885136005,888178161,3042156,224,300,3.6861313868613137
506,3,4,1,888178161,888848303,670142,300,699,3.736842105263158
506,4,3,-1,888848303,888848304,1,699,342,2.64
443,3,4,1,883504564,883504593,29,307,327,3.5076923076923077
443,4,5,1,883504593,883504654,61,327,333,3.546666666666667
443,5,4,-1,883504654,883504682,28,333,271,3.3134328358208953
443,4,5,1,883504682,883504748,66,271,340,3.7419354838709675
443,5,5,0,883504748,883504771,23,340,343,3.0
443,5,1,-4,883504771,883504818,47,343,260,2.4716981132075473
443,1,1,0,883504818,883504844,26,260,948,2.2962962962962963
443,1,3,2,883504844,883504889,45,948,687,2.1481481481481484
443,3,1,-2,883504889,883505492,603,687,39,3.107142857142857
507,3,5,2,889964074,889964121,47,319,313,4.323076923076923
507,5,5,0,889964121,889964162,41,313,894,2.0
507,5,5,0,889964162,889964202,40,894,895,3.142857142857143
507,5,1,-4,889964202,889964274,72,895,352,1.8333333333333333
507,1,5,4,889964274,889964348,74,352,338,2.75
507,5,5,0,889964348,889964706,358,338,879,3.2291666666666665
507,5,5,0,889964706,889964748,42,879,334,3.4210526315789473
507,5,5,0,889964748,889964809,61,334,892,2.9615384615384617
507,5,5,0,889964809,889966054,1245,892,252,2.911392405063291
507,5,5,0,889966054,889966088,34,252,1016,3.559322033898305
507,5,5,0,889966088,889966127,39,1016,826,2.5555555555555554
514,4,5,1,875308925,875309276,351,168,1,3.902439024390244
514,5,4,-1,875309276,875309350,74,1,15,3.725663716814159
514,4,4,0,875309350,875309414,64,15,202,3.730337078651685
514,4,5,1,875309414,875309415,1,202,7,3.76056338028169
514,5,4,-1,875309415,875311156,1741,7,432,3.719298245614035
514,4,4,0,875311156,875311193,37,432,135,3.7974683544303796
514,4,4,0,875311193,875311225,32,135,156,4.017857142857143
514,4,4,0,875311225,875318163,6938,156,152,3.6785714285714284
514,4,5,1,875318163,875318164,1,152,367,3.4242424242424243
514,5,4,-1,875318164,875318224,60,367,582,3.7457627118644066
514,4,4,0,875318224,875318331,107,582,318,4.5046728971962615
514,4,5,1,875318331,875462466,144135,318,50,4.306532663316583
514,5,3,-2,875462466,875462520,54,50,473,2.9166666666666665
514,3,5,2,875462520,875462568,48,473,423,3.7016129032258065
514,5,4,-1,875462568,875462611,43,423,792,3.793103448275862
514,4,4,0,875462611,875462645,34,792,47,3.5869565217391304
514,4,5,1,875462645,875462689,44,47,474,4.172413793103448
514,5,4,-1,875462689,875462764,75,474,735,3.58
514,4,4,0,875462764,875462795,31,735,483,4.475609756097561
514,4,4,0,875462795,875462826,31,483,609,3.7058823529411766
514,4,4,0,875462826,875462867,41,609,10,3.85
514,4,3,-1,875462867,875462901,34,10,470,3.72
514,3,5,2,875462901,875463028,127,470,275,4.087912087912088
514,5,3,-2,875463028,875463079,51,275,647,4.142857142857143
514,3,4,1,875463079,875463128,49,647,19,3.9615384615384617
514,4,3,-1,875463128,875463164,36,19,24,3.3728813559322033
514,3,5,2,875463164,875463165,1,24,111,3.5106382978723403
514,5,4,-1,875463165,875463202,37,111,22,4.215909090909091
514,4,4,0,875463202,875463245,43,22,402,3.3076923076923075
514,4,4,0,875463245,875463269,24,402,421,3.462962962962963
514,4,3,-1,875463269,875463351,82,421,199,4.191489361702128
514,3,4,1,875463351,875463416,65,199,81,3.2857142857142856
514,4,4,0,875463416,875463440,24,81,4,3.5538461538461537
514,4,4,0,875463440,875463469,29,4,132,3.929411764705882
514,4,4,0,875463469,875463494,25,132,208,3.8125
514,4,4,0,875463494,875463525,31,208,194,4.029411764705882
514,4,4,0,875463525,875463551,26,194,68,3.5714285714285716
514,4,3,-1,875463551,875463595,44,68,26,3.36
514,3,3,0,875463595,875463665,70,26,134,4.174603174603175
514,3,2,-1,875463665,875463906,241,134,748,3.1043478260869564
514,2,3,1,875463906,876063880,599974,748,13,3.5454545454545454
514,3,3,0,876063880,876063961,81,13,1047,2.6923076923076925
514,3,3,0,876063961,876067235,3274,1047,109,3.282608695652174
514,3,4,1,876067235,876067258,23,109,73,3.588235294117647
514,4,3,-1,876067258,876067380,122,73,709,4.171428571428572
514,3,4,1,876067380,876067546,166,709,778,3.5925925925925926
514,4,3,-1,876067546,876067592,46,778,393,3.5125
514,3,4,1,876067592,876067623,31,393,1074,2.857142857142857
514,4,3,-1,876067623,880209950,4142327,1074,293,3.630434782608696
514,3,4,1,880209950,880209981,31,293,257,3.7154471544715446
514,4,4,0,880209981,880210105,124,257,587,3.4
514,4,4,0,880210105,885180579,4970474,587,268,3.9838709677419355
514,4,4,0,885180579,885180603,24,268,272,4.2
514,4,4,0,885180603,885180627,24,272,750,4.027777777777778
514,4,2,-2,885180627,885180645,18,750,1014,3.1
514,2,1,-1,885180645,885180842,197,1014,336,2.4
514,1,1,0,885180842,885180893,51,336,680,2.8333333333333335
514,1,1,0,885180893,885180909,16,680,342,2.64
514,1,1,0,885180909,885180929,20,342,890,1.7692307692307692
514,1,2,1,885180929,885181043,114,890,243,2.357142857142857
514,2,3,1,885181043,886189467,1008424,243,150,3.803921568627451
514,3,3,0,886189467,886189510,43,150,949,3.392857142857143
514,3,2,-1,886189510,886189676,166,949,49,3.3
514,2,4,2,886189676,886189748,72,49,1160,4.1
514,4,3,-1,886189748,886189816,68,1160,177,3.875
514,3,4,1,886189816,886189841,25,177,729,3.3793103448275863
514,4,3,-1,886189841,886189869,28,729,486,3.9565217391304346
514,3,4,1,886189869,886189893,24,486,1101,3.793103448275862
514,4,3,-1,886189893,886189927,34,1101,180,3.9473684210526314
514,3,3,0,886189927,886189990,63,180,511,4.096153846153846
514,3,4,1,886189990,886190600,610,511,265,3.710144927536232
514,4,4,0,886190600,886190665,65,265,31,3.642857142857143
514,4,3,-1,886190665,891900164,5709499,31,344,4.0
508,3,4,1,883767047,883767140,93,181,173,4.1441441441441444
508,4,5,1,883767140,883767157,17,173,172,4.225225225225225
508,5,4,-1,883767157,883767172,15,172,168,4.0476190476190474
508,4,5,1,883767172,883767279,107,168,132,3.929411764705882
508,5,5,0,883767279,883767301,22,132,514,4.033333333333333
508,5,5,0,883767301,883767325,24,514,150,3.803921568627451
508,5,4,-1,883767325,883767343,18,150,238,3.888888888888889
508,4,4,0,883767343,883767361,18,238,23,3.9047619047619047
508,4,5,1,883767361,883767383,22,23,191,4.168674698795181
508,5,4,-1,883767383,883767465,82,191,179,3.8823529411764706
508,4,4,0,883767465,883767525,60,179,655,3.7857142857142856
508,4,5,1,883767525,883767565,40,655,180,3.9473684210526314
508,5,5,0,883767565,883767608,43,180,524,4.166666666666667
508,5,1,-4,883767608,883767628,20,524,219,2.735294117647059
508,1,4,3,883767628,883767665,37,219,1067,3.533333333333333
508,4,5,1,883767665,883767704,39,1067,154,3.6031746031746033
508,5,3,-2,883767704,883767728,24,154,144,3.9545454545454546
508,3,4,1,883767728,883768797,1069,144,1153,4.666666666666667
508,4,4,0,883768797,883768842,45,1153,200,3.8157894736842106
508,4,3,-1,883768842,883768862,20,200,163,3.53125
508,3,3,0,883768862,883768886,24,163,109,3.282608695652174
508,3,5,2,883768886,883775361,6475,109,527,3.823529411764706
508,5,4,-1,883775361,883776778,1417,527,502,3.272727272727273
508,4,3,-1,883776778,883777047,269,502,211,3.958904109589041
508,3,4,1,883777047,883777125,78,211,210,3.921259842519685
508,4,3,-1,883777125,883777145,20,210,82,3.6741573033707864
508,3,3,0,883777145,883777257,112,82,47,3.5869565217391304
508,3,3,0,883777257,883777281,24,47,222,3.578125
508,3,3,0,883777281,883777299,18,222,88,3.433734939759036
508,3,2,-1,883777299,883777346,47,88,229,3.185185185185185
508,2,4,2,883777346,883777366,20,229,13,3.5454545454545454
508,4,3,-1,883777366,883777382,16,13,1135,3.0526315789473686
508,3,5,2,883777382,883777430,48,1135,474,4.172413793103448
511,5,4,-1,890004686,890004687,1,292,340,3.7419354838709675
511,4,5,1,890004687,890004702,15,340,313,4.323076923076923
511,5,5,0,890004702,890004728,26,313,872,3.0
511,5,5,0,890004728,890004747,19,872,887,3.5789473684210527
511,5,4,-1,890004747,890004795,48,887,288,3.5214285714285714
511,4,4,0,890004795,890004844,49,288,682,3.0476190476190474
511,4,5,1,890004844,890004879,35,682,271,3.3134328358208953
511,5,3,-2,890004879,890004892,13,271,343,3.0
511,3,4,1,890004892,890004916,24,343,260,2.4716981132075473
511,4,2,-2,890004916,890005076,160,260,678,2.8181818181818183
511,2,3,1,890005076,890005102,26,678,322,3.0476190476190474
515,4,4,0,887658782,887658844,62,304,271,3.3134328358208953
515,4,3,-1,887658844,887658910,66,271,294,3.1052631578947367
515,3,5,2,887658910,887658975,65,294,300,3.6861313868613137
515,5,3,-2,887658975,887659073,98,300,322,3.0476190476190474
515,3,4,1,887659073,887659123,50,322,307,3.6031746031746033
515,4,3,-1,887659123,887659192,69,307,323,3.0
515,3,4,1,887659192,887659718,526,323,1399,3.5
512,5,4,-1,888578937,888579569,632,286,1459,3.6
512,4,5,1,888579569,888579645,76,1459,273,3.5238095238095237
512,5,5,0,888579645,888579920,275,273,198,4.04
512,5,5,0,888579920,888579996,76,198,56,4.051724137931035
512,5,4,-1,888579996,888580143,147,56,265,3.710144927536232
512,4,4,0,888580143,888580248,105,265,23,3.9047619047619047
513,5,5,0,885062332,885062365,33,181,50,4.306532663316583
513,5,3,-2,885062365,885062453,88,50,763,3.347826086956522
513,3,5,2,885062453,885062519,66,763,117,3.689189189189189
513,5,4,-1,885062519,885062559,40,117,118,3.2764227642276422
513,4,4,0,885062559,885062601,42,118,685,3.2666666666666666
513,4,5,1,885062601,885062602,1,685,121,3.521212121212121
513,5,5,0,885062602,885062636,34,121,323,3.0
513,5,5,0,885062636,885063056,420,323,739,3.391304347826087
513,5,5,0,885063056,885063304,248,739,435,3.8933333333333335
475,4,1,-3,891451149,891451205,56,327,258,3.7547169811320753
475,1,1,0,891451205,891451341,136,258,303,3.75
475,1,5,4,891451341,891451402,61,303,902,3.9444444444444446
475,5,5,0,891451402,891452276,874,902,100,4.0162162162162165
475,5,5,0,891452276,891627927,175651,100,316,4.285714285714286
475,5,5,0,891627927,891628024,97,316,259,2.492063492063492
523,4,4,0,883699629,883700064,435,1022,301,3.2465753424657535
523,4,5,1,883700064,883700144,80,301,255,3.2027027027027026
523,5,5,0,883700144,883700186,42,255,50,4.306532663316583
523,5,5,0,883700186,883700307,121,50,1014,3.1
523,5,4,-1,883700307,883700395,88,1014,533,3.6
523,4,5,1,883700395,883700527,132,533,408,4.4772727272727275
523,5,4,-1,883700527,883700564,37,408,9,3.8878504672897196
523,4,5,1,883700564,883700618,54,9,866,3.3962264150943398
523,5,5,0,883700618,883700766,148,866,116,3.6666666666666665
523,5,4,-1,883700766,883700870,104,116,509,3.7058823529411766
523,4,5,1,883700870,883700969,99,509,1121,3.5
523,5,4,-1,883700969,883701018,49,1121,166,4.0
523,4,4,0,883701018,883701065,47,166,638,3.923076923076923
523,4,5,1,883701065,883701093,28,638,707,3.909090909090909
523,5,5,0,883701093,883701800,707,707,169,4.548387096774194
523,5,5,0,883701800,883701962,162,169,1069,3.6
523,5,4,-1,883701962,883702054,92,1069,202,3.730337078651685
523,4,5,1,883702054,883702125,71,202,629,3.3333333333333335
523,5,5,0,883702125,883702171,46,629,204,3.6744186046511627
523,5,4,-1,883702171,883702172,1,204,514,4.033333333333333
523,4,5,1,883702172,883702209,37,514,210,3.921259842519685
523,5,5,0,883702209,883702210,1,210,194,4.029411764705882
523,5,4,-1,883702210,883702233,23,194,167,2.8181818181818183
523,4,4,0,883702233,883702263,30,167,792,3.793103448275862
523,4,4,0,883702263,883702292,29,792,211,3.958904109589041
523,4,4,0,883702292,883702324,32,211,944,2.75
523,4,3,-1,883702324,883702351,27,944,412,2.272727272727273
523,3,5,2,883702351,883702411,60,412,393,3.5125
523,5,5,0,883702411,883702441,30,393,451,3.207792207792208
523,5,5,0,883702441,883702474,33,451,954,3.5
523,5,4,-1,883702474,883702602,128,954,934,3.0294117647058822
523,4,4,0,883702602,883702654,52,934,67,3.106382978723404
523,4,4,0,883702654,883702800,146,67,407,2.611111111111111
523,4,5,1,883702800,883702863,63,407,516,4.055555555555555
523,5,4,-1,883702863,883702946,83,516,97,3.7282608695652173
523,4,5,1,883702946,883703048,102,97,694,4.277777777777778
523,5,4,-1,883703048,883703070,22,694,662,3.4583333333333335
523,4,4,0,883703070,883703091,21,662,155,3.0588235294117645
523,4,4,0,883703091,883703144,53,155,794,3.6
518,3,4,1,876822744,876822811,67,10,475,3.956043956043956
518,4,3,-1,876822811,876822873,62,475,471,3.5714285714285716
518,3,5,2,876822873,876822923,50,471,276,3.6036036036036037
518,5,3,-2,876822923,876823018,95,276,1335,2.25
518,3,3,0,876823018,876823071,53,1335,124,4.052631578947368
518,3,2,-1,876823071,876823143,72,124,123,3.297872340425532
518,2,5,3,876823143,876823197,54,123,25,3.3185840707964602
518,5,3,-2,876823197,876823266,69,25,508,3.6923076923076925
518,3,4,1,876823266,876823324,58,508,147,3.3142857142857145
518,4,5,1,876823324,876823540,216,147,866,3.3962264150943398
518,5,5,0,876823540,876823597,57,866,222,3.578125
518,5,4,-1,876823597,876823645,48,222,1011,3.1
518,4,5,1,876823645,876823804,159,1011,106,2.8125
518,5,1,-4,876823804,876823994,190,106,763,3.347826086956522
518,1,2,1,876823994,876824079,85,763,1114,3.2
518,2,3,1,876824079,876824121,42,1114,920,3.0
518,3,3,0,876824121,876824156,35,920,829,2.4615384615384617
518,3,3,0,876824156,876824218,62,829,120,2.3421052631578947
518,3,1,-2,876824218,876824266,48,120,1079,2.1923076923076925
509,4,2,-2,883590526,883590609,83,258,309,2.3333333333333335
509,2,2,0,883590609,883590729,120,309,307,3.6031746031746033
509,2,2,0,883590729,883590800,71,307,332,3.6511627906976742
509,2,2,0,883590800,883590913,113,332,319,3.0408163265306123
509,2,2,0,883590913,883591109,196,319,245,3.056179775280899
509,2,4,2,883591109,883591195,86,245,271,3.3134328358208953
509,4,3,-1,883591195,883591319,124,271,343,3.0
509,3,1,-2,883591319,883591489,170,343,266,2.6666666666666665
509,1,4,3,883591489,883591687,198,266,705,3.7857142857142856
509,4,4,0,883591687,883591826,139,705,603,4.315789473684211
509,4,5,1,883591826,883591878,52,603,50,4.306532663316583
516,4,4,0,891290566,891290593,27,181,194,4.029411764705882
516,4,5,1,891290593,891290594,1,194,582,3.7457627118644066
516,5,3,-2,891290594,891290649,55,582,523,4.159090909090909
510,4,4,0,887667465,887667524,59,258,292,3.6666666666666665
510,4,3,-1,887667524,887667545,21,292,288,3.5214285714285714
510,3,3,0,887667545,887667574,29,288,245,3.056179775280899
510,3,1,-2,887667574,887667575,1,245,325,2.625
510,1,1,0,887667575,887667618,43,325,324,3.2291666666666665
510,1,3,2,887667618,887667681,63,324,294,3.1052631578947367
510,3,3,0,887667681,887667707,26,294,748,3.1043478260869564
510,3,4,1,887667707,887667751,44,748,326,3.262295081967213
510,4,3,-1,887667751,887667752,1,326,322,3.0476190476190474
510,3,1,-2,887667752,887667808,56,322,681,2.25
510,1,2,1,887667808,887667969,161,681,457,1.7
524,5,2,-3,884287406,884321592,34186,302,748,3.1043478260869564
524,2,5,3,884321592,884322113,521,748,124,4.052631578947368
524,5,4,-1,884322113,884322169,56,124,471,3.5714285714285716
524,4,5,1,884322169,884323426,1257,471,111,3.5106382978723403
524,5,4,-1,884323426,884323427,1,111,126,3.8620689655172415
524,4,2,-2,884323427,884323464,37,126,281,3.2
524,2,3,1,884323464,884323525,61,281,284,3.1547619047619047
524,3,4,1,884323525,884323551,26,284,928,3.142857142857143
524,4,2,-2,884323551,884627065,303514,928,405,3.25
524,2,5,3,884627065,884627388,323,405,6,4.333333333333333
524,5,3,-2,884627388,884627446,58,6,742,3.5555555555555554
524,3,3,0,884627446,884627519,73,742,815,3.135135135135135
524,3,4,1,884627519,884627594,75,815,1048,2.857142857142857
524,4,4,0,884627594,884627777,183,1048,291,3.2
524,4,3,-1,884627777,884627932,155,291,931,2.2758620689655173
524,3,1,-2,884627932,884628059,127,931,235,3.106382978723404
524,1,4,3,884628059,884628136,77,235,1093,3.0
524,4,3,-1,884628136,884628212,76,1093,476,3.1216216216216215
524,3,3,0,884628212,884628284,72,476,107,3.45
524,3,3,0,884628284,884628308,24,107,818,2.769230769230769
524,3,4,1,884628308,884634578,6270,818,651,3.8627450980392157
524,4,4,0,884634578,884634579,1,651,180,3.9473684210526314
524,4,4,0,884634579,884634615,36,180,50,4.306532663316583
524,4,5,1,884634615,884634646,31,50,187,4.215189873417722
524,5,3,-2,884634646,884634679,33,187,135,3.7974683544303796
524,3,4,1,884634679,884634707,28,135,488,4.277777777777778
524,4,3,-1,884634707,884634731,24,488,181,3.98974358974359
524,3,4,1,884634731,884634755,24,181,209,3.8275862068965516
524,4,3,-1,884634755,884634818,63,209,705,3.7857142857142856
524,3,5,2,884634818,884634848,30,705,134,4.174603174603175
524,5,5,0,884634848,884634877,29,134,654,4.119047619047619
524,5,3,-2,884634877,884634911,34,654,175,3.8354430379746836
524,3,4,1,884634911,884634968,57,175,132,3.929411764705882
524,4,4,0,884634968,884634995,27,132,657,4.341463414634147
524,4,5,1,884634995,884635031,36,657,1166,3.8
524,5,4,-1,884635031,884635053,22,1166,1101,3.793103448275862
524,4,3,-1,884635053,884635085,32,1101,226,3.378787878787879
524,3,4,1,884635085,884635204,119,226,185,3.9726027397260273
524,4,5,1,884635204,884635205,1,185,241,3.5625
524,5,4,-1,884635205,884635287,82,241,318,4.5046728971962615
524,4,4,0,884635287,884635288,1,318,965,3.7142857142857144
524,4,2,-2,884635288,884635358,70,965,429,3.742857142857143
524,2,4,2,884635358,884636152,794,429,416,3.3846153846153846
524,4,4,0,884636152,884636205,53,416,31,3.642857142857143
524,4,1,-3,884636205,884636262,57,31,81,3.2857142857142856
524,1,1,0,884636262,884636416,154,81,184,3.393939393939394
524,1,5,4,884636416,884636444,28,184,433,3.8035714285714284
524,5,4,-1,884636444,884636453,9,433,52,3.727272727272727
524,4,2,-2,884636453,884636498,45,52,239,3.423076923076923
524,2,4,2,884636498,884636519,21,239,70,3.5833333333333335
524,4,1,-3,884636519,884636541,22,70,640,2.75
524,1,5,4,884636541,884636562,21,640,693,3.6285714285714286
524,5,4,-1,884636562,884636583,21,693,265,3.710144927536232
524,4,2,-2,884636583,884636617,34,265,402,3.3076923076923075
524,2,4,2,884636617,884636645,28,402,708,3.3157894736842106
524,4,1,-3,884636645,884636646,1,708,1065,3.1578947368421053
524,1,2,1,884636646,884636735,89,1065,215,3.662921348314607
524,2,4,2,884636735,884636827,92,215,573,2.909090909090909
524,4,3,-1,884636827,884636907,80,573,526,3.909090909090909
524,3,4,1,884636907,884636931,24,526,549,3.4871794871794872
524,4,3,-1,884636931,884636958,27,549,796,2.923076923076923
524,3,4,1,884636958,884636980,22,796,942,3.4545454545454546
524,4,5,1,884636980,884637031,51,942,578,3.066666666666667
524,5,3,-2,884637031,884637032,1,578,393,3.5125
524,3,3,0,884637032,884637067,35,393,559,3.477272727272727
524,3,4,1,884637067,884637095,28,559,161,3.5844155844155843
524,4,2,-2,884637095,884637128,33,161,1074,2.857142857142857
524,2,4,2,884637128,884637147,19,1074,712,3.0434782608695654
524,4,3,-1,884637147,884637173,26,712,29,2.5714285714285716
524,3,4,1,884637173,884637203,30,29,670,2.9375
524,4,5,1,884637203,884637246,43,670,700,2.7142857142857144
524,5,3,-2,884637246,884637314,68,700,607,4.136363636363637
524,3,4,1,884637314,884637347,33,607,197,4.112676056338028
524,4,2,-2,884637347,884637467,120,197,497,3.35
524,2,3,1,884637467,884637528,61,497,1124,3.75
524,3,1,-2,884637528,884637566,38,1124,605,3.3333333333333335
524,1,4,3,884637566,884637598,32,605,499,4.0
524,4,4,0,884637598,884638062,464,499,319,3.0408163265306123
524,4,4,0,884638062,884701702,63640,319,898,3.0869565217391304
524,4,3,-1,884701702,884832616,130914,898,275,4.087912087912088
524,3,2,-1,884832616,884832742,126,275,410,3.0434782608695654
524,2,3,1,884832742,884832772,30,410,930,2.793103448275862
501,4,4,0,883346694,883346823,129,288,342,2.64
501,4,3,-1,883346823,883346844,21,342,245,3.056179775280899
501,3,3,0,883346844,883346886,42,245,678,2.8181818181818183
501,3,4,1,883346886,883347023,137,678,844,3.8333333333333335
501,4,4,0,883347023,883347799,776,844,100,4.0162162162162165
501,4,4,0,883347799,883347823,24,100,293,3.630434782608696
501,4,4,0,883347823,883347857,34,293,405,3.25
501,4,4,0,883347857,883347891,34,405,93,3.5641025641025643
501,4,4,0,883347891,883347920,29,93,508,3.6923076923076925
501,4,5,1,883347920,883347950,30,508,1097,4.333333333333333
501,5,4,-1,883347950,883347975,25,1097,248,3.746268656716418
501,4,3,-1,883347975,883348011,36,248,221,3.6923076923076925
501,3,4,1,883348011,883348036,25,221,129,3.744186046511628
501,4,4,0,883348036,883348236,200,129,122,2.282608695652174
501,4,3,-1,883348236,883348260,24,122,597,3.2771084337349397
501,3,4,1,883348260,883348283,23,597,546,2.9789473684210526
501,4,4,0,883348283,883348308,25,546,1010,3.611111111111111
501,4,3,-1,883348308,883348372,64,1010,1278,3.8333333333333335
501,3,3,0,883348372,883348411,39,1278,249,3.3275862068965516
501,3,3,0,883348411,883348435,24,249,125,3.5555555555555554
501,3,3,0,883348435,883348474,39,125,274,3.5609756097560976
501,3,3,0,883348474,883348519,45,274,24,3.3728813559322033
501,3,4,1,883348519,883348543,24,24,151,3.6544117647058822
501,4,4,0,883348543,883348564,21,151,108,3.107142857142857
501,4,3,-1,883348564,883348610,46,108,456,2.2
501,3,4,1,883348610,883348655,45,456,840,3.090909090909091
501,4,4,0,883348655,883348703,48,840,369,2.5714285714285716
501,4,4,0,883348703,883348743,40,369,1534,4.0
525,4,3,-1,881085217,881085256,39,288,289,2.988888888888889
525,3,4,1,881085256,881085648,392,289,282,3.610526315789474
525,4,4,0,881085648,881085739,91,282,257,3.7154471544715446
525,4,3,-1,881085739,881085843,104,257,742,3.5555555555555554
525,3,4,1,881085843,881085893,50,742,237,3.7315436241610738
525,4,4,0,881085893,881085917,24,237,762,3.3962264150943398
525,4,4,0,881085917,881085964,47,762,1,3.902439024390244
525,4,2,-2,881085964,881086012,48,1,472,2.984375
525,2,3,1,881086012,881086051,39,472,123,3.297872340425532
525,3,3,0,881086051,881086078,27,123,14,4.101694915254237
525,3,4,1,881086078,881086108,30,14,100,4.0162162162162165
525,4,4,0,881086108,881086195,87,100,596,3.180327868852459
525,4,3,-1,881086195,881086274,79,596,1011,3.1
525,3,4,1,881086274,881086393,119,1011,1315,3.4444444444444446
525,4,3,-1,881086393,881086413,20,1315,597,3.2771084337349397
525,3,2,-1,881086413,881086518,105,597,676,3.3142857142857145
525,2,5,3,881086518,881086562,44,676,151,3.6544117647058822
525,5,3,-2,881086562,881086586,24,151,928,3.142857142857143
525,3,3,0,881086586,881086612,26,928,411,2.911764705882353
525,3,4,1,881086612,881086693,81,411,405,3.25
525,4,2,-2,881086693,881086757,64,405,412,2.272727272727273
525,2,3,1,881086757,881086780,23,412,252,2.911392405063291
525,3,2,-1,881086780,881086803,23,252,595,2.9166666666666665
525,2,2,0,881086803,881086938,135,595,106,2.8125
525,2,5,3,881086938,881087067,129,106,269,4.085106382978723
521,3,3,0,884475485,884475524,39,751,271,3.3134328358208953
521,3,3,0,884475524,884475555,31,271,300,3.6861313868613137
521,3,4,1,884475555,884475591,36,300,1022,3.727272727272727
521,4,3,-1,884475591,884475605,14,1022,343,3.0
521,3,3,0,884475605,884475618,13,343,748,3.1043478260869564
521,3,4,1,884475618,884475799,181,748,50,4.306532663316583
521,4,2,-2,884475799,884475825,26,50,1,3.902439024390244
521,2,5,3,884475825,884475845,20,1,109,3.282608695652174
521,5,3,-2,884475845,884475872,27,109,100,4.0162162162162165
521,3,4,1,884475872,884475913,41,100,246,4.0
521,4,2,-2,884475913,884476002,89,246,25,3.3185840707964602
521,2,3,1,884476002,884476020,18,25,250,3.4698795180722892
521,3,3,0,884476020,884476035,15,250,257,3.7154471544715446
521,3,3,0,884476035,884476049,14,257,1012,3.2916666666666665
521,3,3,0,884476049,884476067,18,1012,240,3.0350877192982457
521,3,3,0,884476067,884476110,43,240,248,3.746268656716418
521,3,3,0,884476110,884476126,16,248,298,3.779220779220779
521,3,4,1,884476126,884476152,26,298,763,3.347826086956522
521,4,2,-2,884476152,884476168,16,763,829,2.4615384615384617
521,2,3,1,884476168,884476221,53,829,235,3.106382978723404
521,3,4,1,884476221,884476257,36,235,249,3.3275862068965516
521,4,2,-2,884476257,884476302,45,249,597,3.2771084337349397
521,2,1,-1,884476302,884476821,519,597,1059,2.764705882352941
521,1,4,3,884476821,884476837,16,1059,147,3.3142857142857145
521,4,2,-2,884476837,884476869,32,147,833,2.9444444444444446
521,2,3,1,884476869,884476887,18,833,1244,2.7777777777777777
521,3,1,-2,884476887,884476904,17,1244,827,2.4375
521,1,2,1,884476904,884476920,16,827,826,2.5555555555555554
521,2,3,1,884476920,884477585,665,826,520,4.136363636363637
521,3,3,0,884477585,884477630,45,520,427,4.2025316455696204
521,3,4,1,884477630,884477656,26,427,79,3.956989247311828
521,4,3,-1,884477656,884477677,21,79,474,4.172413793103448
521,3,3,0,884477677,884477727,50,474,69,3.8015873015873014
521,3,4,1,884477727,884477775,48,69,195,3.9072164948453607
521,4,4,0,884477775,884477820,45,195,176,3.967032967032967
521,4,3,-1,884477820,884477896,76,176,203,3.826923076923077
521,3,3,0,884477896,884477914,18,203,8,3.903225806451613
521,3,4,1,884477914,884477993,79,8,11,3.8904109589041096
521,4,4,0,884477993,884478007,14,11,228,3.7246376811594204
521,4,3,-1,884478007,884478049,42,228,172,4.225225225225225
521,3,4,1,884478049,884478086,37,172,153,3.7865168539325844
521,4,3,-1,884478086,884478101,15,153,568,3.5853658536585367
521,3,2,-1,884478101,884478119,18,568,154,3.6031746031746033
521,2,4,2,884478119,884478152,33,154,746,3.7560975609756095
521,4,4,0,884478152,884478171,19,746,156,4.017857142857143
521,4,3,-1,884478171,884478314,143,156,87,3.9
521,3,4,1,884478314,884478358,44,87,186,3.905263157894737
521,4,3,-1,884478358,884478428,70,186,23,3.9047619047619047
521,3,3,0,884478428,884478483,55,23,163,3.53125
521,3,3,0,884478483,884478515,32,163,679,3.2432432432432434
521,3,3,0,884478515,884478530,15,679,202,3.730337078651685
521,3,3,0,884478530,884478667,137,202,1240,3.5454545454545454
521,3,4,1,884478667,884478721,54,1240,226,3.378787878787879
521,4,3,-1,884478721,884478792,71,226,423,3.7016129032258065
521,3,3,0,884478792,884478807,15,423,684,3.847826086956522
521,3,3,0,884478807,885253247,774440,684,265,3.710144927536232
521,3,3,0,885253247,885253266,19,265,89,3.9615384615384617
521,3,3,0,885253266,885253323,57,89,28,3.923076923076923
521,3,4,1,885253323,885253337,14,28,721,3.4583333333333335
521,4,4,0,885253337,885253352,15,721,127,4.162790697674419
521,4,3,-1,885253352,885253376,24,127,651,3.8627450980392157
521,3,3,0,885253376,885253501,125,651,402,3.3076923076923075
521,3,3,0,885253501,885253562,61,402,208,3.8125
521,3,2,-1,885253562,885253668,106,208,496,4.094594594594595
521,2,4,2,885253668,885253758,90,496,403,3.298507462686567
521,4,3,-1,885253758,885253808,50,403,227,3.169811320754717
521,3,3,0,885253808,885253827,19,227,73,3.588235294117647
521,3,1,-2,885253827,885253861,34,73,81,3.2857142857142856
521,1,3,2,885253861,885253937,76,81,99,3.8392857142857144
521,3,4,1,885253937,885254006,69,99,241,3.5625
521,4,4,0,885254006,885254070,64,241,421,3.462962962962963
521,4,2,-2,885254070,885254116,46,421,161,3.5844155844155843
521,2,4,2,885254116,885254133,17,161,33,3.2941176470588234
521,4,1,-3,885254133,885254166,33,33,291,3.2
521,1,3,2,885254166,885254250,84,291,230,3.3518518518518516
521,3,2,-1,885254250,885254307,57,230,231,2.938775510204082
521,2,3,1,885254307,885254338,31,231,77,3.3857142857142857
521,3,1,-2,885254338,885254888,550,77,17,3.032258064516129
521,1,3,2,885254888,885254925,37,17,566,3.543859649122807
521,3,3,0,885254925,886063310,808385,566,2,3.0851063829787235
520,5,5,0,885168677,885168819,142,690,242,3.5217391304347827
520,5,4,-1,885168819,885168862,43,242,310,3.6666666666666665
520,4,5,1,885168862,885168939,77,310,898,3.0869565217391304
520,5,4,-1,885168939,885169052,113,898,289,2.988888888888889
520,4,4,0,885169052,885169083,31,289,315,4.15
520,4,4,0,885169083,885170394,1311,315,100,4.0162162162162165
520,4,1,-3,885170394,885170476,82,100,1028,2.857142857142857
520,1,4,3,885170476,885170516,40,1028,283,3.901639344262295
520,4,1,-3,885170516,885170547,31,283,871,2.3823529411764706
520,1,3,2,885170547,885170585,38,871,1051,3.625
519,4,5,1,883248089,883248134,45,288,313,4.323076923076923
519,5,1,-4,883248134,883248191,57,313,324,3.2291666666666665
519,1,3,2,883248191,883248222,31,324,339,2.7058823529411766
519,3,5,2,883248222,883248251,29,339,340,3.7419354838709675
519,5,5,0,883248251,883248595,344,340,903,2.6666666666666665
519,5,5,0,883248595,883250148,1553,903,1612,4.5
519,5,5,0,883250148,884545961,1295813,1612,299,3.0
528,5,5,0,886101505,886101610,105,657,173,4.1441441441441444
528,5,5,0,886101610,886101632,22,173,83,4.204081632653061
528,5,4,-1,886101632,886101652,20,83,185,3.9726027397260273
528,4,2,-2,886101652,886101695,43,185,393,3.5125
528,2,4,2,886101695,886101715,20,393,615,3.8333333333333335
528,4,2,-2,886101715,886101736,21,615,588,3.8358208955223883
528,2,5,3,886101736,886101761,25,588,31,3.642857142857143
528,5,3,-2,886101761,886101782,21,31,238,3.888888888888889
528,3,5,2,886101782,886101821,39,238,174,4.253521126760563
528,5,4,-1,886101821,886101846,25,174,523,4.159090909090909
528,4,2,-2,886101846,886101872,26,523,485,3.717948717948718
528,2,4,2,886101872,886101873,1,485,193,3.883720930232558
528,4,5,1,886101873,886101911,38,193,79,3.956989247311828
528,5,5,0,886101911,886101956,45,79,194,4.029411764705882
528,5,5,0,886101956,886101976,20,194,210,3.921259842519685
528,5,5,0,886101976,886101994,18,210,58,3.543859649122807
528,5,3,-2,886101994,886812886,710892,58,250,3.4698795180722892
528,3,3,0,886812886,886812920,34,250,1254,2.4
528,3,4,1,886812920,886812980,60,1254,109,3.282608695652174
528,4,2,-2,886812980,886813066,86,109,422,3.25
528,2,3,1,886813066,888520438,1707372,422,294,3.1052631578947367
528,3,2,-1,888520438,888520491,53,294,358,2.6551724137931036
528,2,3,1,888520491,888520525,34,358,678,2.8181818181818183
528,3,4,1,888520525,888520849,324,678,298,3.779220779220779
528,4,4,0,888520849,888520911,62,298,402,3.3076923076923075
528,4,4,0,888520911,888522613,1702,402,203,3.826923076923077
532,3,3,0,874789155,874789332,177,1199,38,2.784313725490196
532,3,4,1,874789332,874789474,142,38,451,3.207792207792208
532,4,2,-2,874789474,874789538,64,451,795,2.4
532,2,3,1,874789538,874789704,166,795,105,2.6176470588235294
532,3,2,-1,874789704,874790629,925,105,831,2.6097560975609757
532,2,4,2,874790629,874790813,184,831,554,2.9555555555555557
532,4,3,-1,874790813,874790930,117,554,1337,3.0
532,3,4,1,874790930,874790998,68,1337,1188,2.45
532,4,3,-1,874790998,874791172,174,1188,771,2.5714285714285716
532,3,3,0,874791172,874791506,334,771,1426,4.0
532,3,4,1,874791506,874791671,165,1426,721,3.4583333333333335
532,4,3,-1,874791671,874791786,115,721,734,3.0
532,3,3,0,874791786,874791850,64,734,592,4.333333333333333
532,3,3,0,874791850,874791976,126,592,364,2.8095238095238093
532,3,3,0,874791976,874792031,55,364,411,2.911764705882353
532,3,3,0,874792031,874792142,111,411,369,2.5714285714285716
532,3,5,2,874792142,874792232,90,369,139,2.7222222222222223
532,5,2,-3,874792232,874796421,4189,139,450,2.2758620689655173
532,2,3,1,874796421,875441348,644927,450,267,3.3333333333333335
532,3,4,1,875441348,876696298,1254950,267,332,3.6511627906976742
532,4,5,1,876696298,884594358,7898060,332,750,4.027777777777778
532,5,3,-2,884594358,884594450,92,750,895,3.142857142857143
532,3,4,1,884594450,884594575,125,895,898,3.0869565217391304
532,4,4,0,884594575,884594621,46,898,292,3.6666666666666665
532,4,5,1,884594621,884594761,140,292,295,3.769230769230769
532,5,4,-1,884594761,884594932,171,295,187,4.215189873417722
532,4,2,-2,884594932,886364951,1770019,187,353,2.4285714285714284
532,2,5,3,886364951,888629254,2264303,353,482,3.9444444444444446
532,5,4,-1,888629254,888629446,192,482,52,3.727272727272727
532,4,3,-1,888629446,888629518,72,52,601,3.857142857142857
532,3,5,2,888629518,888629565,47,601,679,3.2432432432432434
532,5,4,-1,888629565,888629670,105,679,153,3.7865168539325844
532,4,4,0,888629670,888629804,134,153,570,3.526315789473684
532,4,3,-1,888629804,888629836,32,570,722,2.9642857142857144
532,3,4,1,888629836,888629863,27,722,1039,3.9583333333333335
532,4,3,-1,888629863,888629938,75,1039,240,3.0350877192982457
532,3,4,1,888629938,888630086,148,240,155,3.0588235294117645
532,4,3,-1,888630086,888630146,60,155,926,2.7857142857142856
532,3,4,1,888630146,888630205,59,926,447,3.46875
532,4,3,-1,888630205,888630360,155,447,399,3.317073170731707
532,3,4,1,888630360,888630436,76,399,1168,3.4166666666666665
532,4,4,0,888630436,888630453,17,1168,1217,3.4166666666666665
532,4,2,-2,888630453,888630531,78,1217,769,2.2222222222222223
532,2,5,3,888630531,888630585,54,769,452,2.6129032258064515
532,5,2,-3,888630585,888630742,157,452,120,2.3421052631578947
532,2,2,0,888630742,888630838,96,120,1092,2.5714285714285716
532,2,4,2,888630838,888631036,198,1092,1312,2.8333333333333335
532,4,3,-1,888631036,888631077,41,1312,982,3.2
532,3,2,-1,888631077,888631576,499,982,1162,2.0
532,2,4,2,888631576,888634802,3226,1162,147,3.3142857142857145
532,4,5,1,888634802,888635239,437,147,300,3.6861313868613137
532,5,4,-1,888635239,888635264,25,300,248,3.746268656716418
532,4,5,1,888635264,888635365,101,248,51,3.5277777777777777
532,5,5,0,888635365,888635366,1,51,419,3.8208955223880596
532,5,4,-1,888635366,888635376,10,419,815,3.135135135135135
532,4,4,0,888635376,888635407,31,815,842,3.0
532,4,4,0,888635407,888636374,967,842,121,3.521212121212121
532,4,3,-1,888636374,888636423,49,121,315,4.15
532,3,4,1,888636423,888636450,27,315,1016,3.559322033898305
532,4,4,0,888636450,888636478,28,1016,252,2.911392405063291
532,4,4,0,888636478,888636501,23,252,177,3.875
532,4,3,-1,888636501,888636521,20,177,29,2.5714285714285716
532,3,2,-1,888636521,888636558,37,29,1136,3.3076923076923075
532,2,4,2,888636558,888637105,547,1136,492,4.117647058823529
532,4,4,0,888637105,888817735,180630,492,242,3.5217391304347827
532,4,3,-1,888817735,891910110,3092375,242,250,3.4698795180722892
532,3,4,1,891910110,891910189,79,250,186,3.905263157894737
532,4,5,1,891910189,892519935,609746,186,357,4.063291139240507
532,5,3,-2,892519935,892520073,138,357,829,2.4615384615384617
532,3,4,1,892520073,892520128,55,829,917,4.0
532,4,4,0,892520128,892520198,70,917,477,3.1666666666666665
532,4,2,-2,892520198,892520390,192,477,1415,2.8
532,2,5,3,892520390,892521554,1164,1415,82,3.6741573033707864
532,5,5,0,892521554,892859149,337595,82,636,3.4146341463414633
532,5,5,0,892859149,893119415,260266,636,4,3.5538461538461537
532,5,5,0,893119415,893119438,23,4,99,3.8392857142857144
532,5,5,0,893119438,893119439,1,99,277,3.6
532,5,5,0,893119439,893119491,52,277,1011,3.1
530,3,4,1,883784105,883784195,90,195,98,4.240875912408759
530,4,4,0,883784195,883784258,63,98,692,3.56
530,4,4,0,883784258,883784503,245,692,174,4.253521126760563
530,4,4,0,883784503,883784557,54,174,487,4.043478260869565
530,4,5,1,883784557,883784601,44,487,196,3.9404761904761907
530,5,4,-1,883784601,883784654,53,196,527,3.823529411764706
530,4,5,1,883784654,883790567,5913,527,607,4.136363636363637
530,5,4,-1,883790567,883790882,315,607,183,3.951219512195122
530,4,5,1,883790882,883790942,60,183,64,4.373737373737374
530,5,4,-1,883790942,883790943,1,64,443,3.8421052631578947
530,4,5,1,883790943,883790997,54,443,60,4.105263157894737
530,5,4,-1,883790997,886198575,2407578,60,535,3.380952380952381
530,4,3,-1,886198575,890627264,4428689,535,333,3.546666666666667
530,3,5,2,890627264,890627396,132,333,275,4.087912087912088
530,5,4,-1,890627396,890627443,47,275,88,3.433734939759036
530,4,3,-1,890627443,891568424,940981,88,319,3.0408163265306123
531,3,5,2,887048718,887048741,23,327,286,3.442857142857143
531,5,4,-1,887048741,887048763,22,286,311,3.761904761904762
531,4,5,1,887048763,887048789,26,311,990,2.769230769230769
531,5,4,-1,887048789,887048813,24,990,332,3.6511627906976742
531,4,4,0,887048813,887048836,23,332,751,3.3896103896103895
531,4,4,0,887048836,887048862,26,751,300,3.6861313868613137
531,4,5,1,887048862,887048899,37,300,312,3.0
531,5,1,-4,887048899,887048938,39,312,338,2.75
531,1,1,0,887048938,887048998,60,338,688,2.111111111111111
531,1,4,3,887048998,887049049,51,688,245,3.056179775280899
531,4,4,0,887049049,887049081,32,245,748,3.1043478260869564
531,4,4,0,887049081,887049166,85,748,905,3.357142857142857
531,4,1,-3,887049166,887049187,21,905,358,2.6551724137931036
531,1,1,0,887049187,887049214,27,358,894,2.0
531,1,1,0,887049214,887049341,127,894,457,1.7
531,1,5,4,887049341,887049364,23,457,313,4.323076923076923
529,4,4,0,882535049,882535091,42,300,873,2.7586206896551726
529,4,4,0,882535091,882535180,89,873,292,3.6666666666666665
529,4,1,-3,882535180,882535181,1,292,340,3.7419354838709675
529,1,4,3,882535181,882535256,75,340,328,3.4895833333333335
529,4,4,0,882535256,882535353,97,328,886,2.857142857142857
529,4,4,0,882535353,882535383,30,886,322,3.0476190476190474
529,4,3,-1,882535383,882535466,83,322,876,3.0
529,3,2,-1,882535466,882535563,97,876,324,3.2291666666666665
529,2,1,-1,882535563,882535639,76,324,991,2.4545454545454546
529,1,3,2,882535639,882535693,54,991,325,2.625
529,3,4,1,882535693,882535714,21,325,875,2.736842105263158
529,4,2,-2,882535714,882535820,106,875,264,2.65
517,4,3,-1,892659893,892659922,29,405,333,3.546666666666667
517,3,2,-1,892659922,892659923,1,333,284,3.1547619047619047
517,2,4,2,892659923,892660033,110,284,181,3.98974358974359
517,4,5,1,892660033,892660728,695,181,1177,3.0
527,3,1,-2,879455415,879455511,96,324,878,2.0
527,1,5,4,879455511,879455654,143,878,507,3.6285714285714286
527,5,4,-1,879455654,879455680,26,507,124,4.052631578947368
527,4,4,0,879455680,879455706,26,124,50,4.306532663316583
527,4,4,0,879455706,879455707,1,50,479,4.25
527,4,4,0,879455707,879455740,33,479,427,4.2025316455696204
527,4,3,-1,879455740,879455765,25,427,1211,3.5714285714285716
527,3,4,1,879455765,879455792,27,1211,425,3.7027027027027026
527,4,2,-2,879455792,879455814,22,425,855,3.590909090909091
527,2,4,2,879455814,879455847,33,855,956,3.5714285714285716
527,4,4,0,879455847,879455924,77,956,210,3.921259842519685
527,4,5,1,879455924,879455961,37,210,709,4.171428571428572
527,5,5,0,879455961,879455999,38,709,187,4.215189873417722
527,5,4,-1,879455999,879456078,79,187,603,4.315789473684211
527,4,4,0,879456078,879456132,54,603,60,4.105263157894737
527,4,4,0,879456132,879456162,30,60,558,3.75
527,4,5,1,879456162,879456186,24,558,661,4.133333333333334
527,5,5,0,879456186,879456248,62,661,511,4.096153846153846
527,5,4,-1,879456248,879456289,41,511,588,3.8358208955223883
527,4,4,0,879456289,879456312,23,588,615,3.8333333333333335
527,4,5,1,879456312,879456334,22,615,180,3.9473684210526314
527,5,4,-1,879456334,879456362,28,180,190,4.233333333333333
527,4,3,-1,879456362,879456363,1,190,508,3.6923076923076925
527,3,4,1,879456363,879456438,75,508,86,3.869565217391304
527,4,4,0,879456438,879456464,26,86,181,3.98974358974359
527,4,3,-1,879456464,879456587,123,181,179,3.8823529411764706
527,3,4,1,879456587,879456637,50,179,1149,3.857142857142857
527,4,4,0,879456637,879456662,25,1149,11,3.8904109589041096
527,4,2,-2,879456662,879456663,1,11,14,4.101694915254237
527,2,4,2,879456663,879456691,28,14,1101,3.793103448275862
485,4,3,-1,891040493,891040560,67,269,538,3.25
485,3,1,-2,891040560,891041103,543,538,294,3.1052631578947367
485,1,3,2,891041103,891041171,68,294,288,3.5214285714285714
485,3,3,0,891041171,891041275,104,288,321,3.0172413793103448
485,3,2,-1,891041275,891041551,276,321,748,3.1043478260869564
485,2,2,0,891041551,891041705,154,748,326,3.262295081967213
485,2,3,1,891041705,891041782,77,326,245,3.056179775280899
485,3,3,0,891041782,891042162,380,245,330,2.625
533,3,3,0,879190724,879190771,47,484,474,4.172413793103448
533,3,2,-1,879190771,879190926,155,474,462,3.7954545454545454
533,2,2,0,879190926,879190991,65,462,91,3.6
533,2,4,2,879190991,879191061,70,91,194,4.029411764705882
533,4,3,-1,879191061,879191085,24,194,357,4.063291139240507
533,3,4,1,879191085,879191184,99,357,174,4.253521126760563
533,4,5,1,879191184,879191220,36,174,132,3.929411764705882
533,5,3,-2,879191220,879191265,45,132,182,3.842857142857143
533,3,4,1,879191265,879191300,35,182,177,3.875
533,4,1,-3,879191300,879191332,32,177,176,3.967032967032967
533,1,4,3,879191332,879191373,41,176,427,4.2025316455696204
533,4,4,0,879191373,879191374,1,427,208,3.8125
533,4,3,-1,879191374,879191469,95,208,293,3.630434782608696
533,3,4,1,879191469,879191563,94,293,230,3.3518518518518516
533,4,4,0,879191563,879191594,31,230,44,3.1333333333333333
533,4,3,-1,879191594,879191595,1,44,443,3.8421052631578947
533,3,1,-2,879191595,879191621,26,443,53,2.9523809523809526
533,1,4,3,879191621,879191652,31,53,356,3.2
533,4,2,-2,879191652,879191691,39,356,38,2.784313725490196
533,2,3,1,879191691,879191770,79,38,23,3.9047619047619047
533,3,4,1,879191770,879191864,94,23,216,3.8454545454545452
533,4,2,-2,879191864,879191902,38,216,83,4.204081632653061
533,2,4,2,879191902,879191938,36,83,70,3.5833333333333335
533,4,4,0,879191938,879191972,34,70,211,3.958904109589041
533,4,1,-3,879191972,879191998,26,211,47,3.5869565217391304
533,1,3,2,879191998,879192034,36,47,580,3.625
533,3,4,1,879192034,879192069,35,580,393,3.5125
533,4,4,0,879192069,879192157,88,393,778,3.5925925925925926
533,4,4,0,879192157,879192184,27,778,94,2.8823529411764706
533,4,4,0,879192184,879192315,131,94,28,3.923076923076923
533,4,4,0,879192315,879192414,99,28,126,3.8620689655172415
533,4,3,-1,879192414,879192474,60,126,151,3.6544117647058822
533,3,3,0,879192474,879192475,1,151,13,3.5454545454545454
533,3,1,-2,879192475,879192500,25,13,475,3.956043956043956
533,1,4,3,879192500,879192521,21,475,1,3.902439024390244
533,4,2,-2,879192521,879192582,61,1,713,3.5
533,2,1,-1,879192582,879192641,59,713,284,3.1547619047619047
533,1,4,3,879192641,879192681,40,284,742,3.5555555555555554
533,4,2,-2,879192681,879192730,49,742,871,2.3823529411764706
533,2,4,2,879192730,879192792,62,871,118,3.2764227642276422
533,4,3,-1,879192792,879192793,1,118,405,3.25
533,3,4,1,879192793,879192815,22,405,740,3.423076923076923
533,4,5,1,879192815,879192901,86,740,117,3.689189189189189
533,5,3,-2,879192901,879192939,38,117,597,3.2771084337349397
533,3,4,1,879192939,879193004,65,597,756,2.6885245901639343
533,4,2,-2,879193004,879193048,44,756,237,3.7315436241610738
533,2,4,2,879193048,879193106,58,237,322,3.0476190476190474
533,4,3,-1,879193106,879193132,26,322,319,3.0408163265306123
533,3,3,0,879193132,879365781,172649,319,19,3.9615384615384617
533,3,2,-1,879365781,879365886,105,19,846,3.1052631578947367
533,2,2,0,879365886,879365951,65,846,476,3.1216216216216215
533,2,2,0,879365951,879365998,47,476,411,2.911764705882353
533,2,1,-1,879365998,879366076,78,411,1291,2.125
533,1,1,0,879366076,879366118,42,1291,122,2.282608695652174
533,1,1,0,879366118,879366159,41,122,412,2.272727272727273
533,1,2,1,879366159,879366160,1,412,931,2.2758620689655173
533,2,4,2,879366160,879438470,72310,931,483,4.475609756097561
533,4,3,-1,879438470,879438486,16,483,192,4.090909090909091
533,3,4,1,879438486,879438510,24,192,380,3.4878048780487805
533,4,4,0,879438510,879438543,33,380,12,4.358974358974359
533,4,4,0,879438543,879438666,123,12,385,3.6129032258064515
533,4,4,0,879438666,879438743,77,385,203,3.826923076923077
533,4,4,0,879438743,879438811,68,203,187,4.215189873417722
533,4,4,0,879438811,879438849,38,187,69,3.8015873015873014
533,4,4,0,879438849,879438850,1,69,498,4.290909090909091
533,4,4,0,879438850,879438941,91,498,215,3.662921348314607
533,4,5,1,879438941,879439061,120,215,496,4.094594594594595
533,5,4,-1,879439061,879439082,21,496,195,3.9072164948453607
533,4,2,-2,879439082,879439167,85,195,708,3.3157894736842106
533,2,4,2,879439167,879439204,37,708,66,3.4705882352941178
533,4,4,0,879439204,879439290,86,66,378,3.6904761904761907
533,4,2,-2,879439290,879439379,89,378,190,4.233333333333333
533,2,4,2,879439379,879439465,86,190,161,3.5844155844155843
533,4,3,-1,879439465,879439488,23,161,371,3.0
533,3,4,1,879439488,879439519,31,371,949,3.392857142857143
533,4,5,1,879439519,879439720,201,949,676,3.3142857142857145
533,5,3,-2,879439720,879773606,333886,676,107,3.45
533,3,4,1,879773606,880402957,629351,107,477,3.1666666666666665
533,4,2,-2,880402957,880402996,39,477,596,3.180327868852459
533,2,2,0,880402996,882195237,1792241,596,255,3.2027027027027026
533,2,3,1,882195237,882902727,707490,255,291,3.2
533,3,4,1,882902727,882902989,262,291,845,3.661290322580645
533,4,4,0,882902989,883583127,680138,845,292,3.6666666666666665
533,4,1,-3,883583127,884698117,1114990,292,147,3.3142857142857145
533,1,4,3,884698117,886425803,1727686,147,333,3.546666666666667
533,4,2,-2,886425803,887032297,606494,333,866,3.3962264150943398
533,2,3,1,887032297,887032538,241,866,696,3.138888888888889
533,3,2,-1,887032538,887721800,689262,696,744,3.5714285714285716
533,2,4,2,887721800,888347670,625870,744,1142,4.0476190476190474
533,4,4,0,888347670,888347691,21,1142,724,3.64
533,4,4,0,888347691,888844577,496886,724,282,3.610526315789474
533,4,4,0,888844577,888844601,24,282,54,3.3714285714285714
533,4,4,0,888844601,888844941,340,54,196,3.9404761904761907
533,4,3,-1,888844941,888845066,125,196,4,3.5538461538461537
533,3,4,1,888845066,888845150,84,4,58,3.543859649122807
533,4,4,0,888845150,888845229,79,58,504,4.085714285714285
533,4,3,-1,888845229,888845338,109,504,755,3.085714285714286
533,3,3,0,888845338,889450842,605504,755,1048,2.857142857142857
533,3,3,0,889450842,890659295,1208453,1048,748,3.1043478260869564
535,3,2,-1,879617098,879617123,25,338,286,3.442857142857143
535,2,4,2,879617123,879617199,76,286,301,3.2465753424657535
535,4,5,1,879617199,879617310,111,301,319,3.0408163265306123
535,5,2,-3,879617310,879617531,221,319,357,4.063291139240507
535,2,3,1,879617531,879617574,43,357,527,3.823529411764706
535,3,4,1,879617574,879617613,39,527,165,3.9130434782608696
535,4,3,-1,879617613,879617663,50,165,461,3.3333333333333335
535,3,3,0,879617663,879617747,84,461,172,4.225225225225225
535,3,5,2,879617747,879617779,32,172,9,3.8878504672897196
535,5,4,-1,879617779,879617818,39,9,181,3.98974358974359
535,4,5,1,879617818,879617819,1,181,506,3.566666666666667
535,5,4,-1,879617819,879617856,37,506,645,3.5714285714285716
535,4,4,0,879617856,879617894,38,645,499,4.0
535,4,5,1,879617894,879617931,37,499,508,3.6923076923076925
535,5,4,-1,879617931,879617977,46,508,591,3.7169811320754715
535,4,3,-1,879617977,879617978,1,591,135,3.7974683544303796
535,3,5,2,879617978,879618019,41,135,953,3.076923076923077
535,5,4,-1,879618019,879618058,39,953,1396,4.0
535,4,4,0,879618058,879618091,33,1396,52,3.727272727272727
535,4,4,0,879618091,879618123,32,52,121,3.521212121212121
535,4,4,0,879618123,879618160,37,121,170,4.242424242424242
535,4,5,1,879618160,879618207,47,170,223,4.108695652173913
535,5,3,-2,879618207,879618246,39,223,116,3.6666666666666665
535,3,4,1,879618246,879618288,42,116,1149,3.857142857142857
535,4,5,1,879618288,879618338,50,1149,425,3.7027027027027026
535,5,3,-2,879618338,879618414,76,425,662,3.4583333333333335
535,3,3,0,879618414,879618464,50,662,469,3.6842105263157894
535,3,4,1,879618464,879618465,1,469,1136,3.3076923076923075
535,4,4,0,879618465,879618502,37,1136,318,4.5046728971962615
535,4,4,0,879618502,879618532,30,318,16,3.411764705882353
535,4,5,1,879618532,879618569,37,16,518,3.5833333333333335
535,5,3,-2,879618569,879618655,86,518,529,4.142857142857143
535,3,3,0,879618655,879618700,45,529,221,3.6923076923076925
535,3,5,2,879618700,879618742,42,221,483,4.475609756097561
535,5,4,-1,879618742,879618776,34,483,629,3.3333333333333335
535,4,4,0,879618776,879618809,33,629,238,3.888888888888889
535,4,5,1,879618809,879618849,40,238,213,3.943396226415094
535,5,4,-1,879618849,879618850,1,213,198,4.04
535,4,5,1,879618850,879618925,75,198,709,4.171428571428572
535,5,5,0,879618925,879618965,40,709,87,3.9
535,5,4,-1,879618965,879619000,35,87,699,3.736842105263158
535,4,1,-3,879619000,879619067,67,699,702,2.764705882352941
535,1,3,2,879619067,879619107,40,702,22,4.215909090909091
535,3,2,-1,879619107,879619144,37,22,630,3.25
535,2,5,3,879619144,879619176,32,630,631,3.581818181818182
535,5,3,-2,879619176,879619224,48,631,515,4.202898550724638
535,3,5,2,879619224,879619286,62,515,258,3.7547169811320753
536,3,3,0,882317183,882317312,129,304,596,3.180327868852459
536,3,2,-1,882317312,882318246,934,596,405,3.25
536,2,5,3,882318246,882318287,41,405,275,4.087912087912088
536,5,5,0,882318287,882318369,82,275,1115,3.3846153846153846
536,5,4,-1,882318369,882318415,46,1115,117,3.689189189189189
536,4,2,-2,882318415,882318533,118,117,546,2.9789473684210526
536,2,5,3,882318533,882318561,28,546,408,4.4772727272727275
536,5,4,-1,882318561,882318630,69,408,740,3.423076923076923
536,4,4,0,882318630,882318741,111,740,713,3.5
536,4,4,0,882318741,882318820,79,713,121,3.521212121212121
536,4,3,-1,882318820,882319003,183,121,472,2.984375
536,3,5,2,882319003,882359065,40062,472,174,4.253521126760563
536,5,4,-1,882359065,882359085,20,174,385,3.6129032258064515
536,4,4,0,882359085,882359333,248,385,493,3.909090909090909
536,4,5,1,882359333,882359370,37,493,480,4.283018867924528
536,5,3,-2,882359370,882359455,85,480,183,3.951219512195122
536,3,4,1,882359455,882359477,22,183,133,3.7777777777777777
536,4,3,-1,882359477,882359499,22,133,199,4.191489361702128
536,3,5,2,882359499,882359539,40,199,172,4.225225225225225
536,5,4,-1,882359539,882359540,1,172,153,3.7865168539325844
536,4,3,-1,882359540,882359567,27,153,197,4.112676056338028
536,3,3,0,882359567,882359584,17,197,87,3.9
536,3,2,-1,882359584,882359625,41,87,179,3.8823529411764706
536,2,4,2,882359625,882359652,27,179,486,3.9565217391304346
536,4,4,0,882359652,882359653,1,486,614,3.727272727272727
536,4,5,1,882359653,882359678,25,614,707,3.909090909090909
536,5,3,-2,882359678,882359697,19,707,727,3.5517241379310347
536,3,3,0,882359697,882359726,29,727,588,3.8358208955223883
536,3,3,0,882359726,882359755,29,588,435,3.8933333333333335
536,3,4,1,882359755,882359780,25,435,136,3.764705882352941
536,4,4,0,882359780,882359838,58,136,510,3.823529411764706
536,4,5,1,882359838,882359863,25,510,168,4.0476190476190474
536,5,3,-2,882359863,882359883,20,168,436,3.5
536,3,5,2,882359883,882359906,23,436,498,4.290909090909091
536,5,4,-1,882359906,882359938,32,498,204,3.6744186046511627
536,4,4,0,882359938,882359962,24,204,132,3.929411764705882
536,4,4,0,882359962,882359988,26,132,96,3.9130434782608696
536,4,4,0,882359988,882360029,41,96,98,4.240875912408759
536,4,2,-2,882360029,882360030,1,98,209,3.8275862068965516
536,2,5,3,882360030,882360080,50,209,163,3.53125
536,5,2,-3,882360080,882360100,20,163,582,3.7457627118644066
536,2,5,3,882360100,882360143,43,582,189,3.88
536,5,3,-2,882360143,882360187,44,189,52,3.727272727272727
536,3,4,1,882360187,882360209,22,52,568,3.5853658536585367
536,4,4,0,882360209,882360227,18,568,2,3.0851063829787235
536,4,5,1,882360227,882360264,37,2,736,4.083333333333333
536,5,5,0,882360264,882360300,36,736,265,3.710144927536232
536,5,5,0,882360300,882360361,61,265,95,3.8194444444444446
536,5,3,-2,882360361,882360405,44,95,56,4.051724137931035
536,3,5,2,882360405,882360424,19,56,205,3.717391304347826
536,5,5,0,882360424,882360425,1,205,143,3.56
536,5,2,-3,882360425,882360450,25,143,214,3.272727272727273
536,2,4,2,882360450,882360451,1,214,489,4.076923076923077
536,4,4,0,882360451,882360495,44,489,679,3.2432432432432434
536,4,5,1,882360495,882360530,35,679,470,3.72
536,5,4,-1,882360530,882360552,22,470,222,3.578125
536,4,3,-1,882360552,882360573,21,222,86,3.869565217391304
536,3,5,2,882360573,882360622,49,86,694,4.277777777777778
536,5,3,-2,882360622,882360685,63,694,31,3.642857142857143
536,3,3,0,882360685,882360753,68,31,49,3.3
536,3,4,1,882360753,882360802,49,49,63,3.125
536,4,3,-1,882360802,882360833,31,63,443,3.8421052631578947
536,3,4,1,882360833,882360873,40,443,62,3.048780487804878
536,4,4,0,882360873,882360894,21,62,73,3.588235294117647
536,4,4,0,882360894,882360946,52,73,500,4.285714285714286
536,4,4,0,882360946,882360993,47,500,755,3.085714285714286
536,4,4,0,882360993,882361018,25,755,164,3.6140350877192984
536,4,5,1,882361018,882361066,48,164,227,3.169811320754717
536,5,4,-1,882361066,882361142,76,227,229,3.185185185185185
536,4,3,-1,882361142,882361162,20,229,570,3.526315789473684
536,3,3,0,882361162,882361179,17,570,708,3.3157894736842106
536,3,4,1,882361179,882361207,28,708,720,3.2
536,4,4,0,882361207,882361262,55,720,449,2.9069767441860463
536,4,3,-1,882361262,882361317,55,449,167,2.8181818181818183
536,3,3,0,882361317,882363919,2602,167,387,3.5357142857142856
536,3,3,0,882363919,882364065,146,387,561,3.1515151515151514
526,2,3,1,885681886,885681910,24,754,690,3.260869565217391
526,3,2,-1,885681910,885681958,48,690,307,3.6031746031746033
526,2,3,1,885681958,885681982,24,307,294,3.1052631578947367
526,3,2,-1,885681982,885682006,24,294,328,3.4895833333333335
526,2,2,0,885682006,885682031,25,328,300,3.6861313868613137
526,2,3,1,885682031,885682077,46,300,886,2.857142857142857
526,3,3,0,885682077,885682102,25,886,879,3.2291666666666665
526,3,2,-1,885682102,885682124,22,879,245,3.056179775280899
526,2,1,-1,885682124,885682214,90,245,748,3.1043478260869564
526,1,3,2,885682214,885682264,50,748,343,3.0
526,3,2,-1,885682264,885682295,31,343,312,3.0
526,2,3,1,885682295,885682370,75,312,282,3.610526315789474
526,3,4,1,885682370,885682426,56,282,127,4.162790697674419
526,4,4,0,885682426,885682448,22,127,181,3.98974358974359
526,4,1,-3,885682448,885682477,29,181,544,3.185185185185185
526,1,4,3,885682477,885682503,26,544,147,3.3142857142857145
526,4,2,-2,885682503,885682562,59,147,273,3.5238095238095237
526,2,5,3,885682562,885682590,28,273,845,3.661290322580645
526,5,3,-2,885682590,885682614,24,845,123,3.297872340425532
526,3,5,2,885682614,885682635,21,123,475,3.956043956043956
537,3,2,-1,886028498,886028544,46,286,749,3.2777777777777777
537,2,3,1,886028544,886028604,60,749,896,3.6666666666666665
537,3,4,1,886028604,886028647,43,896,268,3.9838709677419355
537,4,4,0,886028647,886028706,59,268,303,3.75
537,4,2,-2,886028706,886028707,1,303,333,3.546666666666667
537,2,2,0,886028707,886028730,23,333,327,3.5076923076923077
537,2,2,0,886028730,886028791,61,327,299,3.0
537,2,1,-1,886028791,886028845,54,299,349,2.5714285714285716
537,1,4,3,886028845,886029116,271,349,315,4.15
537,4,1,-3,886029116,886029181,65,315,678,2.8181818181818183
537,1,1,0,886029181,886029239,58,678,689,3.1538461538461537
537,1,4,3,886029239,886029286,47,689,258,3.7547169811320753
537,4,1,-3,886029286,886029444,158,258,457,1.7
537,1,1,0,886029444,886029488,44,457,1025,2.95
537,1,4,3,886029488,886029692,204,1025,100,4.0162162162162165
537,4,3,-1,886029692,886029726,34,100,236,3.2666666666666666
537,3,4,1,886029726,886029727,1,236,7,3.76056338028169
537,4,4,0,886029727,886029806,79,7,13,3.5454545454545454
537,4,2,-2,886029806,886029841,35,13,978,2.357142857142857
537,2,3,1,886029841,886029974,133,978,1068,3.2
537,3,2,-1,886029974,886030011,37,1068,117,3.689189189189189
537,2,4,2,886030011,886030012,1,117,919,4.0
537,4,3,-1,886030012,886030050,38,919,1084,4.0
537,3,1,-2,886030050,886030051,1,1084,1129,3.4444444444444446
537,1,3,2,886030051,886030077,26,1129,111,3.5106382978723403
537,3,3,0,886030077,886030078,1,111,149,2.4
537,3,3,0,886030078,886030109,31,149,224,3.4545454545454546
537,3,1,-2,886030109,886030176,67,224,24,3.3728813559322033
537,1,2,1,886030176,886030177,1,24,628,3.573529411764706
537,2,2,0,886030177,886030199,22,628,741,3.3043478260869565
537,2,2,0,886030199,886030235,36,741,274,3.5609756097560976
537,2,1,-1,886030235,886030281,46,274,281,3.2
537,1,2,1,886030281,886030317,36,281,979,3.1
537,2,3,1,886030317,886030347,30,979,950,2.625
537,3,3,0,886030347,886030380,33,950,744,3.5714285714285716
537,3,2,-1,886030380,886030381,1,744,1010,3.611111111111111
537,2,2,0,886030381,886030415,34,1010,472,2.984375
537,2,3,1,886030415,886030416,1,472,1011,3.1
537,3,3,0,886030416,886030442,26,1011,922,4.0
537,3,3,0,886030442,886030552,110,922,848,4.0
537,3,4,1,886030552,886030583,31,848,514,4.033333333333333
537,4,4,0,886030583,886030584,1,514,558,3.75
537,4,3,-1,886030584,886030652,68,558,469,3.6842105263157894
537,3,4,1,886030652,886030682,30,469,607,4.136363636363637
537,4,4,0,886030682,886030707,25,607,357,4.063291139240507
537,4,3,-1,886030707,886030738,31,357,489,4.076923076923077
537,3,4,1,886030738,886030767,29,489,187,4.215189873417722
537,4,4,0,886030767,886030768,1,187,530,4.125
537,4,4,0,886030768,886030805,37,530,48,4.055555555555555
537,4,4,0,886030805,886030831,26,48,211,3.958904109589041
537,4,4,0,886030831,886030862,31,211,182,3.842857142857143
537,4,2,-2,886030862,886030863,1,182,421,3.462962962962963
537,2,3,1,886030863,886030891,28,421,52,3.727272727272727
537,3,3,0,886030891,886030937,46,52,855,3.590909090909091
537,3,4,1,886030937,886030966,29,855,507,3.6285714285714286
537,4,3,-1,886030966,886030967,1,507,171,4.090909090909091
537,3,3,0,886030967,886031074,107,171,12,4.358974358974359
537,3,4,1,886031074,886031105,31,12,179,3.8823529411764706
537,4,3,-1,886031105,886031106,1,179,81,3.2857142857142856
537,3,3,0,886031106,886031149,43,81,746,3.7560975609756095
537,3,4,1,886031149,886031178,29,746,641,4.5
537,4,3,-1,886031178,886031211,33,641,604,3.8181818181818183
537,3,3,0,886031211,886031297,86,604,733,3.3333333333333335
537,3,4,1,886031297,886031341,44,733,517,3.625
537,4,3,-1,886031341,886031342,1,517,215,3.662921348314607
537,3,3,0,886031342,886031375,33,215,702,2.764705882352941
537,3,3,0,886031375,886031438,63,702,28,3.923076923076923
537,3,3,0,886031438,886031473,35,28,200,3.8157894736842106
537,3,3,0,886031473,886031474,1,200,228,3.7246376811594204
537,3,4,1,886031474,886031506,32,228,428,3.744186046511628
537,4,3,-1,886031506,886031575,69,428,510,3.823529411764706
537,3,3,0,886031575,886031576,1,510,735,3.58
537,3,3,0,886031576,886031606,30,735,30,3.8181818181818183
537,3,3,0,886031606,886031634,28,30,602,3.533333333333333
537,3,3,0,886031634,886031678,44,602,381,3.2758620689655173
537,3,4,1,886031678,886031719,41,381,58,3.543859649122807
537,4,1,-3,886031719,886031720,1,58,206,3.0
537,1,4,3,886031720,886031751,31,206,956,3.5714285714285716
537,4,2,-2,886031751,886031752,1,956,82,3.6741573033707864
537,2,4,2,886031752,886031830,78,82,213,3.943396226415094
537,4,3,-1,886031830,886031831,1,213,782,2.8
537,3,3,0,886031831,886031859,28,782,703,3.75
537,3,3,0,886031859,886031886,27,703,724,3.64
537,3,3,0,886031886,886031912,26,724,732,3.6266666666666665
537,3,3,0,886031912,886031913,1,732,942,3.4545454545454546
537,3,2,-1,886031913,886031965,52,942,549,3.4871794871794872
537,2,1,-1,886031965,886031966,1,549,72,3.175438596491228
537,1,2,1,886031966,886032098,132,72,723,3.5384615384615383
537,2,1,-1,886032098,886032123,25,723,102,3.3684210526315788
537,1,3,2,886032123,886032154,31,102,1045,3.2
537,3,2,-1,886032154,886032183,29,1045,569,2.4285714285714284
537,2,3,1,886032183,886032184,1,569,970,3.0
537,3,2,-1,886032184,886032204,20,970,1404,3.875
537,2,3,1,886032204,886032246,42,1404,231,2.938775510204082
534,3,4,1,877807602,877807653,51,286,619,3.4782608695652173
534,4,1,-3,877807653,877807692,39,619,93,3.5641025641025643
534,1,4,3,877807692,877807718,26,93,129,3.744186046511628
534,4,5,1,877807718,877807747,29,129,628,3.573529411764706
534,5,4,-1,877807747,877807780,33,628,926,2.7857142857142856
534,4,4,0,877807780,877807815,35,926,985,2.9
534,4,5,1,877807815,877807816,1,985,455,3.1702127659574466
534,5,5,0,877807816,877807845,29,455,591,3.7169811320754715
534,5,3,-2,877807845,877807873,28,591,150,3.803921568627451
534,3,4,1,877807873,877807905,32,150,21,2.9210526315789473
534,4,4,0,877807905,877807935,30,21,118,3.2764227642276422
534,4,4,0,877807935,877807973,38,118,235,3.106382978723404
534,4,4,0,877807973,877808002,29,235,930,2.793103448275862
534,4,4,0,877808002,877808053,51,930,109,3.282608695652174
534,4,3,-1,877808053,877808120,67,109,1034,2.6
534,3,5,2,877808120,877808174,54,1034,282,3.610526315789474
534,5,5,0,877808174,877808175,1,282,597,3.2771084337349397
534,5,5,0,877808175,877808198,23,597,717,2.9696969696969697
534,5,2,-3,877808198,877808237,39,717,149,2.4
534,2,4,2,877808237,877808260,23,149,370,2.8125
534,4,4,0,877808260,877808281,21,370,825,2.914285714285714
534,4,3,-1,877808281,877808340,59,825,820,3.0444444444444443
534,3,4,1,877808340,877808361,21,820,763,3.347826086956522
541,5,4,-1,883864160,883864207,47,678,304,3.5306122448979593
541,4,4,0,883864207,883864638,431,304,427,4.2025316455696204
541,4,4,0,883864638,883864782,144,427,655,3.7857142857142856
541,4,4,0,883864782,883864928,146,655,196,3.9404761904761907
541,4,3,-1,883864928,883864946,18,196,402,3.3076923076923075
541,3,4,1,883864946,883864985,39,402,699,3.736842105263158
541,4,4,0,883864985,883865007,22,699,468,3.380952380952381
541,4,5,1,883865007,883865039,32,468,660,3.71875
541,5,3,-2,883865039,883865063,24,660,676,3.3142857142857145
541,3,3,0,883865063,883865110,47,676,403,3.298507462686567
541,3,5,2,883865110,883865133,23,403,924,3.3703703703703702
541,5,3,-2,883865133,883865173,40,924,732,3.6266666666666665
541,3,4,1,883865173,883865211,38,732,239,3.423076923076923
541,4,4,0,883865211,883865289,78,239,553,3.5
541,4,3,-1,883865289,883865317,28,553,1053,3.3846153846153846
541,3,4,1,883865317,883865394,77,1053,941,3.5
541,4,5,1,883865394,883865534,140,941,173,4.1441441441441444
541,5,4,-1,883865534,883865555,21,173,168,4.0476190476190474
541,4,5,1,883865555,883865575,20,168,210,3.921259842519685
541,5,4,-1,883865575,883865654,79,210,477,3.1666666666666665
541,4,3,-1,883865654,883865693,39,477,393,3.5125
541,3,3,0,883865693,883865738,45,393,88,3.433734939759036
541,3,4,1,883865738,883865929,191,88,66,3.4705882352941178
541,4,5,1,883865929,883866007,78,66,476,3.1216216216216215
541,5,2,-3,883866007,883866028,21,476,1185,2.111111111111111
541,2,1,-1,883866028,883866049,21,1185,235,3.106382978723404
541,1,3,2,883866049,883866068,19,235,763,3.347826086956522
541,3,5,2,883866068,883866093,25,763,781,3.4166666666666665
541,5,2,-3,883866093,883866114,21,781,585,2.5384615384615383
541,2,2,0,883866114,883866173,59,585,1047,2.6923076923076925
541,2,3,1,883866173,883866210,37,1047,376,2.9166666666666665
541,3,2,-1,883866210,883866300,90,376,395,2.5714285714285716
541,2,4,2,883866300,883871644,5344,395,62,3.048780487804878
541,4,4,0,883871644,883871670,26,62,118,3.2764227642276422
541,4,3,-1,883871670,883871755,85,118,826,2.5555555555555554
541,3,3,0,883871755,883874518,2763,826,452,2.6129032258064515
541,3,5,2,883874518,883874645,127,452,8,3.903225806451613
541,5,5,0,883874645,883874646,1,8,418,3.825
541,5,5,0,883874646,883874682,36,418,419,3.8208955223880596
541,5,5,0,883874682,883874683,1,419,91,3.6
541,5,4,-1,883874683,883874716,33,91,465,3.75
541,4,3,-1,883874716,883874717,1,465,151,3.6544117647058822
541,3,3,0,883874717,883874749,32,151,1035,3.03125
541,3,3,0,883874749,883874778,29,1035,623,3.0454545454545454
541,3,1,-2,883874778,883874834,56,623,1412,1.5
541,1,3,2,883874834,883874872,38,1412,812,3.375
541,3,3,0,883874872,883875370,498,812,931,2.2758620689655173
541,3,4,1,883875370,883875432,62,931,543,4.166666666666667
541,4,4,0,883875432,884046295,170863,543,993,3.4838709677419355
541,4,5,1,884046295,884046320,25,993,257,3.7154471544715446
541,5,3,-2,884046320,884046321,1,257,255,3.2027027027027026
541,3,5,2,884046321,884046910,589,255,50,4.306532663316583
541,5,3,-2,884046910,884046953,43,50,254,2.7419354838709675
541,3,3,0,884046953,884047204,251,254,139,2.7222222222222223
541,3,4,1,884047204,884645883,598679,139,843,2.933333333333333
541,4,5,1,884645883,885595735,949852,843,709,4.171428571428572
541,5,4,-1,885595735,885595771,36,709,215,3.662921348314607
541,4,4,0,885595771,885595846,75,215,225,3.0714285714285716
541,4,3,-1,885595846,885595972,126,225,1030,2.3636363636363638
538,5,4,-1,877106665,877106976,311,191,153,3.7865168539325844
538,4,5,1,877106976,877107012,36,153,98,4.240875912408759
538,5,4,-1,877107012,877107050,38,98,79,3.956989247311828
538,4,3,-1,877107050,877107085,35,79,208,3.8125
538,3,5,2,877107085,877107086,1,208,97,3.7282608695652173
538,5,5,0,877107086,877107231,145,97,127,4.162790697674419
538,5,5,0,877107231,877107340,109,127,69,3.8015873015873014
538,5,5,0,877107340,877107491,151,69,496,4.094594594594595
538,5,3,-2,877107491,877107492,1,496,117,3.689189189189189
538,3,5,2,877107492,877107536,44,117,215,3.662921348314607
538,5,4,-1,877107536,877107558,22,215,144,3.9545454545454546
538,4,3,-1,877107558,877107633,75,144,642,3.4285714285714284
538,3,5,2,877107633,877107656,23,642,50,4.306532663316583
538,5,3,-2,877107656,877107700,44,50,181,3.98974358974359
538,3,3,0,877107700,877107726,26,181,4,3.5538461538461537
538,3,4,1,877107726,877107765,39,4,172,4.225225225225225
538,4,5,1,877107765,877107840,75,172,187,4.215189873417722
538,5,3,-2,877107840,877107879,39,187,273,3.5238095238095237
538,3,3,0,877107879,877107914,35,273,956,3.5714285714285716
538,3,1,-2,877107914,877108077,163,956,42,3.893617021276596
538,1,4,3,877108077,877108195,118,42,188,3.625
538,4,4,0,877108195,877108250,55,188,202,3.730337078651685
538,4,3,-1,877108250,877108345,95,202,655,3.7857142857142856
538,3,3,0,877108345,877108785,440,655,735,3.58
538,3,3,0,877108785,877109564,779,735,405,3.25
538,3,4,1,877109564,877109669,105,405,96,3.9130434782608696
538,4,4,0,877109669,877109688,19,96,58,3.543859649122807
538,4,4,0,877109688,877109748,60,58,100,4.0162162162162165
538,4,3,-1,877109748,877109773,25,100,712,3.0434782608695654
538,3,4,1,877109773,877109831,58,712,89,3.9615384615384617
538,4,5,1,877109831,877109932,101,89,483,4.475609756097561
538,5,4,-1,877109932,877109986,54,483,237,3.7315436241610738
538,4,3,-1,877109986,877110209,223,237,121,3.521212121212121
538,3,3,0,877110209,877363863,253654,121,162,3.4651162790697674
538,3,3,0,877363863,877363950,87,162,204,3.6744186046511627
538,3,3,0,877363950,877364003,53,204,143,3.56
538,3,5,2,877364003,877364067,64,143,199,4.191489361702128
538,5,4,-1,877364067,877364204,137,199,216,3.8454545454545452
542,2,3,1,886532149,886532176,27,288,347,3.59375
542,3,4,1,886532176,886532209,33,347,50,4.306532663316583
542,4,4,0,886532209,886532238,29,50,265,3.710144927536232
542,4,4,0,886532238,886532265,27,265,479,4.25
542,4,5,1,886532265,886532294,29,479,427,4.2025316455696204
542,5,3,-2,886532294,886532314,20,427,202,3.730337078651685
542,3,5,2,886532314,886532338,24,202,191,4.168674698795181
542,5,4,-1,886532338,886532359,21,191,181,3.98974358974359
542,4,2,-2,886532359,886532381,22,181,121,3.521212121212121
542,2,4,2,886532381,886532416,35,121,109,3.282608695652174
542,4,3,-1,886532416,886532466,50,109,273,3.5238095238095237
542,3,4,1,886532466,886532534,68,273,496,4.094594594594595
542,4,4,0,886532534,886532552,18,496,69,3.8015873015873014
542,4,2,-2,886532552,886532602,50,69,206,3.0
542,2,4,2,886532602,886532676,74,206,423,3.7016129032258065
542,4,5,1,886532676,886532706,30,423,56,4.051724137931035
542,5,3,-2,886532706,886532726,20,56,382,3.764705882352941
542,3,3,0,886532726,886532727,1,382,88,3.433734939759036
542,3,2,-1,886532727,886532788,61,88,695,3.0
542,2,4,2,886532788,886532818,30,695,1098,3.533333333333333
542,4,3,-1,886532818,886532838,20,1098,433,3.8035714285714284
542,3,5,2,886532838,886532855,17,433,47,3.5869565217391304
542,5,4,-1,886532855,886532881,26,47,208,3.8125
542,4,4,0,886532881,886532908,27,208,655,3.7857142857142856
542,4,3,-1,886532908,886532909,1,655,789,3.7777777777777777
542,3,3,0,886532909,886532950,41,789,319,3.0408163265306123
542,3,4,1,886532950,886532971,21,319,410,3.0434782608695654
542,4,3,-1,886532971,886533003,32,410,780,3.08
542,3,3,0,886533003,886533021,18,780,94,2.8823529411764706
542,3,4,1,886533021,886533068,47,94,41,3.0625
542,4,3,-1,886533068,886533090,22,41,63,3.125
542,3,4,1,886533090,886533112,22,63,396,2.84
542,4,2,-2,886533112,886533172,60,396,399,3.317073170731707
542,2,4,2,886533172,886533193,21,399,952,3.3529411764705883
542,4,3,-1,886533193,886533227,34,952,384,2.7941176470588234
542,3,3,0,886533227,886533228,1,384,235,3.106382978723404
542,3,2,-1,886533228,886533275,47,235,1061,2.9166666666666665
542,2,3,1,886533275,886533303,28,1061,734,3.0
542,3,5,2,886533303,886533421,118,734,192,4.090909090909091
542,5,3,-2,886533421,886533452,31,192,214,3.272727272727273
542,3,4,1,886533452,886533562,110,214,588,3.8358208955223883
542,4,5,1,886533562,886533587,25,588,99,3.8392857142857144
542,5,3,-2,886533587,886533588,1,99,625,3.25
542,3,3,0,886533588,886533604,16,625,627,3.3823529411764706
542,3,4,1,886533604,886533694,90,627,772,3.3333333333333335
542,4,2,-2,886533694,886533710,16,772,11,3.8904109589041096
545,4,3,-1,879898362,879898447,85,689,326,3.262295081967213
545,3,2,-1,879898447,879898486,39,326,680,2.8333333333333335
545,2,3,1,879898486,879898617,131,680,258,3.7547169811320753
545,3,5,2,879898617,879898644,27,258,50,4.306532663316583
545,5,5,0,879898644,879898678,34,50,257,3.7154471544715446
545,5,2,-3,879898678,879898802,124,257,993,3.4838709677419355
545,2,4,2,879898802,879898995,193,993,254,2.7419354838709675
545,4,3,-1,879898995,879899125,130,254,89,3.9615384615384617
545,3,3,0,879899125,879899158,33,89,22,4.215909090909091
545,3,2,-1,879899158,879899233,75,22,188,3.625
545,2,4,2,879899233,879899266,33,188,68,3.5714285714285716
545,4,5,1,879899266,879899327,61,68,230,3.3518518518518516
545,5,5,0,879899327,879899380,53,230,403,3.298507462686567
545,5,4,-1,879899380,879899438,58,403,566,3.543859649122807
545,4,4,0,879899438,879899472,34,566,231,2.938775510204082
545,4,2,-2,879899472,879899497,25,231,449,2.9069767441860463
545,2,4,2,879899497,879899523,26,449,810,2.9473684210526314
545,4,4,0,879899523,879899548,25,810,541,2.9473684210526314
545,4,4,0,879899548,879899641,93,541,204,3.6744186046511627
545,4,3,-1,879899641,879899677,36,204,194,4.029411764705882
545,3,3,0,879899677,879899719,42,194,648,3.9545454545454546
545,3,5,2,879899719,879899861,142,648,98,4.240875912408759
545,5,3,-2,879899861,879899905,44,98,234,3.7674418604651163
545,3,5,2,879899905,879899934,29,234,217,3.1538461538461537
545,5,4,-1,879899934,879899977,43,217,413,2.5652173913043477
545,4,3,-1,879899977,879899978,1,413,447,3.46875
545,3,4,1,879899978,879900010,32,447,379,3.35
545,4,4,0,879900010,879900121,111,379,73,3.588235294117647
545,4,4,0,879900121,879900156,35,73,168,4.0476190476190474
545,4,3,-1,879900156,879900227,71,168,710,3.41025641025641
545,3,4,1,879900227,879900321,94,710,746,3.7560975609756095
545,4,3,-1,879900321,879900366,45,746,451,3.207792207792208
545,3,4,1,879900366,879900388,22,451,202,3.730337078651685
545,4,3,-1,879900388,879900586,198,202,211,3.958904109589041
545,3,3,0,879900586,879900654,68,211,692,3.56
545,3,4,1,879900654,879900731,77,692,1028,2.857142857142857
545,4,3,-1,879900731,879900794,63,1028,94,2.8823529411764706
545,3,3,0,879900794,879900863,69,94,384,2.7941176470588234
545,3,4,1,879900863,879900891,28,384,393,3.5125
545,4,4,0,879900891,879901092,201,393,395,2.5714285714285716
545,4,3,-1,879901092,879901281,189,395,546,2.9789473684210526
545,3,3,0,879901281,879901322,41,546,743,1.9545454545454546
545,3,3,0,879901322,879901359,37,743,820,3.0444444444444443
545,3,4,1,879901359,879901458,99,820,95,3.8194444444444446
545,4,3,-1,879901458,879901504,46,95,627,3.3823529411764706
545,3,4,1,879901504,879901538,34,627,101,3.4827586206896552
545,4,4,0,879901538,879901920,382,101,549,3.4871794871794872
545,4,3,-1,879901920,879901941,21,549,88,3.433734939759036
545,3,3,0,879901941,879902060,119,88,155,3.0588235294117645
545,3,4,1,879902060,880347770,445710,155,199,4.191489361702128
545,4,4,0,880347770,880347813,43,199,742,3.5555555555555554
545,4,4,0,880347813,880347831,18,742,203,3.826923076923077
545,4,3,-1,880347831,880347957,126,203,510,3.823529411764706
545,3,3,0,880347957,880347984,27,510,29,2.5714285714285716
545,3,4,1,880347984,880348074,90,29,151,3.6544117647058822
545,4,3,-1,880348074,883115515,2767441,151,232,3.0789473684210527
545,3,2,-1,883115515,883115552,37,232,391,2.4285714285714284
545,2,3,1,883115552,883115664,112,391,720,3.2
545,3,2,-1,883115664,883115718,54,720,450,2.2758620689655173
545,2,4,2,883115718,884133839,1018121,450,404,3.6578947368421053
545,4,3,-1,884133839,884133881,42,404,215,3.662921348314607
545,3,4,1,884133881,884133906,25,215,69,3.8015873015873014
545,4,3,-1,884133906,884133963,57,69,633,3.9
545,3,4,1,884133963,884133988,25,633,31,3.642857142857143
545,4,3,-1,884133988,884134035,47,31,491,3.55
545,3,4,1,884134035,884134060,25,491,135,3.7974683544303796
545,4,3,-1,884134060,884134114,54,135,729,3.3793103448275863
545,3,3,0,884134114,884134177,63,729,434,3.588235294117647
545,3,3,0,884134177,884134205,28,434,474,4.172413793103448
545,3,4,1,884134205,884134276,71,474,205,3.717391304347826
545,4,5,1,884134276,884134395,119,205,968,3.75
545,5,4,-1,884134395,884134519,124,968,132,3.929411764705882
545,4,3,-1,884134519,884134628,109,132,380,3.4878048780487805
545,3,3,0,884134628,884134704,76,380,77,3.3857142857142857
545,3,4,1,884134704,884134780,76,77,739,3.391304347826087
545,4,4,0,884134780,884134936,156,739,578,3.066666666666667
545,4,3,-1,884134936,884134959,23,578,139,2.7222222222222223
539,4,5,1,879787771,879787825,54,286,382,3.764705882352941
539,5,4,-1,879787825,879787917,92,382,357,4.063291139240507
539,4,3,-1,879787917,879787985,68,357,496,4.094594594594595
539,3,5,2,879787985,879788007,22,496,19,3.9615384615384617
539,5,2,-3,879788007,879788046,39,19,56,4.051724137931035
539,2,5,3,879788046,879788101,55,56,483,4.475609756097561
539,5,4,-1,879788101,879788136,35,483,133,3.7777777777777777
539,4,4,0,879788136,879788159,23,133,131,3.731707317073171
539,4,3,-1,879788159,879788195,36,131,58,3.543859649122807
539,3,5,2,879788195,879788224,29,58,59,4.0
539,5,3,-2,879788224,879788345,121,59,236,3.2666666666666666
539,3,5,2,879788345,879788346,1,236,660,3.71875
539,5,3,-2,879788346,879788371,25,660,1211,3.5714285714285716
539,3,5,2,879788371,879788405,34,1211,956,3.5714285714285716
539,5,4,-1,879788405,879788533,128,956,963,3.9285714285714284
539,4,4,0,879788533,879788572,39,963,163,3.53125
539,4,4,0,879788572,879788623,51,163,215,3.662921348314607
547,5,4,-1,891282575,891282596,21,302,258,3.7547169811320753
547,4,4,0,891282596,891282597,1,258,751,3.3896103896103895
547,4,5,1,891282597,891282611,14,751,313,4.323076923076923
547,5,4,-1,891282611,891282640,29,313,354,3.6923076923076925
547,4,3,-1,891282640,891282680,40,354,301,3.2465753424657535
547,3,3,0,891282680,891282715,35,301,303,3.75
547,3,4,1,891282715,891282732,17,303,321,3.0172413793103448
547,4,4,0,891282732,891282757,25,321,340,3.7419354838709675
547,4,3,-1,891282757,891282775,18,340,289,2.988888888888889
547,3,5,2,891282775,891282797,22,289,316,4.285714285714286
547,5,4,-1,891282797,891282824,27,316,312,3.0
547,4,4,0,891282824,891282926,102,312,319,3.0408163265306123
547,4,2,-2,891282926,891282967,41,319,338,2.75
543,3,4,1,874861699,874861792,93,742,508,3.6923076923076925
543,4,4,0,874861792,874862966,1174,508,694,4.277777777777778
543,4,4,0,874862966,874862967,1,694,432,3.719298245614035
543,4,3,-1,874862967,874863035,68,432,423,3.7016129032258065
543,3,4,1,874863035,874863155,120,423,70,3.5833333333333335
543,4,3,-1,874863155,874863269,114,70,1073,3.6315789473684212
543,3,4,1,874863269,874863336,67,1073,64,4.373737373737374
543,4,3,-1,874863336,874863549,213,64,157,3.5714285714285716
543,3,3,0,874863549,874863550,1,157,582,3.7457627118644066
543,3,3,0,874863550,874863734,184,582,509,3.7058823529411766
543,3,3,0,874863734,874863803,69,509,160,3.4
543,3,4,1,874863803,874863878,75,160,1099,3.7142857142857144
543,4,3,-1,874863878,874864034,156,1099,463,3.6818181818181817
543,3,4,1,874864034,874864094,60,463,466,3.5
543,4,3,-1,874864094,874864182,88,466,647,4.142857142857143
543,3,4,1,874864182,874864183,1,647,23,3.9047619047619047
543,4,4,0,874864183,874864346,163,23,114,4.3478260869565215
543,4,4,0,874864346,874864347,1,114,531,3.7435897435897436
543,4,3,-1,874864347,874864421,74,531,214,3.272727272727273
543,3,3,0,874864421,874864736,315,214,518,3.5833333333333335
543,3,4,1,874864736,874864737,1,518,684,3.847826086956522
543,4,3,-1,874864737,874864870,133,684,194,4.029411764705882
543,3,3,0,874864870,874865728,858,194,95,3.8194444444444446
543,3,2,-1,874865728,874865923,195,95,700,2.7142857142857144
543,2,3,1,874865923,874866116,193,700,11,3.8904109589041096
543,3,4,1,874866116,874866208,92,11,180,3.9473684210526314
543,4,4,0,874866208,875659174,792966,180,1194,4.181818181818182
543,4,4,0,875659174,875659175,1,1194,212,3.230769230769231
543,4,4,0,875659175,875659256,81,212,59,4.0
543,4,4,0,875659256,875663056,3800,59,199,4.191489361702128
543,4,3,-1,875663056,875663170,114,199,168,4.0476190476190474
543,3,4,1,875663170,875663267,97,168,169,4.548387096774194
543,4,4,0,875663267,875663372,105,169,226,3.378787878787879
543,4,3,-1,875663372,875663687,315,226,62,3.048780487804878
543,3,2,-1,875663687,876105554,441867,62,761,3.0588235294117645
543,2,4,2,876105554,877545356,1439802,761,265,3.710144927536232
543,4,4,0,877545356,877545716,360,265,233,3.323529411764706
543,4,3,-1,877545716,877545717,1,233,385,3.6129032258064515
543,3,3,0,877545717,877546306,589,385,2,3.0851063829787235
543,3,2,-1,877546306,877547005,699,2,550,3.272727272727273
543,2,3,1,877547005,877547190,185,550,53,2.9523809523809526
543,3,2,-1,877547190,877547580,390,53,85,3.3157894736842106
543,2,3,1,877547580,877547672,92,85,47,3.5869565217391304
543,3,3,0,877547672,877547863,191,47,732,3.6266666666666665
543,3,3,0,877547863,877550534,2671,732,715,3.257142857142857
543,3,4,1,877550534,877550535,1,715,792,3.793103448275862
543,4,2,-2,877550535,877550660,125,792,239,3.423076923076923
543,2,3,1,877550660,877550790,130,239,796,2.923076923076923
543,3,3,0,877550790,877550791,1,796,94,2.8823529411764706
543,3,4,1,877550791,887912238,10361447,94,302,4.133333333333334
543,4,2,-2,887912238,888209667,297429,302,249,3.3275862068965516
543,2,3,1,888209667,888209697,30,249,15,3.725663716814159
548,4,4,0,891042353,891042474,121,750,307,3.6031746031746033
548,4,3,-1,891042474,891042475,1,307,690,3.260869565217391
548,3,4,1,891042475,891042530,55,690,292,3.6666666666666665
548,4,4,0,891042530,891042624,94,292,346,3.5128205128205128
548,4,3,-1,891042624,891042794,170,346,288,3.5214285714285714
548,3,4,1,891042794,891042851,57,288,751,3.3896103896103895
548,4,4,0,891042851,891042954,103,751,328,3.4895833333333335
548,4,1,-3,891042954,891043008,54,328,9,3.8878504672897196
548,1,4,3,891043008,891043278,270,9,1025,2.95
548,4,4,0,891043278,891043509,231,1025,322,3.0476190476190474
548,4,4,0,891043509,891043547,38,322,323,3.0
548,4,4,0,891043547,891043852,305,323,255,3.2027027027027026
548,4,4,0,891043852,891043882,30,255,298,3.779220779220779
548,4,3,-1,891043882,891043910,28,298,1013,2.388888888888889
548,3,4,1,891043910,891043932,22,1013,1014,3.1
548,4,4,0,891043932,891043953,21,1014,1244,2.7777777777777777
548,4,3,-1,891043953,891043977,24,1244,252,2.911392405063291
548,3,1,-2,891043977,891043999,22,252,254,2.7419354838709675
548,1,2,1,891043999,891044049,50,254,1089,2.1363636363636362
548,2,4,2,891044049,891044139,90,1089,316,4.285714285714286
548,4,4,0,891044139,891044198,59,316,905,3.357142857142857
548,4,5,1,891044198,891044304,106,905,7,3.76056338028169
548,5,4,-1,891044304,891044355,51,7,176,3.967032967032967
548,4,5,1,891044355,891044356,1,176,56,4.051724137931035
548,5,5,0,891044356,891044410,54,56,183,3.951219512195122
548,5,5,0,891044410,891044411,1,183,657,4.341463414634147
548,5,5,0,891044411,891044446,35,657,466,3.5
548,5,5,0,891044446,891044481,35,466,39,3.107142857142857
548,5,5,0,891044481,891044482,1,39,55,4.051282051282051
548,5,4,-1,891044482,891044538,56,55,636,3.4146341463414633
548,4,5,1,891044538,891044596,58,636,222,3.578125
548,5,3,-2,891044596,891415258,370662,222,315,4.15
548,3,4,1,891415258,891415384,126,315,117,3.689189189189189
548,4,3,-1,891415384,891415465,81,117,591,3.7169811320754715
548,3,3,0,891415465,891415512,47,591,276,3.6036036036036037
548,3,3,0,891415512,891415572,60,276,283,3.901639344262295
548,3,4,1,891415572,891415643,71,283,950,2.625
548,4,4,0,891415643,891415677,34,950,1051,3.625
548,4,4,0,891415677,891415709,32,1051,762,3.3962264150943398
548,4,3,-1,891415709,891415746,37,762,235,3.106382978723404
548,3,1,-2,891415746,891415786,40,235,477,3.1666666666666665
548,1,4,3,891415786,891415815,29,477,546,2.9789473684210526
548,4,2,-2,891415815,891415854,39,546,15,3.725663716814159
548,2,5,3,891415854,891415855,1,15,118,3.2764227642276422
548,5,4,-1,891415855,891415890,35,118,597,3.2771084337349397
548,4,4,0,891415890,891415912,22,597,696,3.138888888888889
548,4,5,1,891415912,891415939,27,696,121,3.521212121212121
548,5,4,-1,891415939,891416011,72,121,1047,2.6923076923076925
548,4,4,0,891416011,891416050,39,1047,717,2.9696969696969697
548,4,2,-2,891416050,891416122,72,717,978,2.357142857142857
546,3,5,2,885139608,885139634,26,895,346,3.5128205128205128
546,5,2,-3,885139634,885139693,59,346,690,3.260869565217391
546,2,1,-1,885139693,885139779,86,690,294,3.1052631578947367
546,1,3,2,885139779,885139871,92,294,751,3.3896103896103895
546,3,4,1,885139871,885139921,50,751,322,3.0476190476190474
546,4,3,-1,885139921,885140097,176,322,682,3.0476190476190474
546,3,3,0,885140097,885140117,20,682,343,3.0
546,3,3,0,885140117,885140706,589,343,100,4.0162162162162165
546,3,5,2,885140706,885140754,48,100,181,3.98974358974359
546,5,4,-1,885140754,885140808,54,181,758,2.2857142857142856
546,4,5,1,885140808,885140909,101,758,121,3.521212121212121
546,5,4,-1,885140909,885141132,223,121,928,3.142857142857143
546,4,5,1,885141132,885141162,30,928,717,2.9696969696969697
546,5,4,-1,885141162,885141360,198,717,185,3.9726027397260273
546,4,4,0,885141360,885141411,51,185,17,3.032258064516129
546,4,3,-1,885141411,885141438,27,17,672,2.7222222222222223
546,3,4,1,885141438,885141465,27,672,379,3.35
546,4,4,0,885141465,885141502,37,379,145,2.3636363636363638
546,4,4,0,885141502,885141538,36,145,590,1.8888888888888888
522,5,4,-1,876960956,876961020,64,168,205,3.717391304347826
522,4,5,1,876961020,876961133,113,205,523,4.159090909090909
522,5,4,-1,876961133,876961190,57,523,492,4.117647058823529
522,4,5,1,876961190,876961248,58,492,23,3.9047619047619047
551,4,4,0,892775466,892775516,50,288,307,3.6031746031746033
551,4,4,0,892775516,892775584,68,307,340,3.7419354838709675
551,4,4,0,892775584,892775612,28,340,326,3.262295081967213
551,4,4,0,892775612,892775687,75,326,300,3.6861313868613137
551,4,3,-1,892775687,892775723,36,300,912,3.0
551,3,4,1,892775723,892775797,74,912,751,3.3896103896103895
551,4,4,0,892775797,892775869,72,751,343,3.0
551,4,3,-1,892775869,892775894,25,343,351,2.4444444444444446
551,3,4,1,892775894,892776419,525,351,12,4.358974358974359
551,4,5,1,892776419,892776420,1,12,127,4.162790697674419
551,5,5,0,892776420,892776450,30,127,187,4.215189873417722
551,5,4,-1,892776450,892776486,36,187,100,4.0162162162162165
551,4,5,1,892776486,892776575,89,100,205,3.717391304347826
551,5,4,-1,892776575,892776750,175,205,651,3.8627450980392157
551,4,5,1,892776750,892776824,74,651,318,4.5046728971962615
551,5,4,-1,892776824,892776876,52,318,176,3.967032967032967
551,4,4,0,892776876,892776982,106,176,28,3.923076923076923
551,4,5,1,892776982,892777052,70,28,180,3.9473684210526314
551,5,5,0,892777052,892777092,40,180,282,3.610526315789474
551,5,5,0,892777092,892777123,31,282,527,3.823529411764706
551,5,4,-1,892777123,892777274,151,527,509,3.7058823529411766
551,4,3,-1,892777274,892777310,36,509,153,3.7865168539325844
551,3,4,1,892777310,892777339,29,153,520,4.136363636363637
551,4,5,1,892777339,892777397,58,520,505,4.0625
551,5,5,0,892777397,892777485,88,505,531,3.7435897435897436
551,5,5,0,892777485,892777583,98,531,132,3.929411764705882
551,5,5,0,892777583,892777609,26,132,216,3.8454545454545452
551,5,4,-1,892777609,892777673,64,216,204,3.6744186046511627
551,4,5,1,892777673,892777723,50,204,168,4.0476190476190474
551,5,5,0,892777723,892777753,30,168,55,4.051282051282051
551,5,4,-1,892777753,892777787,34,55,210,3.921259842519685
551,4,1,-3,892777787,892777855,68,210,184,3.393939393939394
551,1,5,4,892777855,892777885,30,184,185,3.9726027397260273
551,5,5,0,892777885,892777910,25,185,475,3.956043956043956
551,5,5,0,892777910,892777943,33,475,693,3.6285714285714286
551,5,5,0,892777943,892777987,44,693,96,3.9130434782608696
551,5,3,-2,892777987,892778074,87,96,461,3.3333333333333335
551,3,5,2,892778074,892778129,55,461,135,3.7974683544303796
551,5,4,-1,892778129,892778164,35,135,673,3.393939393939394
551,4,4,0,892778164,892778202,38,673,76,3.1875
551,4,2,-2,892778202,892778244,42,76,1035,3.03125
551,2,4,2,892778244,892778297,53,1035,1169,4.0
551,4,4,0,892778297,892778336,39,1169,34,3.2
551,4,3,-1,892778336,892778337,1,34,280,3.103448275862069
551,3,3,0,892778337,892778369,32,280,583,3.4285714285714284
551,3,3,0,892778369,892782807,4438,583,150,3.803921568627451
551,3,5,2,892782807,892782838,31,150,742,3.5555555555555554
551,5,4,-1,892782838,892782865,27,742,273,3.5238095238095237
551,4,1,-3,892782865,892782901,36,273,685,3.2666666666666666
551,1,4,3,892782901,892782936,35,685,200,3.8157894736842106
551,4,1,-3,892782936,892783025,89,200,91,3.6
551,1,4,3,892783025,892783110,85,91,284,3.1547619047619047
551,4,5,1,892783110,892783142,32,284,655,3.7857142857142856
551,5,5,0,892783142,892783212,70,655,684,3.847826086956522
551,5,5,0,892783212,892783242,30,684,162,3.4651162790697674
551,5,4,-1,892783242,892783281,39,162,71,3.6575342465753424
551,4,5,1,892783281,892783314,33,71,774,3.0
551,5,5,0,892783314,892783365,51,774,232,3.0789473684210527
551,5,1,-4,892783365,892783366,1,232,25,3.3185840707964602
551,1,5,4,892783366,892783411,45,25,121,3.521212121212121
551,5,5,0,892783411,892783451,40,121,924,3.3703703703703702
551,5,3,-2,892783451,892783488,37,924,380,3.4878048780487805
551,3,4,1,892783488,892783525,37,380,147,3.3142857142857145
551,4,5,1,892783525,892783559,34,147,727,3.5517241379310347
551,5,5,0,892783559,892783612,53,727,591,3.7169811320754715
551,5,5,0,892783612,892783672,60,591,188,3.625
551,5,2,-3,892783672,892783711,39,188,4,3.5538461538461537
551,2,5,3,892783711,892783749,38,4,582,3.7457627118644066
551,5,3,-2,892783749,892783791,42,582,808,2.4444444444444446
551,3,1,-2,892783791,892783830,39,808,708,3.3157894736842106
551,1,2,1,892783830,892783861,31,708,950,2.625
551,2,3,1,892783861,892783906,45,950,627,3.3823529411764706
551,3,3,0,892783906,892783942,36,627,846,3.1052631578947367
551,3,5,2,892783942,892783972,30,846,581,3.130434782608696
551,5,5,0,892783972,892784049,77,581,1136,3.3076923076923075
551,5,5,0,892784049,892784130,81,1136,550,3.272727272727273
551,5,3,-2,892784130,892784166,36,550,833,2.9444444444444446
551,3,5,2,892784166,892784199,33,833,1118,3.533333333333333
551,5,3,-2,892784199,892784259,60,1118,552,2.8095238095238093
551,3,5,2,892784259,892784320,61,552,281,3.2
551,5,4,-1,892784320,892784479,159,281,979,3.1
551,4,1,-3,892784479,892784524,45,979,1376,2.0
551,1,1,0,892784524,892784553,29,1376,38,2.784313725490196
551,1,3,2,892784553,892784592,39,38,760,2.35
551,3,4,1,892784592,892784593,1,760,1051,3.625
551,4,5,1,892784593,892784672,79,1051,578,3.066666666666667
551,5,2,-3,892784672,892784744,72,578,595,2.9166666666666665
551,2,5,3,892784744,892784779,35,595,229,3.185185185185185
551,5,5,0,892784779,892784780,1,229,51,3.5277777777777777
551,5,5,0,892784780,892784942,162,51,1443,4.5
551,5,2,-3,892784942,892784976,34,1443,43,3.1
551,2,1,-1,892784976,892785020,44,43,84,3.0
551,1,1,0,892785020,892785056,36,84,40,2.7037037037037037
551,1,2,1,892785056,892785091,35,40,1067,3.533333333333333
551,2,3,1,892785091,892785128,37,1067,1059,2.764705882352941
551,3,5,2,892785128,892785164,36,1059,67,3.106382978723404
551,5,1,-4,892785164,892785194,30,67,1621,1.0
551,1,1,0,892785194,892785223,29,1621,384,2.7941176470588234
551,1,4,3,892785223,892785263,40,384,1139,2.611111111111111
551,4,4,0,892785263,892785264,1,1139,570,3.526315789473684
551,4,1,-3,892785264,892785300,36,570,1207,2.125
551,1,5,4,892785300,892785331,31,1207,1135,3.0526315789473686
551,5,1,-4,892785331,892785332,1,1135,1419,1.7142857142857142
551,1,5,4,892785332,892785363,31,1419,561,3.1515151515151514
551,5,3,-2,892785363,892785364,1,561,399,3.317073170731707
551,3,4,1,892785364,892785399,35,399,779,2.2
551,4,1,-3,892785399,892785431,32,779,1079,2.1923076923076925
544,2,3,1,884795264,884795437,173,310,332,3.6511627906976742
544,3,4,1,884795437,884795470,33,332,292,3.6666666666666665
544,4,3,-1,884795470,884795516,46,292,331,3.5517241379310347
544,3,3,0,884795516,884795542,26,331,1280,2.3333333333333335
544,3,2,-1,884795542,884795580,38,1280,301,3.2465753424657535
544,2,3,1,884795580,884795581,1,301,328,3.4895833333333335
544,3,4,1,884795581,884795612,31,328,300,3.6861313868613137
544,4,2,-2,884795612,884795706,94,300,689,3.1538461538461537
544,2,2,0,884795706,884796016,310,689,323,3.0
544,2,2,0,884796016,884796086,70,323,312,3.0
553,5,5,0,879948386,879948423,37,611,483,4.475609756097561
553,5,4,-1,879948423,879948508,85,483,1126,3.625
553,4,5,1,879948508,879948552,44,1126,480,4.283018867924528
553,5,4,-1,879948552,879948610,58,480,132,3.929411764705882
553,4,3,-1,879948610,879948655,45,132,378,3.6904761904761907
553,3,4,1,879948655,879948695,40,378,1124,3.75
553,4,3,-1,879948695,879948732,37,1124,81,3.2857142857142856
553,3,3,0,879948732,879948771,39,81,86,3.869565217391304
553,3,4,1,879948771,879948806,35,86,609,3.7058823529411766
553,4,4,0,879948806,879948869,63,609,111,3.5106382978723403
553,4,4,0,879948869,879948964,95,111,478,4.161290322580645
553,4,5,1,879948964,879948995,31,478,1194,4.181818181818182
553,5,4,-1,879948995,879949042,47,1194,617,3.8
553,4,4,0,879949042,879949073,31,617,490,3.5454545454545454
553,4,5,1,879949073,879949107,34,490,604,3.8181818181818183
553,5,2,-3,879949107,879949153,46,604,1021,3.8666666666666667
553,2,4,2,879949153,879949180,27,1021,177,3.875
553,4,5,1,879949180,879949181,1,177,151,3.6544117647058822
553,5,4,-1,879949181,879949212,31,151,1451,4.0
553,4,4,0,879949212,879949289,77,1451,655,3.7857142857142856
553,4,5,1,879949289,879949290,1,655,213,3.943396226415094
552,4,3,-1,879220610,879220650,40,300,988,2.5555555555555554
552,3,4,1,879220650,879220651,1,988,748,3.1043478260869564
552,4,4,0,879220651,879220688,37,748,294,3.1052631578947367
552,4,4,0,879220688,879220720,32,294,301,3.2465753424657535
552,4,3,-1,879220720,879221399,679,301,181,3.98974358974359
552,3,3,0,879221399,879221543,144,181,515,4.202898550724638
552,3,4,1,879221543,879221580,37,515,127,4.162790697674419
552,4,4,0,879221580,879221617,37,127,237,3.7315436241610738
552,4,4,0,879221617,879221649,32,237,14,4.101694915254237
552,4,3,-1,879221649,879221716,67,14,1,3.902439024390244
552,3,3,0,879221716,879221764,48,1,455,3.1702127659574466
552,3,3,0,879221764,879221795,31,455,257,3.7154471544715446
552,3,3,0,879221795,879221833,38,257,628,3.573529411764706
552,3,4,1,879221833,879221876,43,628,50,4.306532663316583
552,4,3,-1,879221876,879222002,126,50,1152,3.4375
552,3,3,0,879222002,879222033,31,1152,977,2.473684210526316
552,3,3,0,879222033,879222070,37,977,410,3.0434782608695654
552,3,3,0,879222070,879222071,1,410,1620,3.6666666666666665
552,3,4,1,879222071,879222103,32,1620,742,3.5555555555555554
552,4,3,-1,879222103,879222162,59,742,274,3.5609756097560976
552,3,3,0,879222162,879222194,32,274,932,2.5
552,3,3,0,879222194,879222268,74,932,405,3.25
552,3,3,0,879222268,879222306,38,405,471,3.5714285714285716
552,3,3,0,879222306,879222336,30,471,815,3.135135135135135
552,3,3,0,879222336,879222412,76,815,591,3.7169811320754715
552,3,3,0,879222412,879222452,40,591,1315,3.4444444444444446
552,3,3,0,879222452,879222484,32,1315,125,3.5555555555555554
552,3,4,1,879222484,879222520,36,125,1014,3.1
552,4,3,-1,879222520,879222521,1,1014,1047,2.6923076923076925
552,3,3,0,879222521,879222632,111,1047,619,3.4782608695652173
552,3,2,-1,879222632,879222661,29,619,291,3.2
552,2,3,1,879222661,879222698,37,291,1362,3.0
552,3,3,0,879222698,879222738,40,1362,829,2.4615384615384617
552,3,3,0,879222738,879222763,25,829,1277,3.5555555555555554
540,4,3,-1,882156617,882156618,1,294,300,3.6861313868613137
540,3,4,1,882156618,882156677,59,300,332,3.6511627906976742
540,4,4,0,882156677,882156710,33,332,310,3.6666666666666665
540,4,3,-1,882156710,882156851,141,310,323,3.0
540,3,5,2,882156851,882156965,114,323,9,3.8878504672897196
540,5,4,-1,882156965,882156983,18,9,508,3.6923076923076925
540,4,4,0,882156983,882157011,28,508,7,3.76056338028169
540,4,3,-1,882157011,882157036,25,7,591,3.7169811320754715
540,3,4,1,882157036,882157060,24,591,181,3.98974358974359
540,4,4,0,882157060,882157061,1,181,276,3.6036036036036037
540,4,3,-1,882157061,882157084,23,276,15,3.725663716814159
540,3,5,2,882157084,882157105,21,15,515,4.202898550724638
540,5,4,-1,882157105,882157126,21,515,596,3.180327868852459
540,4,4,0,882157126,882157148,22,596,111,3.5106382978723403
540,4,4,0,882157148,882157172,24,111,825,2.914285714285714
540,4,4,0,882157172,882157194,22,825,109,3.282608695652174
540,4,4,0,882157194,882157224,30,109,1014,3.1
540,4,4,0,882157224,882157248,24,1014,597,3.2771084337349397
540,4,4,0,882157248,882157509,261,597,20,3.375
540,4,4,0,882157509,882157545,36,20,762,3.3962264150943398
540,4,4,0,882157545,882157584,39,762,257,3.7154471544715446
540,4,3,-1,882157584,882157612,28,257,405,3.25
540,3,4,1,882157612,882157662,50,405,274,3.5609756097560976
540,4,3,-1,882157662,882157687,25,274,473,2.9166666666666665
540,3,4,1,882157687,882157706,19,473,117,3.689189189189189
540,4,4,0,882157706,882157732,26,117,1226,3.5454545454545454
540,4,3,-1,882157732,882157797,65,1226,280,3.103448275862069
554,4,4,0,876231468,876231521,53,9,286,3.442857142857143
554,4,3,-1,876231521,876231546,25,286,742,3.5555555555555554
554,3,3,0,876231546,876231570,24,742,237,3.7315436241610738
554,3,4,1,876231570,876231634,64,237,275,4.087912087912088
554,4,3,-1,876231634,876231688,54,275,819,2.6666666666666665
554,3,4,1,876231688,876231777,89,819,117,3.689189189189189
554,4,4,0,876231777,876231802,25,117,222,3.578125
554,4,3,-1,876231802,876231839,37,222,1012,3.2916666666666665
554,3,3,0,876231839,876231886,47,1012,546,2.9789473684210526
554,3,3,0,876231886,876231938,52,546,756,2.6885245901639343
554,3,4,1,876231938,876231964,26,756,15,3.725663716814159
554,4,3,-1,876231964,876232023,59,15,696,3.138888888888889
554,3,1,-2,876232023,876232212,189,696,21,2.9210526315789473
554,1,4,3,876232212,876232267,55,21,121,3.521212121212121
554,4,3,-1,876232267,876232317,50,121,274,3.5609756097560976
554,3,3,0,876232317,876232486,169,274,866,3.3962264150943398
554,3,2,-1,876232486,876232730,244,866,13,3.5454545454545454
554,2,4,2,876232730,876232758,28,13,28,3.923076923076923
554,4,4,0,876232758,876232794,36,28,22,4.215909090909091
554,4,4,0,876232794,876232956,162,22,202,3.730337078651685
554,4,3,-1,876232956,876232996,40,202,223,4.108695652173913
554,3,4,1,876232996,876232997,1,223,209,3.8275862068965516
554,4,4,0,876232997,876233069,72,209,11,3.8904109589041096
554,4,4,0,876233069,876369085,136016,11,31,3.642857142857143
554,4,3,-1,876369085,876369162,77,31,216,3.8454545454545452
554,3,4,1,876369162,876369272,110,216,133,3.7777777777777777
554,4,4,0,876369272,876369382,110,133,70,3.5833333333333335
554,4,3,-1,876369382,876369527,145,70,173,4.1441441441441444
554,3,2,-1,876369527,876369560,33,173,4,3.5538461538461537
554,2,3,1,876369560,876369615,55,4,66,3.4705882352941178
554,3,4,1,876369615,876369678,63,66,86,3.869565217391304
554,4,5,1,876369678,876369730,52,86,318,4.5046728971962615
554,5,3,-2,876369730,876369785,55,318,179,3.8823529411764706
554,3,3,0,876369785,876369907,122,179,229,3.185185185185185
554,3,3,0,876369907,876369932,25,229,67,3.106382978723404
554,3,5,2,876369932,876369968,36,67,230,3.3518518518518516
554,5,3,-2,876369968,876369995,27,230,728,3.05
554,3,3,0,876369995,876549009,179014,728,284,3.1547619047619047
554,3,3,0,876549009,876549087,78,284,7,3.76056338028169
554,3,4,1,876549087,876549656,569,7,289,2.988888888888889
554,4,4,0,876549656,876549731,75,289,531,3.7435897435897436
554,4,4,0,876549731,876549808,77,531,58,3.543859649122807
554,4,4,0,876549808,876550100,292,58,526,3.909090909090909
554,4,4,0,876550100,876550182,82,526,14,4.101694915254237
554,4,4,0,876550182,876550257,75,14,71,3.6575342465753424
554,4,4,0,876550257,876550342,85,71,939,3.6333333333333333
554,4,5,1,876550342,876550372,30,939,172,4.225225225225225
554,5,4,-1,876550372,876550453,81,172,132,3.929411764705882
554,4,4,0,876550453,876550491,38,132,432,3.719298245614035
554,4,4,0,876550491,876550526,35,432,8,3.903225806451613
554,4,3,-1,876550526,876550610,84,8,1042,3.625
554,3,4,1,876550610,876550654,44,1042,87,3.9
554,4,4,0,876550654,876550778,124,87,50,4.306532663316583
554,4,4,0,876550778,876550833,55,50,732,3.6266666666666665
554,4,3,-1,876550833,876550913,80,732,125,3.5555555555555554
554,3,3,0,876550913,876551044,131,125,1028,2.857142857142857
550,4,5,1,883425365,883425409,44,748,258,3.7547169811320753
550,5,4,-1,883425409,883425426,17,258,993,3.4838709677419355
550,4,3,-1,883425426,883425485,59,993,1089,2.1363636363636362
550,3,5,2,883425485,883425610,125,1089,313,4.323076923076923
550,5,5,0,883425610,883425627,17,313,310,3.6666666666666665
550,5,5,0,883425627,883425652,25,310,271,3.3134328358208953
550,5,4,-1,883425652,883425723,71,271,877,2.619047619047619
550,4,3,-1,883425723,883425743,20,877,304,3.5306122448979593
550,3,3,0,883425743,883425762,19,304,688,2.111111111111111
550,3,4,1,883425762,883425783,21,688,682,3.0476190476190474
550,4,4,0,883425783,883425958,175,682,275,4.087912087912088
550,4,5,1,883425958,883425979,21,275,288,3.5214285714285714
550,5,4,-1,883425979,883426027,48,288,924,3.3703703703703702
550,4,2,-2,883426027,883426119,92,924,259,2.492063492063492
556,5,2,-3,882135508,882135684,176,327,325,2.625
556,2,4,2,882135684,882135805,121,325,324,3.2291666666666665
556,4,2,-2,882135805,882135855,50,324,294,3.1052631578947367
556,2,4,2,882135855,882135994,139,294,321,3.0172413793103448
556,4,2,-2,882135994,882136058,64,321,323,3.0
556,2,5,3,882136058,882136162,104,323,479,4.25
556,5,5,0,882136162,882136205,43,479,523,4.159090909090909
556,5,2,-3,882136205,882136252,47,523,135,3.7974683544303796
556,2,5,3,882136252,882136396,144,135,132,3.929411764705882
556,5,5,0,882136396,882136440,44,132,427,4.2025316455696204
556,5,5,0,882136440,882136441,1,427,520,4.136363636363637
559,3,5,2,891033759,891033805,46,1556,205,3.717391304347826
559,5,5,0,891033805,891033835,30,205,318,4.5046728971962615
559,5,3,-2,891033835,891033911,76,318,187,4.215189873417722
559,3,5,2,891033911,891033956,45,187,863,3.727272727272727
559,5,4,-1,891033956,891034003,47,863,87,3.9
559,4,5,1,891034003,891034004,1,87,519,4.291666666666667
559,5,3,-2,891034004,891034040,36,519,661,4.133333333333334
559,3,3,0,891034040,891034067,27,661,12,4.358974358974359
559,3,4,1,891034067,891034095,28,12,587,3.4
559,4,5,1,891034095,891034139,44,587,191,4.168674698795181
559,5,3,-2,891034139,891034172,33,191,1401,3.0
559,3,3,0,891034172,891034209,37,1401,508,3.6923076923076925
559,3,1,-2,891034209,891034250,41,508,660,3.71875
559,1,2,1,891034250,891034347,97,660,511,4.096153846153846
559,2,5,3,891034347,891034551,204,511,144,3.9545454545454546
559,5,5,0,891034551,891034609,58,144,188,3.625
559,5,3,-2,891034609,891034688,79,188,233,3.323529411764706
559,3,4,1,891034688,891034957,269,233,210,3.921259842519685
559,4,4,0,891034957,891034987,30,210,322,3.0476190476190474
559,4,4,0,891034987,891035111,124,322,180,3.9473684210526314
559,4,4,0,891035111,891035137,26,180,300,3.6861313868613137
559,4,3,-1,891035137,891035378,241,300,261,2.7333333333333334
559,3,3,0,891035378,891035407,29,261,259,2.492063492063492
559,3,3,0,891035407,891035466,59,259,257,3.7154471544715446
559,3,1,-2,891035466,891035519,53,257,294,3.1052631578947367
559,1,3,2,891035519,891035551,32,294,687,2.1481481481481484
559,3,4,1,891035551,891035633,82,687,514,4.033333333333333
559,4,1,-3,891035633,891035674,41,514,238,3.888888888888889
559,1,3,2,891035674,891035708,34,238,204,3.6744186046511627
559,3,3,0,891035708,891035840,132,204,167,2.8181818181818183
559,3,3,0,891035840,891035917,77,167,70,3.5833333333333335
559,3,4,1,891035917,891035946,29,70,502,3.272727272727273
560,4,3,-1,879975116,879975151,35,288,321,3.0172413793103448
560,3,4,1,879975151,879975173,22,321,270,3.7804878048780486
560,4,4,0,879975173,879975194,21,270,271,3.3134328358208953
560,4,3,-1,879975194,879975231,37,271,264,2.65
560,3,3,0,879975231,879975358,127,264,358,2.6551724137931036
560,3,5,2,879975358,879975406,48,358,134,4.174603174603175
560,5,3,-2,879975406,879975485,79,134,132,3.929411764705882
560,3,4,1,879975485,879975529,44,132,1019,3.7777777777777777
560,4,5,1,879975529,879975586,57,1019,183,3.951219512195122
560,5,4,-1,879975586,879975613,27,183,203,3.826923076923077
560,4,3,-1,879975613,879975661,48,203,617,3.8
560,3,3,0,879975661,879975662,1,617,489,4.076923076923077
560,3,5,2,879975662,879975752,90,489,100,4.0162162162162165
560,5,5,0,879975752,879976109,357,100,246,4.0
560,5,4,-1,879976109,879976126,17,246,250,3.4698795180722892
560,4,3,-1,879976126,879976172,46,250,257,3.7154471544715446
560,3,4,1,879976172,879976215,43,257,1405,3.3333333333333335
560,4,3,-1,879976215,879976216,1,1405,1016,3.559322033898305
560,3,5,2,879976216,879976247,31,1016,249,3.3275862068965516
560,5,4,-1,879976247,879976449,202,249,1,3.902439024390244
560,4,3,-1,879976449,879976478,29,1,1134,2.888888888888889
560,3,3,0,879976478,879976502,24,1134,508,3.6923076923076925
560,3,3,0,879976502,879976525,23,508,284,3.1547619047619047
560,3,3,0,879976525,879976542,17,284,151,3.6544117647058822
560,3,3,0,879976542,879976602,60,151,13,3.5454545454545454
560,3,3,0,879976602,879976705,103,13,121,3.521212121212121
560,3,3,0,879976705,879976706,1,121,25,3.3185840707964602
560,3,3,0,879976706,879976731,25,25,1008,3.5
560,3,2,-1,879976731,879976772,41,1008,24,3.3728813559322033
560,2,3,1,879976772,879976807,35,24,1171,2.857142857142857
560,3,3,0,879976807,879976828,21,1171,281,3.2
560,3,2,-1,879976828,879976867,39,281,235,3.106382978723404
560,2,1,-1,879976867,879976892,25,235,278,3.0357142857142856
560,1,2,1,879976892,879976914,22,278,597,3.2771084337349397
560,2,2,0,879976914,879976945,31,597,472,2.984375
560,2,4,2,879976945,879976970,25,472,405,3.25
560,4,1,-3,879976970,879976988,18,405,108,3.107142857142857
560,1,2,1,879976988,879977032,44,108,756,2.6885245901639343
560,2,3,1,879977032,879977062,30,756,928,3.142857142857143
560,3,3,0,879977062,879977081,19,928,122,2.282608695652174
560,3,2,-1,879977081,879977124,43,122,476,3.1216216216216215
561,3,4,1,885806779,885806797,18,751,302,4.133333333333334
561,4,2,-2,885806797,885806823,26,302,258,3.7547169811320753
561,2,5,3,885806823,885806862,39,258,346,3.5128205128205128
561,5,3,-2,885806862,885806883,21,346,1024,3.0
561,3,4,1,885806883,885807035,152,1024,343,3.0
561,4,2,-2,885807035,885807080,45,343,678,2.8181818181818183
561,2,5,3,885807080,885807173,93,678,607,4.136363636363637
561,5,1,-4,885807173,885807215,42,607,69,3.8015873015873014
561,1,3,2,885807215,885807235,20,69,679,3.2432432432432434
561,3,4,1,885807235,885807261,26,679,168,4.0476190476190474
561,4,4,0,885807261,885807290,29,168,478,4.161290322580645
561,4,3,-1,885807290,885807291,1,478,201,3.75
561,3,4,1,885807291,885807318,27,201,1120,3.1
561,4,4,0,885807318,885807369,51,1120,492,4.117647058823529
561,4,3,-1,885807369,885807393,24,492,205,3.717391304347826
561,3,4,1,885807393,885807429,36,205,507,3.6285714285714286
561,4,5,1,885807429,885807455,26,507,1512,5.0
561,5,3,-2,885807455,885807484,29,1512,191,4.168674698795181
561,3,4,1,885807484,885807510,26,191,511,4.096153846153846
561,4,4,0,885807510,885807574,64,511,664,3.15
561,4,3,-1,885807574,885807612,38,664,357,4.063291139240507
561,3,4,1,885807612,885807713,101,357,1149,3.857142857142857
561,4,4,0,885807713,885807743,30,1149,200,3.8157894736842106
561,4,4,0,885807743,885807842,99,200,382,3.764705882352941
561,4,4,0,885807842,885807843,1,382,436,3.5
561,4,3,-1,885807843,885807888,45,436,133,3.7777777777777777
561,3,4,1,885807888,885807962,74,133,1021,3.8666666666666667
561,4,4,0,885807962,885808000,38,1021,425,3.7027027027027026
561,4,2,-2,885808000,885808053,53,425,28,3.923076923076923
561,2,3,1,885808053,885808673,620,28,19,3.9615384615384617
561,3,4,1,885808673,885808715,42,19,772,3.3333333333333335
561,4,3,-1,885808715,885808766,51,772,10,3.85
561,3,3,0,885808766,885808767,1,10,645,3.5714285714285716
561,3,2,-1,885808767,885808796,29,645,423,3.7016129032258065
561,2,4,2,885808796,885808824,28,423,211,3.958904109589041
561,4,2,-2,885808824,885808843,19,211,151,3.6544117647058822
561,2,3,1,885808843,885808844,1,151,153,3.7865168539325844
561,3,4,1,885808844,885808866,22,153,537,3.5
561,4,3,-1,885808866,885808887,21,537,1101,3.793103448275862
561,3,3,0,885808887,885808904,17,1101,160,3.4
561,3,3,0,885808904,885808963,59,160,195,3.9072164948453607
561,3,3,0,885808963,885808986,23,195,198,4.04
561,3,2,-1,885808986,885809005,19,198,319,3.0408163265306123
561,2,3,1,885809005,885809025,20,319,42,3.893617021276596
561,3,4,1,885809025,885809043,18,42,1070,4.0
561,4,3,-1,885809043,885809044,1,1070,4,3.5538461538461537
561,3,4,1,885809044,885809064,20,4,86,3.869565217391304
561,4,2,-2,885809064,885809119,55,86,241,3.5625
561,2,3,1,885809119,885809146,27,241,1115,3.3846153846153846
561,3,3,0,885809146,885809197,51,1115,943,3.6666666666666665
561,3,3,0,885809197,885809223,26,943,277,3.6
561,3,4,1,885809223,885809224,1,277,93,3.5641025641025643
561,4,3,-1,885809224,885809245,21,93,207,3.4761904761904763
561,3,3,0,885809245,885809246,1,207,462,3.7954545454545454
561,3,2,-1,885809246,885809269,23,462,132,3.929411764705882
561,2,3,1,885809269,885809291,22,132,639,4.083333333333333
561,3,5,2,885809291,885809312,21,639,652,3.9642857142857144
561,5,3,-2,885809312,885809313,1,652,673,3.393939393939394
561,3,3,0,885809313,885809336,23,673,239,3.423076923076923
561,3,5,2,885809336,885809356,20,239,12,4.358974358974359
561,5,3,-2,885809356,885809407,51,12,1170,3.1666666666666665
561,3,3,0,885809407,885809447,40,1170,504,4.085714285714285
561,3,3,0,885809447,885809506,59,504,206,3.0
561,3,2,-1,885809506,885809524,18,206,1110,2.85
561,2,1,-1,885809524,885809583,59,1110,219,2.735294117647059
561,1,3,2,885809583,885809654,71,219,58,3.543859649122807
561,3,3,0,885809654,885809670,16,58,214,3.272727272727273
561,3,2,-1,885809670,885809690,20,214,417,3.0588235294117645
561,2,2,0,885809690,885809731,41,417,794,3.6
561,2,3,1,885809731,885809752,21,794,2,3.0851063829787235
561,3,3,0,885809752,885809781,29,2,162,3.4651162790697674
561,3,3,0,885809781,885809806,25,162,235,3.106382978723404
561,3,3,0,885809806,885809872,66,235,215,3.662921348314607
561,3,3,0,885809872,885809873,1,215,702,2.764705882352941
561,3,4,1,885809873,885809939,66,702,199,4.191489361702128
561,4,2,-2,885809939,885809958,19,199,596,3.180327868852459
561,2,1,-1,885809958,885810000,42,596,143,3.56
561,1,2,1,885810000,885810039,39,143,71,3.6575342465753424
561,2,3,1,885810039,885810060,21,71,13,3.5454545454545454
561,3,1,-2,885810060,885810084,24,13,692,3.56
561,1,2,1,885810084,885810117,33,692,451,3.207792207792208
561,2,3,1,885810117,885810144,27,451,62,3.048780487804878
561,3,2,-1,885810144,885810167,23,62,17,3.032258064516129
561,2,3,1,885810167,885810192,25,17,952,3.3529411764705883
561,3,2,-1,885810192,885810193,1,952,849,2.5625
561,2,1,-1,885810193,885810220,27,849,1229,2.4
561,1,3,2,885810220,885810240,20,1229,805,3.909090909090909
561,3,3,0,885810240,885810271,31,805,229,3.185185185185185
561,3,3,0,885810271,885810309,38,229,665,2.72972972972973
561,3,3,0,885810309,885810372,63,665,121,3.521212121212121
561,3,3,0,885810372,885810390,18,121,3,3.0625
561,3,2,-1,885810390,885810428,38,3,379,3.35
561,2,4,2,885810428,885810429,1,379,130,1.8461538461538463
561,4,2,-2,885810429,885810538,109,130,1220,2.9166666666666665
561,2,1,-1,885810538,885810557,19,1220,546,2.9789473684210526
561,1,3,2,885810557,885810575,18,546,578,3.066666666666667
561,3,3,0,885810575,885810674,99,578,676,3.3142857142857145
561,3,3,0,885810674,885810706,32,676,737,3.12
561,3,1,-2,885810706,885810726,20,737,240,3.0350877192982457
561,1,2,1,885810726,885810744,18,240,231,2.938775510204082
561,2,3,1,885810744,885810769,25,231,921,3.611111111111111
561,3,2,-1,885810769,885810785,16,921,155,3.0588235294117645
561,2,3,1,885810785,885810813,28,155,1230,1.8888888888888888
561,3,2,-1,885810813,885810834,21,1230,40,2.7037037037037037
563,5,4,-1,880506197,880506234,37,321,301,3.2465753424657535
563,4,2,-2,880506234,880506368,134,301,678,2.8181818181818183
563,2,5,3,880506368,880506596,228,678,257,3.7154471544715446
563,5,4,-1,880506596,880506703,107,257,220,3.433333333333333
563,4,4,0,880506703,880506771,68,220,167,2.8181818181818183
563,4,5,1,880506771,880506842,71,167,692,3.56
563,5,4,-1,880506842,880506863,21,692,118,3.2764227642276422
563,4,3,-1,880506863,880506963,100,118,254,2.7419354838709675
563,3,4,1,880506963,880507042,79,254,566,3.543859649122807
563,4,4,0,880507042,880507083,41,566,367,3.4242424242424243
563,4,2,-2,880507083,880507108,25,367,412,2.272727272727273
563,2,2,0,880507108,880507263,155,412,871,2.3823529411764706
563,2,3,1,880507263,880507311,48,871,476,3.1216216216216215
563,3,4,1,880507311,880507374,63,476,181,3.98974358974359
563,4,5,1,880507374,880507404,30,181,50,4.306532663316583
563,5,4,-1,880507404,880507483,79,50,210,3.921259842519685
563,4,4,0,880507483,880507625,142,210,153,3.7865168539325844
563,4,1,-3,880507625,880507672,47,153,862,1.6666666666666667
566,4,4,0,881649357,881649358,1,483,529,4.142857142857143
566,4,4,0,881649358,881649445,87,529,98,4.240875912408759
566,4,4,0,881649445,881649471,26,98,480,4.283018867924528
566,4,4,0,881649471,881649505,34,480,443,3.8421052631578947
566,4,5,1,881649505,881649530,25,443,64,4.373737373737374
566,5,5,0,881649530,881649548,18,64,100,4.0162162162162165
566,5,4,-1,881649548,881649563,15,100,70,3.5833333333333335
566,4,4,0,881649563,881649577,14,70,508,3.6923076923076925
566,4,3,-1,881649577,881649644,67,508,172,4.225225225225225
566,3,4,1,881649644,881649670,26,172,133,3.7777777777777777
566,4,2,-2,881649670,881649709,39,133,423,3.7016129032258065
566,2,5,3,881649709,881649727,18,423,693,3.6285714285714286
566,5,4,-1,881649727,881649775,48,693,673,3.393939393939394
566,4,4,0,881649775,881649802,27,673,684,3.847826086956522
566,4,3,-1,881649802,881649828,26,684,204,3.6744186046511627
566,3,4,1,881649828,881649853,25,204,461,3.3333333333333335
566,4,4,0,881649853,881649871,18,461,705,3.7857142857142856
566,4,3,-1,881649871,881649893,22,705,186,3.905263157894737
566,3,2,-1,881649893,881649913,20,186,95,3.8194444444444446
566,2,5,3,881649913,881649928,15,95,137,3.9545454545454546
566,5,3,-2,881649928,881649945,17,137,173,4.1441441441441444
566,3,3,0,881649945,881649962,17,173,11,3.8904109589041096
566,3,5,2,881649962,881649985,23,11,157,3.5714285714285716
566,5,4,-1,881649985,881650003,18,157,168,4.0476190476190474
566,4,3,-1,881650003,881650090,87,168,88,3.433734939759036
566,3,4,1,881650090,881650108,18,88,69,3.8015873015873014
566,4,2,-2,881650108,881650123,15,69,230,3.3518518518518516
566,2,4,2,881650123,881650148,25,230,203,3.826923076923077
566,4,4,0,881650148,881650172,24,203,660,3.71875
566,4,5,1,881650172,881650186,14,660,582,3.7457627118644066
566,5,5,0,881650186,881650219,33,582,127,4.162790697674419
566,5,4,-1,881650219,881650423,204,127,89,3.9615384615384617
566,4,4,0,881650423,881650442,19,89,707,3.909090909090909
566,4,4,0,881650442,881650467,25,707,772,3.3333333333333335
566,4,4,0,881650467,881650519,52,772,392,3.5555555555555554
566,4,3,-1,881650519,881650534,15,392,235,3.106382978723404
566,3,4,1,881650534,881650551,17,235,202,3.730337078651685
566,4,3,-1,881650551,881650627,76,202,288,3.5214285714285714
566,3,3,0,881650627,881650654,27,288,403,3.298507462686567
566,3,5,2,881650654,881650690,36,403,856,4.142857142857143
566,5,4,-1,881650690,881650709,19,856,82,3.6741573033707864
566,4,3,-1,881650709,881650739,30,82,215,3.662921348314607
566,3,3,0,881650739,881650755,16,215,121,3.521212121212121
566,3,3,0,881650755,881650825,70,121,31,3.642857142857143
566,3,4,1,881650825,881650849,24,31,265,3.710144927536232
566,4,4,0,881650849,881650886,37,265,117,3.689189189189189
566,4,2,-2,881650886,881650958,72,117,71,3.6575342465753424
566,2,4,2,881650958,881651013,55,71,411,2.911764705882353
566,4,4,0,881651013,881651045,32,411,763,3.347826086956522
566,4,2,-2,881651045,881651077,32,763,25,3.3185840707964602
566,2,4,2,881651077,881651097,20,25,161,3.5844155844155843
566,4,2,-2,881651097,881651126,29,161,1232,2.6666666666666665
566,2,3,1,881651126,881651151,25,1232,154,3.6031746031746033
566,3,4,1,881651151,881651183,32,154,77,3.3857142857142857
566,4,1,-3,881651183,881651286,103,77,219,2.735294117647059
566,1,1,0,881651286,881651317,31,219,231,2.938775510204082
566,1,2,1,881651317,881651339,22,231,1028,2.857142857142857
566,2,2,0,881651339,881651360,21,1028,108,3.107142857142857
566,2,4,2,881651360,881651406,46,108,959,3.4583333333333335
566,4,2,-2,881651406,881651434,28,959,1437,2.3333333333333335
566,2,3,1,881651434,881651464,30,1437,790,2.8518518518518516
566,3,4,1,881651464,881651512,48,790,387,3.5357142857142856
566,4,3,-1,881651512,881651531,19,387,80,2.967741935483871
566,3,2,-1,881651531,881651561,30,80,755,3.085714285714286
566,2,3,1,881651561,881651583,22,755,1044,3.2777777777777777
566,3,2,-1,881651583,881651636,53,1044,94,2.8823529411764706
566,2,1,-1,881651636,881651652,16,94,575,2.619047619047619
566,1,1,0,881651652,881651672,20,575,395,2.5714285714285716
566,1,1,0,881651672,881651813,141,395,110,2.25
566,1,1,0,881651813,881651829,16,110,78,2.3636363636363638
557,4,4,0,880484992,880485019,27,289,292,3.6666666666666665
557,4,3,-1,880485019,880485052,33,292,322,3.0476190476190474
557,3,3,0,880485052,880485074,22,322,325,2.625
557,3,4,1,880485074,880485718,644,325,127,4.162790697674419
557,4,2,-2,880485718,880485764,46,127,257,3.7154471544715446
557,2,3,1,880485764,880485846,82,257,252,2.911392405063291
557,3,2,-1,880485846,880485863,17,252,1244,2.7777777777777777
557,2,4,2,880485863,880485908,45,1244,254,2.7419354838709675
557,4,4,0,880485908,880485956,48,254,508,3.6923076923076925
557,4,4,0,880485956,881095995,610039,508,343,3.0
557,4,3,-1,881095995,881179139,83144,343,269,4.085106382978723
557,3,3,0,881179139,881179166,27,269,270,3.7804878048780486
557,3,2,-1,881179166,881179213,47,270,682,3.0476190476190474
557,2,3,1,881179213,881179268,55,682,305,3.5789473684210527
557,3,4,1,881179268,881179291,23,305,875,2.736842105263158
557,4,4,0,881179291,881179362,71,875,334,3.4210526315789473
557,4,4,0,881179362,881179397,35,334,166,4.0
557,4,5,1,881179397,881179455,58,166,529,4.142857142857143
557,5,5,0,881179455,881179513,58,529,198,4.04
557,5,4,-1,881179513,881179557,44,198,271,3.3134328358208953
557,4,3,-1,881179557,881179621,64,271,150,3.803921568627451
557,3,5,2,881179621,881179653,32,150,197,4.112676056338028
557,5,2,-3,881179653,882458820,1279167,197,262,3.5217391304347827
557,2,4,2,882458820,884357373,1898553,262,750,4.027777777777778
557,4,3,-1,884357373,884357648,275,750,892,2.9615384615384617
558,4,2,-2,879435855,879435896,41,124,1068,3.2
558,2,4,2,879435896,879436027,131,1068,744,3.5714285714285716
558,4,4,0,879436027,879436069,42,744,9,3.8878504672897196
558,4,4,0,879436069,879436097,28,9,14,4.101694915254237
564,2,3,1,888718443,888718521,78,1025,333,3.546666666666667
564,3,4,1,888718521,888718546,25,333,245,3.056179775280899
564,4,4,0,888718546,888730699,12153,245,118,3.2764227642276422
564,4,4,0,888730699,888730974,275,118,117,3.689189189189189
564,4,3,-1,888730974,888731038,64,117,827,2.4375
565,5,4,-1,891037291,891037393,102,639,207,3.4761904761904763
565,4,3,-1,891037393,891037453,60,207,512,3.888888888888889
565,3,5,2,891037453,891037499,46,512,30,3.8181818181818183
565,5,5,0,891037499,891037524,25,30,52,3.727272727272727
565,5,5,0,891037524,891037563,39,52,652,3.9642857142857144
565,5,5,0,891037563,891037586,23,652,382,3.764705882352941
565,5,2,-3,891037586,891037628,42,382,381,3.2758620689655173
565,2,5,3,891037628,891037629,1,381,70,3.5833333333333335
565,5,4,-1,891037629,891037692,63,70,462,3.7954545454545454
565,4,5,1,891037692,891037693,1,462,713,3.5
565,5,5,0,891037693,891037757,64,713,86,3.869565217391304
565,5,5,0,891037757,891037778,21,86,179,3.8823529411764706
565,5,4,-1,891037778,891037803,25,179,213,3.943396226415094
565,4,5,1,891037803,891037837,34,213,730,3.8
565,5,5,0,891037837,891037862,25,730,1018,3.0714285714285716
573,4,4,0,885843527,885843596,69,237,275,4.087912087912088
573,4,4,0,885843596,885843700,104,275,258,3.7547169811320753
573,4,4,0,885843700,885843738,38,258,50,4.306532663316583
573,4,3,-1,885843738,885843779,41,50,685,3.2666666666666666
573,3,4,1,885843779,885843817,38,685,283,3.901639344262295
573,4,4,0,885843817,885843818,1,283,10,3.85
573,4,4,0,885843818,885843892,74,10,182,3.842857142857143
573,4,4,0,885843892,885843928,36,182,134,4.174603174603175
573,4,5,1,885843928,885843964,36,134,211,3.958904109589041
573,5,4,-1,885843964,885844007,43,211,632,3.9523809523809526
573,4,4,0,885844007,885844051,44,632,479,4.25
573,4,4,0,885844051,885844091,40,479,179,3.8823529411764706
573,4,3,-1,885844091,885844127,36,179,423,3.7016129032258065
573,3,2,-1,885844127,885844339,212,423,1012,3.2916666666666665
573,2,4,2,885844339,885844394,55,1012,22,4.215909090909091
573,4,4,0,885844394,885844395,1,22,178,4.378378378378378
573,4,4,0,885844395,885844431,36,178,661,4.133333333333334
573,4,3,-1,885844431,885844481,50,661,176,3.967032967032967
573,3,4,1,885844481,885844535,54,176,192,4.090909090909091
573,4,4,0,885844535,885844567,32,192,519,4.291666666666667
573,4,3,-1,885844567,885844605,38,519,185,3.9726027397260273
573,3,4,1,885844605,885844638,33,185,144,3.9545454545454546
573,4,4,0,885844638,885844674,36,144,478,4.161290322580645
549,2,4,2,881671879,881671952,73,323,748,3.1043478260869564
549,4,3,-1,881671952,881671982,30,748,678,2.8181818181818183
549,3,5,2,881671982,881672199,217,678,50,4.306532663316583
549,5,4,-1,881672199,881672241,42,50,181,3.98974358974359
549,4,5,1,881672241,881672276,35,181,515,4.202898550724638
549,5,3,-2,881672276,881672300,24,515,151,3.6544117647058822
549,3,4,1,881672300,881672333,33,151,100,4.0162162162162165
549,4,3,-1,881672333,881672408,75,100,472,2.984375
549,3,5,2,881672408,881672441,33,472,127,4.162790697674419
549,5,4,-1,881672441,881672479,38,127,118,3.2764227642276422
549,4,3,-1,881672479,881672538,59,118,252,2.911392405063291
549,3,4,1,881672538,881672573,35,252,866,3.3962264150943398
549,4,4,0,881672573,881672605,32,866,237,3.7315436241610738
549,4,3,-1,881672605,881672667,62,237,411,2.911764705882353
549,3,3,0,881672667,881672804,137,411,225,3.0714285714285716
567,5,4,-1,882425631,882425673,42,198,490,3.5454545454545454
567,4,5,1,882425673,882425701,28,490,506,3.566666666666667
567,5,5,0,882425701,882425762,61,506,59,4.0
567,5,4,-1,882425762,882425790,28,59,133,3.7777777777777777
567,4,4,0,882425790,882425791,1,133,83,4.204081632653061
567,4,3,-1,882425791,882425820,29,83,1020,3.727272727272727
567,3,5,2,882425820,882425843,23,1020,483,4.475609756097561
567,5,5,0,882425843,882425873,30,483,134,4.174603174603175
567,5,5,0,882425873,882425874,1,134,176,3.967032967032967
567,5,2,-3,882425874,882425901,27,176,357,4.063291139240507
567,2,4,2,882425901,882425932,31,357,615,3.8333333333333335
567,4,5,1,882425932,882425966,34,615,60,4.105263157894737
567,5,5,0,882425966,882425998,32,60,647,4.142857142857143
567,5,4,-1,882425998,882426021,23,647,648,3.9545454545454546
567,4,5,1,882426021,882426055,34,648,156,4.017857142857143
567,5,5,0,882426055,882426079,24,156,478,4.161290322580645
567,5,3,-2,882426079,882426135,56,478,491,3.55
567,3,5,2,882426135,882426158,23,491,641,4.5
567,5,5,0,882426158,882426184,26,641,496,4.094594594594595
567,5,4,-1,882426184,882426210,26,496,811,4.166666666666667
567,4,1,-3,882426210,882426246,36,811,181,3.98974358974359
567,1,4,3,882426246,882426300,54,181,302,4.133333333333334
567,4,3,-1,882426300,882426327,27,302,306,4.033333333333333
567,3,4,1,882426327,882426350,23,306,299,3.0
567,4,4,0,882426350,882426601,251,299,1131,3.6666666666666665
567,4,4,0,882426601,882426622,21,1131,7,3.76056338028169
567,4,5,1,882426622,882426644,22,7,32,3.7222222222222223
567,5,3,-2,882426644,882426673,29,32,527,3.823529411764706
567,3,4,1,882426673,882426696,23,527,9,3.8878504672897196
567,4,4,0,882426696,882426719,23,9,513,4.526315789473684
567,4,4,0,882426719,882426740,21,513,23,3.9047619047619047
567,4,3,-1,882426740,882426762,22,23,234,3.7674418604651163
567,3,4,1,882426762,882426812,50,234,124,4.052631578947368
567,4,2,-2,882426812,882426869,57,124,423,3.7016129032258065
567,2,5,3,882426869,882426899,30,423,481,3.8421052631578947
567,5,4,-1,882426899,882426927,28,481,640,2.75
567,4,3,-1,882426927,882426952,25,640,1451,4.0
567,3,3,0,882426952,882426974,22,1451,39,3.107142857142857
567,3,5,2,882426974,882427023,49,39,1204,4.0
567,5,5,0,882427023,882427046,23,1204,646,3.9285714285714284
567,5,5,0,882427046,882427068,22,646,273,3.5238095238095237
567,5,3,-2,882427068,882427089,21,273,673,3.393939393939394
567,3,4,1,882427089,882427155,66,673,487,4.043478260869565
567,4,3,-1,882427155,882427250,95,487,257,3.7154471544715446
567,3,3,0,882427250,882427273,23,257,1012,3.2916666666666665
567,3,3,0,882427273,882427294,21,1012,1252,3.0
567,3,1,-2,882427294,882427384,90,1252,252,2.911392405063291
569,3,4,1,879793036,879793075,39,333,340,3.7419354838709675
569,4,4,0,879793075,879793103,28,340,321,3.0172413793103448
569,4,2,-2,879793103,879793149,46,321,294,3.1052631578947367
569,2,4,2,879793149,879793253,104,294,328,3.4895833333333335
569,4,4,0,879793253,879793399,146,328,1,3.902439024390244
569,4,4,0,879793399,879793465,66,1,1197,3.625
569,4,4,0,879793465,879793493,28,1197,276,3.6036036036036037
569,4,4,0,879793493,879793741,248,276,248,3.746268656716418
569,4,3,-1,879793741,879793784,43,248,924,3.3703703703703702
569,3,3,0,879793784,879793785,1,924,508,3.6923076923076925
569,3,3,0,879793785,879793810,25,508,273,3.5238095238095237
569,3,4,1,879793810,879793847,37,273,676,3.3142857142857145
569,4,4,0,879793847,879793886,39,676,284,3.1547619047619047
569,4,5,1,879793886,879793909,23,284,126,3.8620689655172415
569,5,4,-1,879793909,879793948,39,126,14,4.101694915254237
569,4,4,0,879793948,879794075,127,14,685,3.2666666666666666
569,4,5,1,879794075,879794127,52,685,19,3.9615384615384617
569,5,3,-2,879794127,879794265,138,19,222,3.578125
569,3,3,0,879794265,879794302,37,222,546,2.9789473684210526
569,3,4,1,879794302,879794348,46,546,291,3.2
569,4,2,-2,879794348,879794385,37,291,277,3.6
569,2,3,1,879794385,879794408,23,277,225,3.0714285714285716
569,3,3,0,879794408,879794498,90,225,405,3.25
569,3,3,0,879794498,879794660,162,405,756,2.6885245901639343
569,3,3,0,879794660,879794740,80,756,762,3.3962264150943398
569,3,4,1,879794740,879795551,811,762,287,3.4516129032258065
569,4,3,-1,879795551,879795581,30,287,1014,3.1
562,2,2,0,879194768,879194894,126,323,1,3.902439024390244
562,2,2,0,879194894,879195007,113,1,133,3.7777777777777777
562,2,4,2,879195007,879195081,74,133,98,4.240875912408759
562,4,1,-3,879195081,879195125,44,98,357,4.063291139240507
562,1,4,3,879195125,879195126,1,357,480,4.283018867924528
562,4,1,-3,879195126,879195156,30,480,56,4.051724137931035
562,1,1,0,879195156,879195289,133,56,806,3.6666666666666665
562,1,4,3,879195289,879195334,45,806,141,3.4827586206896552
562,4,5,1,879195334,879195442,108,141,148,3.2131147540983607
562,5,4,-1,879195442,879195688,246,148,477,3.1666666666666665
562,4,4,0,879195688,879195721,33,477,132,3.929411764705882
562,4,1,-3,879195721,879195819,98,132,89,3.9615384615384617
562,1,4,3,879195819,879195881,62,89,73,3.588235294117647
562,4,1,-3,879195881,879195927,46,73,66,3.4705882352941178
562,1,4,3,879195927,879195954,27,66,483,4.475609756097561
562,4,2,-2,879195954,879195982,28,483,458,3.0588235294117645
562,2,4,2,879195982,879196045,63,458,1126,3.625
562,4,4,0,879196045,879196105,60,1126,1039,3.9583333333333335
562,4,4,0,879196105,879196176,71,1039,591,3.7169811320754715
562,4,4,0,879196176,879196249,73,591,582,3.7457627118644066
562,4,5,1,879196249,879196267,18,582,727,3.5517241379310347
562,5,1,-4,879196267,879196288,21,727,204,3.6744186046511627
562,1,5,4,879196288,879196445,157,204,50,4.306532663316583
562,5,1,-4,879196445,879196446,1,50,231,2.938775510204082
562,1,4,3,879196446,879196483,37,231,720,3.2
562,4,4,0,879196483,879196576,93,720,218,3.5555555555555554
562,4,5,1,879196576,879196653,77,218,501,3.289473684210526
562,5,5,0,879196653,879196680,27,501,88,3.433734939759036
562,5,4,-1,879196680,879196709,29,88,504,4.085714285714285
576,4,5,1,886985002,886985003,1,124,7,3.76056338028169
576,5,4,-1,886985003,886985079,76,7,1,3.902439024390244
576,4,4,0,886985079,886985104,25,1,15,3.725663716814159
576,4,4,0,886985104,886985177,73,15,125,3.5555555555555554
576,4,4,0,886985177,886986304,1127,125,825,2.914285714285714
576,4,5,1,886986304,886986361,57,825,70,3.5833333333333335
576,5,4,-1,886986361,886986400,39,70,210,3.921259842519685
576,4,3,-1,886986400,886986444,44,210,56,4.051724137931035
576,3,4,1,886986444,886986445,1,56,204,3.6744186046511627
576,4,4,0,886986445,887081005,94560,204,50,4.306532663316583
576,4,4,0,887081005,887081041,36,50,181,3.98974358974359
576,4,3,-1,887081041,887081086,45,181,255,3.2027027027027026
576,3,4,1,887081086,887169019,87933,255,248,3.746268656716418
577,3,3,0,880469983,880470282,299,338,405,3.25
577,3,4,1,880470282,880470323,41,405,237,3.7315436241610738
577,4,4,0,880470323,880470350,27,237,100,4.0162162162162165
577,4,2,-2,880470350,880470447,97,100,7,3.76056338028169
577,2,3,1,880470447,880470483,36,7,546,2.9789473684210526
577,3,4,1,880470483,880470504,21,546,25,3.3185840707964602
577,4,5,1,880470504,880470570,66,25,866,3.3962264150943398
577,5,4,-1,880470570,880470604,34,866,125,3.5555555555555554
577,4,5,1,880470604,880470682,78,125,409,2.9615384615384617
577,5,4,-1,880470682,880470732,50,409,284,3.1547619047619047
577,4,4,0,880470732,880470764,32,284,1028,2.857142857142857
577,4,4,0,880470764,880470852,88,1028,826,2.5555555555555554
577,4,4,0,880470852,880471271,419,826,407,2.611111111111111
577,4,3,-1,880471271,880471287,16,407,932,2.5
577,3,3,0,880471287,880471304,17,932,823,2.75
577,3,4,1,880471304,880471359,55,823,117,3.689189189189189
577,4,3,-1,880471359,880471640,281,117,471,3.5714285714285716
577,3,3,0,880471640,880471658,18,471,118,3.2764227642276422
577,3,3,0,880471658,880471823,165,118,1054,2.5454545454545454
577,3,3,0,880471823,880471954,131,1054,1291,2.125
577,3,5,2,880471954,880472055,101,1291,173,4.1441441441441444
577,5,5,0,880472055,880472077,22,173,28,3.923076923076923
577,5,4,-1,880472077,880472124,47,28,216,3.8454545454545452
577,4,5,1,880472124,880472153,29,216,97,3.7282608695652173
577,5,4,-1,880472153,880474257,2104,97,96,3.9130434782608696
577,4,5,1,880474257,880474311,54,96,176,3.967032967032967
577,5,4,-1,880474311,880474338,27,176,204,3.6744186046511627
577,4,3,-1,880474338,880474357,19,204,230,3.3518518518518516
577,3,4,1,880474357,880474394,37,230,50,4.306532663316583
577,4,4,0,880474394,880474414,20,50,732,3.6266666666666665
577,4,4,0,880474414,880474433,19,732,82,3.6741573033707864
577,4,5,1,880474433,880474455,22,82,496,4.094594594594595
577,5,4,-1,880474455,880474530,75,496,98,4.240875912408759
577,4,4,0,880474530,880474556,26,98,208,3.8125
577,4,5,1,880474556,880474612,56,208,663,3.948717948717949
577,5,3,-2,880474612,880474613,1,663,660,3.71875
577,3,3,0,880474613,880474674,61,660,99,3.8392857142857144
577,3,3,0,880474674,880474694,20,99,55,4.051282051282051
577,3,3,0,880474694,880474715,21,55,210,3.921259842519685
577,3,5,2,880474715,880474747,32,210,183,3.951219512195122
577,5,3,-2,880474747,880474766,19,183,468,3.380952380952381
577,3,4,1,880474766,880474787,21,468,202,3.730337078651685
577,4,2,-2,880474787,880474808,21,202,425,3.7027027027027026
577,2,4,2,880474808,880474829,21,425,69,3.8015873015873014
577,4,3,-1,880474829,880474871,42,69,739,3.391304347826087
577,3,3,0,880474871,880474903,32,739,29,2.5714285714285716
577,3,3,0,880474903,880475021,118,29,568,3.5853658536585367
577,3,4,1,880475021,880475043,22,568,140,3.238095238095238
577,4,3,-1,880475043,880475067,24,140,1219,3.142857142857143
577,3,3,0,880475067,880475094,27,1219,996,2.1666666666666665
577,3,3,0,880475094,880475130,36,996,1035,3.03125
577,3,5,2,880475130,880475149,19,1035,623,3.0454545454545454
577,5,3,-2,880475149,880475170,21,623,85,3.3157894736842106
577,3,4,1,880475170,880475187,17,85,403,3.298507462686567
577,4,3,-1,880475187,880475226,39,403,728,3.05
577,3,5,2,880475226,880475245,19,728,470,3.72
577,5,4,-1,880475245,880475269,24,470,399,3.317073170731707
577,4,4,0,880475269,880475286,17,399,1042,3.625
577,4,4,0,880475286,880475318,32,1042,5,3.1481481481481484
577,4,4,0,880475318,880475339,21,5,436,3.5
577,4,3,-1,880475339,880475363,24,436,560,3.111111111111111
577,3,1,-2,880475363,880475408,45,560,693,3.6285714285714286
577,1,4,3,880475408,880475435,27,693,40,2.7037037037037037
577,4,2,-2,880475435,880475453,18,40,38,2.784313725490196
577,2,4,2,880475453,880475504,51,38,1044,3.2777777777777777
577,4,5,1,880475504,880475539,35,1044,65,3.511111111111111
577,5,4,-1,880475539,880475540,1,65,582,3.7457627118644066
577,4,5,1,880475540,880475561,21,582,161,3.5844155844155843
577,5,4,-1,880475561,880475581,20,161,110,2.25
577,4,4,0,880475581,880475602,21,110,579,2.727272727272727
577,4,3,-1,880475602,880475644,42,579,452,2.6129032258064515
577,3,4,1,880475644,880476606,962,452,63,3.125
577,4,3,-1,880476606,880476630,24,63,795,2.4
577,3,3,0,880476630,890089564,9612934,795,307,3.6031746031746033
577,3,4,1,890089564,890089749,185,307,531,3.7435897435897436
579,4,3,-1,880951372,880951494,122,333,326,3.262295081967213
579,3,3,0,880951494,880951569,75,326,748,3.1043478260869564
579,3,1,-2,880951569,880951594,25,748,877,2.619047619047619
579,1,2,1,880951594,880951595,1,877,245,3.056179775280899
579,2,4,2,880951595,880951708,113,245,528,4.241379310344827
579,4,5,1,880951708,880951765,57,528,173,4.1441441441441444
579,5,3,-2,880951765,880951783,18,173,82,3.6741573033707864
579,3,3,0,880951783,880951784,1,82,676,3.3142857142857145
579,3,4,1,880951784,880951867,83,676,169,4.548387096774194
579,4,2,-2,880951867,880951868,1,169,69,3.8015873015873014
579,2,5,3,880951868,880951984,116,69,50,4.306532663316583
579,5,3,-2,880951984,880952006,22,50,7,3.76056338028169
579,3,3,0,880952006,880952038,32,7,179,3.8823529411764706
579,3,2,-1,880952038,880952165,127,179,1446,3.0
579,2,3,1,880952165,880952201,36,1446,238,3.888888888888889
579,3,3,0,880952201,880952237,36,238,382,3.764705882352941
579,3,5,2,880952237,880952270,33,382,202,3.730337078651685
579,5,3,-2,880952270,880952299,29,202,70,3.5833333333333335
579,3,4,1,880952299,880952335,36,70,153,3.7865168539325844
579,4,3,-1,880952335,880952360,25,153,56,4.051724137931035
579,3,4,1,880952360,880952440,80,56,88,3.433734939759036
579,4,3,-1,880952440,880952476,36,88,211,3.958904109589041
579,3,1,-2,880952476,880952516,40,211,1110,2.85
579,1,4,3,880952516,880952549,33,1110,845,3.661290322580645
574,2,4,2,891278916,891278962,46,1022,346,3.5128205128205128
574,4,4,0,891278962,891279012,50,346,300,3.6861313868613137
574,4,2,-2,891279012,891279013,1,300,896,3.6666666666666665
574,2,3,1,891279013,891279121,108,896,270,3.7804878048780486
574,3,4,1,891279121,891279122,1,270,754,3.5789473684210527
574,4,5,1,891279122,891279173,51,754,269,4.085106382978723
574,5,4,-1,891279173,891279214,41,269,887,3.5789473684210527
574,4,5,1,891279214,891279236,22,887,319,3.0408163265306123
574,5,4,-1,891279236,891279285,49,319,289,2.988888888888889
574,4,1,-3,891279285,891279362,77,289,910,1.0
574,1,4,3,891279362,891279410,48,910,311,3.761904761904762
574,4,4,0,891279410,891279451,41,311,316,4.285714285714286
574,4,4,0,891279451,891279520,69,316,883,3.5
574,4,4,0,891279520,891279712,192,883,213,3.943396226415094
555,4,4,0,879962172,879962569,397,147,118,3.2764227642276422
555,4,4,0,879962569,879962642,73,118,1013,2.388888888888889
555,4,4,0,879962642,879962769,127,1013,410,3.0434782608695654
555,4,4,0,879962769,879964159,1390,410,111,3.5106382978723403
555,4,3,-1,879964159,879964209,50,111,235,3.106382978723404
555,3,4,1,879964209,879964265,56,235,21,2.9210526315789473
555,4,4,0,879964265,879964334,69,21,120,2.3421052631578947
555,4,3,-1,879964334,879964335,1,120,1054,2.5454545454545454
555,3,4,1,879964335,879975438,11103,1054,89,3.9615384615384617
555,4,5,1,879975438,879975455,17,89,489,4.076923076923077
555,5,4,-1,879975455,879975474,19,489,505,4.0625
555,4,2,-2,879975474,879975505,31,505,47,3.5869565217391304
572,4,4,0,879449209,879449243,34,319,300,3.6861313868613137
572,4,5,1,879449243,879449610,367,300,9,3.8878504672897196
572,5,3,-2,879449610,879449708,98,9,1137,4.25
572,3,3,0,879449708,879449734,26,1137,1171,2.857142857142857
572,3,2,-1,879449734,879449763,29,1171,222,3.578125
572,2,1,-1,879449763,879449799,36,222,277,3.6
572,1,1,0,879449799,879449840,41,277,924,3.3703703703703702
575,3,3,0,878146540,878146541,1,321,322,3.0476190476190474
575,3,2,-1,878146541,878146638,97,322,304,3.5306122448979593
575,2,5,3,878146638,878148087,1449,304,318,4.5046728971962615
575,5,1,-4,878148087,878148199,112,318,963,3.9285714285714284
575,1,3,2,878148199,878148229,30,963,215,3.662921348314607
575,3,2,-1,878148229,878148258,29,215,50,4.306532663316583
575,2,3,1,878148258,878148295,37,50,182,3.842857142857143
575,3,4,1,878148295,878148329,34,182,427,4.2025316455696204
575,4,5,1,878148329,878148358,29,427,168,4.0476190476190474
575,5,5,0,878148358,878148388,30,168,357,4.063291139240507
584,3,4,1,885774172,885774551,379,229,249,3.3275862068965516
584,4,3,-1,885774551,885774575,24,249,108,3.107142857142857
584,3,3,0,885774575,885774702,127,108,431,3.422222222222222
584,3,4,1,885774702,885778080,3378,431,172,4.225225225225225
584,4,4,0,885778080,885778120,40,172,181,3.98974358974359
584,4,4,0,885778120,885778170,50,181,161,3.5844155844155843
584,4,4,0,885778170,885778238,68,161,114,4.3478260869565215
584,4,4,0,885778238,885778263,25,114,423,3.7016129032258065
584,4,3,-1,885778263,885778458,195,423,82,3.6741573033707864
584,3,2,-1,885778458,885778571,113,82,450,2.2758620689655173
588,5,4,-1,890014648,890014710,62,347,286,3.442857142857143
588,4,5,1,890014710,890014748,38,286,272,4.2
588,5,5,0,890014748,890014782,34,272,313,4.323076923076923
588,5,4,-1,890014782,890014818,36,313,288,3.5214285714285714
588,4,5,1,890014818,890015021,203,288,301,3.2465753424657535
588,5,2,-3,890015021,890015063,42,301,678,2.8181818181818183
588,2,1,-1,890015063,890015374,311,678,100,4.0162162162162165
588,1,5,4,890015374,890015435,61,100,83,4.204081632653061
588,5,5,0,890015435,890015476,41,83,132,3.929411764705882
588,5,1,-4,890015476,890015500,24,132,202,3.730337078651685
588,1,4,3,890015500,890015580,80,202,161,3.5844155844155843
588,4,5,1,890015580,890015608,28,161,181,3.98974358974359
588,5,2,-3,890015608,890015648,40,181,724,3.64
588,2,4,2,890015648,890015684,36,724,1,3.902439024390244
588,4,4,0,890015684,890015722,38,1,95,3.8194444444444446
588,4,5,1,890015722,890015791,69,95,21,2.9210526315789473
588,5,5,0,890015791,890015835,44,21,485,3.717948717948718
588,5,2,-3,890015835,890015894,59,485,237,3.7315436241610738
588,2,2,0,890015894,890023557,7663,237,566,3.543859649122807
588,2,2,0,890023557,890023587,30,566,97,3.7282608695652173
588,2,1,-1,890023587,890023692,105,97,230,3.3518518518518516
588,1,5,4,890023692,890023830,138,230,421,3.462962962962963
588,5,5,0,890023830,890023831,1,421,969,3.8947368421052633
588,5,5,0,890023831,890024002,171,969,697,2.7777777777777777
588,5,4,-1,890024002,890024051,49,697,692,3.56
588,4,4,0,890024051,890024079,28,692,186,3.905263157894737
588,4,5,1,890024079,890024117,38,186,142,3.1481481481481484
588,5,5,0,890024117,890024161,44,142,234,3.7674418604651163
588,5,4,-1,890024161,890024195,34,234,71,3.6575342465753424
588,4,5,1,890024195,890024196,1,71,735,3.58
588,5,3,-2,890024196,890024325,129,735,625,3.25
588,3,4,1,890024325,890024385,60,625,699,3.736842105263158
588,4,5,1,890024385,890024427,42,699,50,4.306532663316583
588,5,3,-2,890024427,890024488,61,50,729,3.3793103448275863
588,3,5,2,890024488,890024529,41,729,42,3.893617021276596
588,5,3,-2,890024529,890024564,35,42,144,3.9545454545454546
588,3,4,1,890024564,890024677,113,144,25,3.3185840707964602
588,4,5,1,890024677,890024730,53,25,88,3.433734939759036
588,5,5,0,890024730,890024781,51,88,216,3.8454545454545452
588,5,5,0,890024781,890024829,48,216,82,3.6741573033707864
588,5,5,0,890024829,890024876,47,82,1061,2.9166666666666665
588,5,5,0,890024876,890024918,42,1061,131,3.731707317073171
588,5,5,0,890024918,890025023,105,131,220,3.433333333333333
588,5,2,-3,890025023,890025076,53,220,207,3.4761904761904763
588,2,4,2,890025076,890025674,598,207,1044,3.2777777777777777
588,4,5,1,890025674,890025704,30,1044,239,3.423076923076923
588,5,5,0,890025704,890025751,47,239,658,3.393939393939394
588,5,4,-1,890025751,890025797,46,658,747,3.5526315789473686
588,4,5,1,890025797,890025864,67,747,1240,3.5454545454545454
588,5,5,0,890025864,890025951,87,1240,559,3.477272727272727
588,5,5,0,890025951,890026009,58,559,417,3.0588235294117645
588,5,4,-1,890026009,890026059,50,417,472,2.984375
588,4,4,0,890026059,890026154,95,472,40,2.7037037037037037
588,4,3,-1,890026154,890026262,108,40,73,3.588235294117647
588,3,4,1,890026262,890026263,1,73,151,3.6544117647058822
588,4,4,0,890026263,890026339,76,151,821,3.076923076923077
588,4,4,0,890026339,890026395,56,821,51,3.5277777777777777
588,4,5,1,890026395,890026459,64,51,959,3.4583333333333335
588,5,3,-2,890026459,890026513,54,959,550,3.272727272727273
588,3,4,1,890026513,890026656,143,550,1098,3.533333333333333
588,4,3,-1,890026656,890026705,49,1098,1469,3.4
588,3,3,0,890026705,890026787,82,1469,542,2.888888888888889
588,3,5,2,890026787,890026882,95,542,155,3.0588235294117645
588,5,4,-1,890026882,890027063,181,155,928,3.142857142857143
588,4,4,0,890027063,890027113,50,928,432,3.719298245614035
588,4,4,0,890027113,890027247,134,432,720,3.2
588,4,3,-1,890027247,890027379,132,720,399,3.317073170731707
588,3,5,2,890027379,890027430,51,399,366,3.4285714285714284
588,5,3,-2,890027430,890027525,95,366,403,3.298507462686567
588,3,5,2,890027525,890027600,75,403,278,3.0357142857142856
588,5,3,-2,890027600,890027707,107,278,728,3.05
588,3,2,-1,890027707,890027865,158,728,94,2.8823529411764706
588,2,1,-1,890027865,890028509,644,94,111,3.5106382978723403
588,1,1,0,890028509,890029079,570,111,1311,2.125
588,1,5,4,890029079,890029212,133,1311,578,3.066666666666667
588,5,5,0,890029212,890030781,1569,578,107,3.45
588,5,1,-4,890030781,890032343,1562,107,67,3.106382978723404
587,4,2,-2,892871113,892871141,28,895,938,2.5555555555555554
587,2,4,2,892871141,892871171,30,938,270,3.7804878048780486
587,4,3,-1,892871171,892871197,26,270,294,3.1052631578947367
587,3,3,0,892871197,892871223,26,294,347,3.59375
587,3,3,0,892871223,892871252,29,347,327,3.5076923076923077
587,3,1,-2,892871252,892871253,1,327,245,3.056179775280899
587,1,3,2,892871253,892871284,31,245,358,2.6551724137931036
587,3,2,-1,892871284,892871310,26,358,887,3.5789473684210527
587,2,4,2,892871310,892871337,27,887,1483,3.25
587,4,3,-1,892871337,892871372,35,1483,350,3.2
587,3,4,1,892871372,892871400,28,350,264,2.65
587,4,3,-1,892871400,892871401,1,264,243,2.357142857142857
587,3,3,0,892871401,892871437,36,243,539,2.6666666666666665
587,3,3,0,892871437,892871438,1,539,261,2.7333333333333334
587,3,4,1,892871438,892871462,24,261,338,2.75
587,4,1,-3,892871462,892871503,41,338,342,2.64
587,1,1,0,892871503,892871536,33,342,266,2.6666666666666665
587,1,2,1,892871536,892871563,27,266,312,3.0
587,2,2,0,892871563,892871584,21,312,902,3.9444444444444446
587,2,3,1,892871584,892871610,26,902,916,3.3333333333333335
587,3,2,-1,892871610,892871641,31,916,881,2.769230769230769
587,2,3,1,892871641,892871642,1,881,308,3.6153846153846154
587,3,2,-1,892871642,892871683,41,308,351,2.4444444444444446
587,2,2,0,892871683,892871706,23,351,353,2.4285714285714284
587,2,2,0,892871706,892871752,46,353,1624,2.0
568,4,1,-3,877906697,877906737,40,303,301,3.2465753424657535
568,1,1,0,877906737,877906935,198,301,855,3.590909090909091
568,1,3,2,877906935,877906995,60,855,923,4.142857142857143
568,3,2,-1,877906995,877907092,97,923,497,3.35
568,2,4,2,877907092,877907126,34,497,191,4.168674698795181
568,4,4,0,877907126,877907156,30,191,604,3.8181818181818183
568,4,3,-1,877907156,877907235,79,604,6,4.333333333333333
568,3,2,-1,877907235,877907236,1,6,132,3.929411764705882
568,2,4,2,877907236,877907281,45,132,100,4.0162162162162165
568,4,2,-2,877907281,877907327,46,100,735,3.58
568,2,5,3,877907327,877907367,40,735,631,3.581818181818182
568,5,2,-3,877907367,877907671,304,631,954,3.5
568,2,5,3,877907671,877907720,49,954,606,4.294117647058823
568,5,2,-3,877907720,877907721,1,606,435,3.8933333333333335
568,2,4,2,877907721,877907781,60,435,482,3.9444444444444446
568,4,4,0,877907781,877907782,1,482,79,3.956989247311828
568,4,3,-1,877907782,877907834,52,79,430,4.136363636363637
568,3,4,1,877907834,877907835,1,430,1050,3.6153846153846154
586,4,4,0,884057344,884057387,43,181,50,4.306532663316583
586,4,4,0,884057387,884057412,25,50,820,3.0444444444444443
586,4,3,-1,884057412,884057471,59,820,257,3.7154471544715446
586,3,3,0,884057471,884057518,47,257,284,3.1547619047619047
586,3,4,1,884057518,884057578,60,284,117,3.689189189189189
586,4,3,-1,884057578,884057661,83,117,250,3.4698795180722892
586,3,5,2,884057661,884057692,31,250,273,3.5238095238095237
586,5,4,-1,884057692,884057783,91,273,237,3.7315436241610738
586,4,4,0,884057783,884057861,78,237,288,3.5214285714285714
586,4,2,-2,884057861,884058005,144,288,249,3.3275862068965516
586,2,2,0,884058005,884058674,669,249,23,3.9047619047619047
586,2,2,0,884058674,884058708,34,23,423,3.7016129032258065
586,2,2,0,884058708,884058860,152,423,185,3.9726027397260273
586,2,4,2,884058860,884058898,38,185,174,4.253521126760563
586,4,4,0,884058898,884058956,58,174,195,3.9072164948453607
586,4,4,0,884058956,884058986,30,195,79,3.956989247311828
586,4,2,-2,884058986,884059027,41,79,238,3.888888888888889
586,2,4,2,884059027,884059110,83,238,96,3.9130434782608696
586,4,2,-2,884059110,884059287,177,96,186,3.905263157894737
586,2,3,1,884059287,884059426,139,186,496,4.094594594594595
586,3,3,0,884059426,884060705,1279,496,219,2.735294117647059
586,3,5,2,884060705,884060807,102,219,17,3.032258064516129
586,5,4,-1,884060807,884060941,134,17,379,3.35
586,4,2,-2,884060941,884061189,248,379,551,1.6666666666666667
586,2,3,1,884061189,884061256,67,551,665,2.72972972972973
586,3,3,0,884061256,884061459,203,665,92,3.7142857142857144
586,3,4,1,884061459,884061806,347,92,226,3.378787878787879
586,4,5,1,884061806,884061807,1,226,33,3.2941176470588234
586,5,3,-2,884061807,884062742,935,33,229,3.185185185185185
586,3,3,0,884062742,884064631,1889,229,628,3.573529411764706
586,3,4,1,884064631,884065692,1061,628,356,3.2
586,4,4,0,884065692,884065719,27,356,159,3.3902439024390243
586,4,4,0,884065719,884065773,54,159,1042,3.625
586,4,3,-1,884065773,884065851,78,1042,696,3.138888888888889
586,3,2,-1,884065851,884065879,28,696,1207,2.125
586,2,3,1,884065879,884065986,107,1207,318,4.5046728971962615
586,3,3,0,884065986,884066016,30,318,427,4.2025316455696204
586,3,3,0,884066016,884066060,44,427,693,3.6285714285714286
586,3,3,0,884066060,884066112,52,693,676,3.3142857142857145
586,3,4,1,884066112,884066141,29,676,215,3.662921348314607
586,4,3,-1,884066141,884066230,89,215,735,3.58
586,3,4,1,884066230,884066336,106,735,51,3.5277777777777777
586,4,3,-1,884066336,884066723,387,51,204,3.6744186046511627
586,3,3,0,884066723,884066799,76,204,393,3.5125
586,3,3,0,884066799,884066859,60,393,235,3.106382978723404
586,3,5,2,884066859,884066959,100,235,1218,3.2
586,5,2,-3,884066959,884067003,44,1218,80,2.967741935483871
586,2,3,1,884067003,884067058,55,80,1047,2.6923076923076925
586,3,1,-2,884067058,884067105,47,1047,756,2.6885245901639343
586,1,4,3,884067105,884067151,46,756,780,3.08
586,4,2,-2,884067151,884067199,48,780,411,2.911764705882353
586,2,2,0,884067199,884067378,179,411,72,3.175438596491228
586,2,4,2,884067378,884067422,44,72,451,3.207792207792208
585,5,3,-2,891282893,891282894,1,1558,582,3.7457627118644066
585,3,5,2,891282894,891283000,106,582,863,3.727272727272727
585,5,5,0,891283000,891284016,1016,863,207,3.4761904761904763
585,5,4,-1,891284016,891284588,572,207,740,3.423076923076923
585,4,3,-1,891284588,891284915,327,740,970,3.0
585,3,2,-1,891284915,891285658,743,970,1347,2.0
585,2,4,2,891285658,891285820,162,1347,557,3.090909090909091
585,4,3,-1,891285820,891286256,436,557,584,3.5238095238095237
582,4,3,-1,882960418,882960446,28,271,300,3.6861313868613137
582,3,5,2,882960446,882960461,15,300,313,4.323076923076923
582,5,3,-2,882960461,882960555,94,313,328,3.4895833333333335
582,3,3,0,882960555,882960601,46,328,748,3.1043478260869564
582,3,1,-2,882960601,882960718,117,748,948,2.2962962962962963
582,1,5,4,882960718,882960844,126,948,93,3.5641025641025643
582,5,5,0,882960844,882960863,19,93,100,4.0162162162162165
582,5,3,-2,882960863,882960941,78,100,237,3.7315436241610738
582,3,4,1,882960941,882961082,141,237,246,4.0
582,4,4,0,882961082,882961257,175,246,1,3.902439024390244
582,4,4,0,882961257,882961301,44,1,181,3.98974358974359
582,4,3,-1,882961301,882961481,180,181,410,3.0434782608695654
582,3,5,2,882961481,882961540,59,410,919,4.0
582,5,3,-2,882961540,882961608,68,919,25,3.3185840707964602
582,3,3,0,882961608,882961723,115,25,3,3.0625
582,3,4,1,882961723,882961804,81,3,240,3.0350877192982457
582,4,4,0,882961804,882961968,164,240,458,3.0588235294117645
582,4,2,-2,882961968,882962030,62,458,1033,3.0
582,2,3,1,882962030,882962133,103,1033,405,3.25
582,3,4,1,882962133,882962247,114,405,1014,3.1
582,4,3,-1,882962247,882962267,20,1014,597,3.2771084337349397
582,3,2,-1,882962267,882962561,294,597,831,2.6097560975609757
582,2,3,1,882962561,882962886,325,831,760,2.35
582,3,4,1,882962886,882963027,141,760,1215,2.0714285714285716
582,4,2,-2,882963027,882963114,87,1215,932,2.5
591,2,3,1,891031013,891031145,132,322,511,4.096153846153846
591,3,3,0,891031145,891031171,26,511,182,3.842857142857143
591,3,5,2,891031171,891031228,57,182,238,3.888888888888889
591,5,5,0,891031228,891031257,29,238,45,4.130434782608695
591,5,4,-1,891031257,891031286,29,45,48,4.055555555555555
591,4,4,0,891031286,891031321,35,48,70,3.5833333333333335
591,4,4,0,891031321,891031344,23,70,56,4.051724137931035
591,4,4,0,891031344,891031383,39,56,514,4.033333333333333
591,4,3,-1,891031383,891031426,43,514,47,3.5869565217391304
591,3,3,0,891031426,891031469,43,47,516,4.055555555555555
591,3,3,0,891031469,891031500,31,516,787,2.75
591,3,3,0,891031500,891031525,25,787,88,3.433734939759036
591,3,2,-1,891031525,891031526,1,88,66,3.4705882352941178
591,2,4,2,891031526,891031644,118,66,393,3.5125
591,4,2,-2,891031644,891031676,32,393,110,2.25
591,2,3,1,891031676,891031724,48,110,168,4.0476190476190474
591,3,4,1,891031724,891039616,7892,168,116,3.6666666666666665
591,4,4,0,891039616,891039637,21,116,1120,3.1
591,4,3,-1,891039637,891039658,21,1120,866,3.3962264150943398
591,3,3,0,891039658,891039676,18,866,235,3.106382978723404
591,3,3,0,891039676,891039769,93,235,934,3.0294117647058822
581,4,3,-1,879641533,879641698,165,515,222,3.578125
581,3,4,1,879641698,879641787,89,222,1097,4.333333333333333
581,4,5,1,879641787,879642333,546,1097,922,4.0
592,5,5,0,882607325,882607356,31,303,262,3.5217391304347827
592,5,4,-1,882607356,882607387,31,262,324,3.2291666666666665
592,4,4,0,882607387,882607434,47,324,875,2.736842105263158
592,4,3,-1,882607434,882607476,42,875,886,2.857142857142857
592,3,5,2,882607476,882607528,52,886,288,3.5214285714285714
592,5,3,-2,882607528,882607572,44,288,339,2.7058823529411766
592,3,1,-2,882607572,882607573,1,339,301,3.2465753424657535
592,1,3,2,882607573,882607606,33,301,330,2.625
592,3,2,-1,882607606,882607647,41,330,325,2.625
592,2,1,-1,882607647,882607690,43,325,984,2.6666666666666665
592,1,1,0,882607690,882607744,54,984,266,2.6666666666666665
592,1,2,1,882607744,882607745,1,266,342,2.64
592,2,1,-1,882607745,882607779,34,342,263,2.2
592,1,2,1,882607779,882607780,1,263,312,3.0
592,2,3,1,882607780,882607872,92,312,1377,3.5
592,3,4,1,882607872,882607910,38,1377,149,2.4
592,4,5,1,882607910,882607955,45,149,150,3.803921568627451
592,5,4,-1,882607955,882608021,66,150,1097,4.333333333333333
592,4,5,1,882608021,882608061,40,1097,298,3.779220779220779
592,5,3,-2,882608061,882608107,46,298,458,3.0588235294117645
592,3,5,2,882608107,882608145,38,458,1142,4.0476190476190474
592,5,5,0,882608145,882608182,37,1142,100,4.0162162162162165
592,5,1,-4,882608182,882608234,52,100,619,3.4782608695652173
592,1,1,0,882608234,882608279,45,619,253,3.5
592,1,5,4,882608279,882608357,78,253,1010,3.611111111111111
592,5,4,-1,882608357,882608358,1,1010,1187,4.333333333333333
592,4,5,1,882608358,882608401,43,1187,1012,3.2916666666666665
592,5,4,-1,882608401,882608402,1,1012,591,3.7169811320754715
592,4,3,-1,882608402,882608457,55,591,1059,2.764705882352941
592,3,4,1,882608457,882608500,43,1059,546,2.9789473684210526
592,4,4,0,882608500,882608531,31,546,405,3.25
592,4,4,0,882608531,882608572,41,405,282,3.610526315789474
592,4,4,0,882608572,882608573,1,282,123,3.297872340425532
592,4,3,-1,882608573,882608625,52,123,1085,4.0
592,3,2,-1,882608625,882608662,37,1085,685,3.2666666666666666
592,2,1,-1,882608662,882608698,36,685,1609,1.0
592,1,3,2,882608698,882608736,38,1609,922,4.0
592,3,1,-2,882608736,882608795,59,922,825,2.914285714285714
592,1,4,3,882608795,882608827,32,825,533,3.6
592,4,3,-1,882608827,882608873,46,533,460,3.0
592,3,4,1,882608873,882608915,42,460,255,3.2027027027027026
592,4,4,0,882608915,882608960,45,255,3,3.0625
592,4,2,-2,882608960,882608961,1,3,148,3.2131147540983607
592,2,3,1,882608961,882609008,47,148,291,3.2
592,3,4,1,882609008,882609009,1,291,1014,3.1
592,4,1,-3,882609009,882609056,47,1014,409,2.9615384615384617
592,1,3,2,882609056,882609057,1,409,820,3.0444444444444443
592,3,1,-2,882609057,882955292,346235,820,893,2.625
592,1,5,4,882955292,882955387,95,893,272,4.2
592,5,4,-1,882955387,882955460,73,272,60,4.105263157894737
592,4,5,1,882955460,882955506,46,60,22,4.215909090909091
592,5,5,0,882955506,882955543,37,22,655,3.7857142857142856
592,5,4,-1,882955543,882955582,39,655,482,3.9444444444444446
592,4,5,1,882955582,882955583,1,482,189,3.88
592,5,5,0,882955583,882955613,30,189,483,4.475609756097561
592,5,5,0,882955613,882955662,49,483,522,3.8461538461538463
592,5,5,0,882955662,882955663,1,522,169,4.548387096774194
592,5,5,0,882955663,882955735,72,169,23,3.9047619047619047
592,5,5,0,882955735,882955766,31,23,466,3.5
592,5,5,0,882955766,882955794,28,466,132,3.929411764705882
592,5,5,0,882955794,882955863,69,132,197,4.112676056338028
592,5,5,0,882955863,882955889,26,197,527,3.823529411764706
592,5,5,0,882955889,882955918,29,527,423,3.7016129032258065
592,5,5,0,882955918,882955948,30,423,854,5.0
592,5,4,-1,882955948,882955978,30,854,971,4.0
592,4,5,1,882955978,882956011,33,971,172,4.225225225225225
592,5,5,0,882956011,882956039,28,172,64,4.373737373737374
592,5,4,-1,882956039,882956067,28,64,55,4.051282051282051
592,4,4,0,882956067,882956102,35,55,747,3.5526315789473686
592,4,5,1,882956102,882956157,55,747,187,4.215189873417722
592,5,5,0,882956157,882956158,1,187,735,3.58
592,5,5,0,882956158,882956201,43,735,69,3.8015873015873014
592,5,5,0,882956201,882956241,40,69,526,3.909090909090909
592,5,5,0,882956241,882956276,35,526,1073,3.6315789473684212
592,5,5,0,882956276,882956358,82,1073,92,3.7142857142857144
592,5,5,0,882956358,882956388,30,92,58,3.543859649122807
592,5,4,-1,882956388,882956418,30,58,4,3.5538461538461537
592,4,4,0,882956418,882956419,1,4,789,3.7777777777777777
592,4,4,0,882956419,882956467,48,789,87,3.9
592,4,2,-2,882956467,882956510,43,87,782,2.8
592,2,4,2,882956510,882956551,41,782,418,3.825
592,4,4,0,882956551,882956586,35,418,806,3.6666666666666665
592,4,3,-1,882956586,882956624,38,806,631,3.581818181818182
592,3,3,0,882956624,882956668,44,631,1166,3.8
592,3,4,1,882956668,882956718,50,1166,59,4.0
592,4,4,0,882956718,882956761,43,59,382,3.764705882352941
592,4,4,0,882956761,885280124,2323363,382,350,3.2
592,4,5,1,885280124,885280183,59,350,1022,3.727272727272727
592,5,2,-3,885280183,887257199,1977016,1022,898,3.0869565217391304
592,2,4,2,887257199,888553233,1296034,898,345,3.4782608695652173
580,3,5,2,884124191,884124248,57,329,271,3.3134328358208953
580,5,4,-1,884124248,884124337,89,271,294,3.1052631578947367
580,4,3,-1,884124337,884124382,45,294,348,3.2
580,3,2,-1,884124382,884124383,1,348,323,3.0
580,2,4,2,884124383,884124472,89,323,358,2.6551724137931036
580,4,3,-1,884124472,884124583,111,358,687,2.1481481481481484
580,3,4,1,884124583,884124750,167,687,286,3.442857142857143
580,4,3,-1,884124750,884124844,94,286,7,3.76056338028169
580,3,3,0,884124844,884124872,28,7,100,4.0162162162162165
580,3,3,0,884124872,884125018,146,100,471,3.5714285714285716
580,3,5,2,884125018,884125042,24,471,181,3.98974358974359
580,5,5,0,884125042,884125072,30,181,250,3.4698795180722892
580,5,3,-2,884125072,884125135,63,250,1014,3.1
580,3,3,0,884125135,884125175,40,1014,619,3.4782608695652173
580,3,4,1,884125175,884125199,24,619,123,3.297872340425532
580,4,3,-1,884125199,884125243,44,123,1,3.902439024390244
580,3,5,2,884125243,884125292,49,1,282,3.610526315789474
580,5,3,-2,884125292,884125339,47,282,15,3.725663716814159
580,3,3,0,884125339,884125457,118,15,25,3.3185840707964602
580,3,3,0,884125457,884125658,201,25,147,3.3142857142857145
580,3,4,1,884125658,884125773,115,147,148,3.2131147540983607
580,4,5,1,884125773,884125829,56,148,252,2.911392405063291
580,5,4,-1,884125829,884125856,27,252,866,3.3962264150943398
580,4,5,1,884125856,884125916,60,866,3,3.0625
580,5,1,-4,884125916,884126077,161,3,546,2.9789473684210526
590,5,4,-1,879438735,879438769,34,285,744,3.5714285714285716
590,4,5,1,879438769,879438825,56,744,100,4.0162162162162165
590,5,5,0,879438825,879438852,27,100,14,4.101694915254237
590,5,5,0,879438852,879438878,26,14,150,3.803921568627451
590,5,2,-3,879438878,879438911,33,150,298,3.779220779220779
590,2,3,1,879438911,879438936,25,298,15,3.725663716814159
590,3,3,0,879438936,879438972,36,15,9,3.8878504672897196
590,3,4,1,879438972,879439060,88,9,676,3.3142857142857145
590,4,4,0,879439060,879439086,26,676,547,3.6666666666666665
590,4,3,-1,879439086,879439114,28,547,293,3.630434782608696
590,3,5,2,879439114,879439145,31,293,6,4.333333333333333
590,5,4,-1,879439145,879439196,51,6,1017,3.0
590,4,3,-1,879439196,879439256,60,1017,591,3.7169811320754715
590,3,3,0,879439256,879439283,27,591,1014,3.1
590,3,5,2,879439283,879439316,33,1014,126,3.8620689655172415
590,5,3,-2,879439316,879439345,29,126,476,3.1216216216216215
590,3,1,-2,879439345,879439374,29,476,255,3.2027027027027026
590,1,3,2,879439374,879439431,57,255,244,2.9411764705882355
590,3,3,0,879439431,879439483,52,244,1009,3.2962962962962963
590,3,3,0,879439483,879439509,26,1009,125,3.5555555555555554
590,3,2,-1,879439509,879439538,29,125,1061,2.9166666666666665
590,2,1,-1,879439538,879439567,29,1061,130,1.8461538461538463
590,1,4,3,879439567,879439645,78,130,248,3.746268656716418
593,5,3,-2,875658824,875658862,38,100,275,4.087912087912088
593,3,5,2,875658862,875658887,25,275,56,4.051724137931035
593,5,5,0,875658887,875658983,96,56,70,3.5833333333333335
593,5,5,0,875658983,875659055,72,70,255,3.2027027027027026
593,5,3,-2,875659055,875659076,21,255,371,3.0
593,3,4,1,875659076,875659236,160,371,284,3.1547619047619047
593,4,3,-1,875659236,875659306,70,284,9,3.8878504672897196
593,3,5,2,875659306,875659518,212,9,282,3.610526315789474
593,5,5,0,875659518,875659576,58,282,111,3.5106382978723403
593,5,4,-1,875659576,875659665,89,111,283,3.901639344262295
593,4,3,-1,875659665,875659686,21,283,278,3.0357142857142856
593,3,1,-2,875659686,875659755,69,278,1014,3.1
593,1,5,4,875659755,875659777,22,1014,126,3.8620689655172415
593,5,3,-2,875659777,875659849,72,126,274,3.5609756097560976
593,3,3,0,875659849,875659896,47,274,1028,2.857142857142857
593,3,3,0,875659896,875659943,47,1028,535,3.380952380952381
593,3,4,1,875659943,875660009,66,535,118,3.2764227642276422
593,4,4,0,875660009,875660036,27,118,121,3.521212121212121
593,4,3,-1,875660036,875660081,45,121,685,3.2666666666666666
593,3,3,0,875660081,875660105,24,685,763,3.347826086956522
593,3,3,0,875660105,875660194,89,763,280,3.103448275862069
593,3,3,0,875660194,875660215,21,280,977,2.473684210526316
593,3,3,0,875660215,875660274,59,977,220,3.433333333333333
593,3,2,-1,875660274,875660295,21,220,846,3.1052631578947367
593,2,2,0,875660295,875660347,52,846,106,2.8125
593,2,5,3,875660347,875660419,72,106,69,3.8015873015873014
593,5,4,-1,875660419,875660482,63,69,11,3.8904109589041096
593,4,4,0,875660482,875660546,64,11,174,4.253521126760563
593,4,4,0,875660546,875660569,23,174,144,3.9545454545454546
593,4,5,1,875660569,875660823,254,144,1119,3.5185185185185186
593,5,4,-1,875660823,875660886,63,1119,26,3.36
593,4,5,1,875660886,875661567,681,26,200,3.8157894736842106
593,5,5,0,875661567,875661596,29,200,98,4.240875912408759
593,5,4,-1,875661596,875670915,9319,98,183,3.951219512195122
593,4,2,-2,875670915,875671062,147,183,470,3.72
593,2,5,3,875671062,875671081,19,470,633,3.9
593,5,5,0,875671081,875671107,26,633,153,3.7865168539325844
593,5,5,0,875671107,875671198,91,153,496,4.094594594594595
593,5,4,-1,875671198,875671255,57,496,366,3.4285714285714284
593,4,4,0,875671255,875671302,47,366,159,3.3902439024390243
593,4,3,-1,875671302,875671334,32,159,781,3.4166666666666665
593,3,5,2,875671334,875671372,38,781,660,3.71875
593,5,5,0,875671372,875671464,92,660,659,4.027777777777778
593,5,4,-1,875671464,875671505,41,659,423,3.7016129032258065
593,4,5,1,875671505,875671598,93,423,417,3.0588235294117645
593,5,4,-1,875671598,875671619,21,417,77,3.3857142857142857
593,4,4,0,875671619,875671674,55,77,79,3.956989247311828
593,4,3,-1,875671674,875671732,58,79,157,3.5714285714285716
593,3,1,-2,875671732,875671757,25,157,40,2.7037037037037037
593,1,4,3,875671757,875671861,104,40,164,3.6140350877192984
593,4,4,0,875671861,875671890,29,164,723,3.5384615384615383
593,4,3,-1,875671890,875671891,1,723,158,2.7027027027027026
593,3,2,-1,875671891,875671951,60,158,761,3.0588235294117645
593,2,3,1,875671951,875671982,31,761,1221,3.4285714285714284
593,3,5,2,875671982,875672874,892,1221,241,3.5625
593,5,2,-3,875672874,875672949,75,241,949,3.392857142857143
593,2,3,1,875672949,875672999,50,949,451,3.207792207792208
593,3,3,0,875672999,875673098,99,451,8,3.903225806451613
593,3,2,-1,875673098,875673181,83,8,210,3.921259842519685
593,2,4,2,875673181,876506731,833550,210,131,3.731707317073171
593,4,3,-1,876506731,877727961,1221230,131,1012,3.2916666666666665
593,3,1,-2,877727961,877727988,27,1012,293,3.630434782608696
593,1,2,1,877727988,886193129,8465141,293,285,4.181818181818182
593,2,4,2,886193129,886193303,174,285,143,3.56
593,4,4,0,886193303,886193379,76,143,172,4.225225225225225
593,4,3,-1,886193379,886193438,59,172,468,3.380952380952381
593,3,4,1,886193438,886193600,162,468,735,3.58
593,4,2,-2,886193600,886193627,27,735,182,3.842857142857143
593,2,2,0,886193627,886193661,34,182,501,3.289473684210526
593,2,3,1,886193661,886193724,63,501,655,3.7857142857142856
593,3,5,2,886193724,886193788,64,655,966,4.7
593,5,5,0,886193788,886194064,276,966,83,4.204081632653061
593,5,3,-2,886194064,886194241,177,83,609,3.7058823529411766
593,3,4,1,886194241,888871903,2677662,609,313,4.323076923076923
593,4,4,0,888871903,888872002,99,313,742,3.5555555555555554
583,4,4,0,879384094,879384404,310,258,198,4.04
583,4,5,1,879384404,879384471,67,198,175,3.8354430379746836
583,5,5,0,879384471,879384522,51,175,524,4.166666666666667
583,5,5,0,879384522,879384575,53,524,357,4.063291139240507
596,4,3,-1,883538847,883538965,118,288,678,2.8181818181818183
596,3,3,0,883538965,883539011,46,678,258,3.7547169811320753
596,3,3,0,883539011,883539049,38,258,895,3.142857142857143
596,3,3,0,883539049,883539079,30,895,289,2.988888888888889
596,3,5,2,883539079,883539103,24,289,328,3.4895833333333335
596,5,4,-1,883539103,883539173,70,328,682,3.0476190476190474
596,4,4,0,883539173,883539431,258,682,181,3.98974358974359
570,3,5,2,881262189,881262256,67,258,303,3.75
570,5,3,-2,881262256,881262307,51,303,690,3.260869565217391
570,3,3,0,881262307,881262404,97,690,301,3.2465753424657535
570,3,1,-2,881262404,881262437,33,301,326,3.262295081967213
570,1,1,0,881262437,881262497,60,326,289,2.988888888888889
570,1,2,1,881262497,881262534,37,289,886,2.857142857142857
570,2,2,0,881262534,881262582,48,886,358,2.6551724137931036
570,2,4,2,881262582,881262625,43,358,286,3.442857142857143
570,4,2,-2,881262625,881262795,170,286,879,3.2291666666666665
599,4,1,-3,880951079,880951113,34,682,260,2.4716981132075473
599,1,4,3,880951113,880951144,31,260,748,3.1043478260869564
599,4,4,0,880951144,880951211,67,748,988,2.5555555555555554
599,4,2,-2,880951211,880951439,228,988,276,3.6036036036036037
599,2,5,3,880951439,880951479,40,276,220,3.433333333333333
599,5,5,0,880951479,880951595,116,220,237,3.7315436241610738
599,5,4,-1,880951595,880951623,28,237,1152,3.4375
599,4,4,0,880951623,880951657,34,1152,1,3.902439024390244
599,4,4,0,880951657,880951743,86,1,1315,3.4444444444444446
599,4,4,0,880951743,880951885,142,1315,1014,3.1
599,4,5,1,880951885,880951974,89,1014,845,3.661290322580645
599,5,5,0,880951974,880952037,63,845,756,2.6885245901639343
599,5,5,0,880952037,880952144,107,756,595,2.9166666666666665
599,5,5,0,880952144,880952185,41,595,1278,3.8333333333333335
599,5,5,0,880952185,880952229,44,1278,280,3.103448275862069
599,5,5,0,880952229,880952316,87,280,763,3.347826086956522
599,5,5,0,880952316,880952357,41,763,975,3.411764705882353
599,5,4,-1,880952357,880952496,139,975,1277,3.5555555555555554
589,1,4,3,883352402,883352536,134,307,332,3.6511627906976742
589,4,1,-3,883352536,883352562,26,332,995,3.0
589,1,5,4,883352562,883352599,37,995,304,3.5306122448979593
589,5,3,-2,883352599,883352631,32,304,322,3.0476190476190474
589,3,4,1,883352631,883352654,23,322,879,3.2291666666666665
589,4,4,0,883352654,883352707,53,879,688,2.111111111111111
589,4,4,0,883352707,883352735,28,688,678,2.8181818181818183
589,4,4,0,883352735,883352762,27,678,892,2.9615384615384617
589,4,4,0,883352762,883352787,25,892,689,3.1538461538461537
594,3,2,-1,874780909,874780945,36,245,988,2.5555555555555554
594,2,3,1,874780945,874781004,59,988,19,3.9615384615384617
594,3,3,0,874781004,874781076,72,19,181,3.98974358974359
594,3,4,1,874781076,874781173,97,181,14,4.101694915254237
594,4,4,0,874781173,874783052,1879,14,15,3.725663716814159
594,4,3,-1,874783052,874783470,418,15,276,3.6036036036036037
594,3,3,0,874783470,874786695,3225,276,483,4.475609756097561
597,1,4,3,875339083,875339132,49,326,688,2.111111111111111
597,4,4,0,875339132,875339156,24,688,264,2.65
597,4,4,0,875339156,875339876,720,264,1152,3.4375
597,4,5,1,875339876,875339970,94,1152,477,3.1666666666666665
597,5,2,-3,875339970,875340010,40,477,713,3.5
597,2,4,2,875340010,875340062,52,713,181,3.98974358974359
597,4,3,-1,875340062,875340117,55,181,295,3.769230769230769
597,3,4,1,875340117,875340191,74,295,763,3.347826086956522
597,4,5,1,875340191,875341758,1567,763,15,3.725663716814159
597,5,3,-2,875341758,875341858,100,15,24,3.3728813559322033
597,3,4,1,875341858,875342355,497,24,1016,3.559322033898305
597,4,3,-1,875342355,875343067,712,1016,936,3.727272727272727
578,5,3,-2,887229355,887229503,148,313,751,3.3896103896103895
578,3,3,0,887229503,887229523,20,751,245,3.056179775280899
578,3,4,1,887229523,888957584,1728061,245,298,3.779220779220779
578,4,4,0,888957584,888957666,82,298,1016,3.559322033898305
578,4,1,-3,888957666,888957735,69,1016,324,3.2291666666666665
578,1,1,0,888957735,888957758,23,324,355,2.75
578,1,4,3,888957758,888957788,30,355,222,3.578125
578,4,2,-2,888957788,890939753,1981965,222,1098,3.533333333333333
578,2,3,1,890939753,890939815,62,1098,1264,3.5
601,4,1,-3,876346383,876346515,132,324,294,3.1052631578947367
601,1,4,3,876346515,876346757,242,294,100,4.0162162162162165
601,4,4,0,876346757,876346810,53,100,127,4.162790697674419
601,4,4,0,876346810,876346890,80,127,276,3.6036036036036037
601,4,3,-1,876346890,876346930,40,276,151,3.6544117647058822
601,3,4,1,876346930,876346964,34,151,508,3.6923076923076925
601,4,5,1,876346964,876347039,75,508,181,3.98974358974359
601,5,3,-2,876347039,876347113,74,181,21,2.9210526315789473
601,3,4,1,876347113,876347196,83,21,740,3.423076923076923
601,4,2,-2,876347196,876347224,28,740,257,3.7154471544715446
601,2,1,-1,876347224,876347320,96,257,125,3.5555555555555554
601,1,4,3,876347320,876347523,203,125,284,3.1547619047619047
601,4,2,-2,876347523,876347599,76,284,840,3.090909090909091
601,2,3,1,876347599,876347665,66,840,473,2.9166666666666665
601,3,4,1,876347665,876348107,442,473,1615,3.5
601,4,3,-1,876348107,876348140,33,1615,148,3.2131147540983607
601,3,1,-2,876348140,876348215,75,148,287,3.4516129032258065
601,1,1,0,876348215,876348316,101,287,820,3.0444444444444443
601,1,1,0,876348316,876348381,65,820,834,2.0
601,1,1,0,876348381,876348410,29,834,743,1.9545454545454546
601,1,4,3,876348410,876348526,116,743,178,4.378378378378378
601,4,4,0,876348526,876348572,46,178,318,4.5046728971962615
601,4,4,0,876348572,876348782,210,318,156,4.017857142857143
601,4,2,-2,876348782,876348783,1,156,204,3.6744186046511627
601,2,1,-1,876348783,876348947,164,204,234,3.7674418604651163
601,1,3,2,876348947,876348987,40,234,69,3.8015873015873014
601,3,4,1,876348987,876349150,163,69,357,4.063291139240507
601,4,5,1,876349150,876349251,101,357,91,3.6
601,5,4,-1,876349251,876349302,51,91,496,4.094594594594595
601,4,4,0,876349302,876349358,56,496,479,4.25
601,4,5,1,876349358,876349387,29,479,429,3.742857142857143
601,5,5,0,876349387,876349503,116,429,201,3.75
601,5,3,-2,876349503,876349542,39,201,47,3.5869565217391304
601,3,3,0,876349542,876349577,35,47,56,4.051724137931035
601,3,1,-2,876349577,876349897,320,56,623,3.0454545454545454
601,1,1,0,876349897,876349937,40,623,71,3.6575342465753424
601,1,4,3,876349937,876350016,79,71,191,4.168674698795181
601,4,2,-2,876350016,876350017,1,191,1540,3.25
601,2,5,3,876350017,876350104,87,1540,132,3.929411764705882
601,5,4,-1,876350104,876350142,38,132,584,3.5238095238095237
601,4,2,-2,876350142,876350185,43,584,96,3.9130434782608696
601,2,3,1,876350185,876350230,45,96,184,3.393939393939394
601,3,3,0,876350230,876350501,271,184,290,3.108108108108108
601,3,3,0,876350501,876350536,35,290,99,3.8392857142857144
601,3,2,-1,876350536,876350537,1,99,389,3.272727272727273
601,2,4,2,876350537,876350583,46,389,230,3.3518518518518516
601,4,4,0,876350583,876350652,69,230,241,3.5625
601,4,3,-1,876350652,876350683,31,241,416,3.3846153846153846
601,3,3,0,876350683,876350719,36,416,588,3.8358208955223883
601,3,3,0,876350719,876350812,93,588,365,2.95
601,3,4,1,876350812,876350875,63,365,164,3.6140350877192984
601,4,5,1,876350875,876350944,69,164,168,4.0476190476190474
601,5,2,-3,876350944,876351041,97,168,378,3.6904761904761907
601,2,5,3,876351041,876351214,173,378,921,3.611111111111111
601,5,1,-4,876351214,876351264,50,921,673,3.393939393939394
601,1,1,0,876351264,876351298,34,673,140,3.238095238095238
601,1,4,3,876351298,876351413,115,140,431,3.422222222222222
602,4,4,0,888637925,888637965,40,880,358,2.6551724137931036
602,4,5,1,888637965,888637987,22,358,294,3.1052631578947367
602,5,4,-1,888637987,888638022,35,294,304,3.5306122448979593
602,4,4,0,888638022,888638048,26,304,538,3.25
602,4,4,0,888638048,888638160,112,538,259,2.492063492063492
602,4,4,0,888638160,888638193,33,259,678,2.8181818181818183
602,4,3,-1,888638193,888638248,55,678,261,2.7333333333333334
602,3,3,0,888638248,888638277,29,261,243,2.357142857142857
602,3,3,0,888638277,888638305,28,243,457,1.7
602,3,4,1,888638305,888638434,129,457,121,3.521212121212121
602,4,5,1,888638434,888638460,26,121,50,4.306532663316583
602,5,4,-1,888638460,888638490,30,50,9,3.8878504672897196
602,4,5,1,888638490,888638491,1,9,127,4.162790697674419
602,5,4,-1,888638491,888638517,26,127,148,3.2131147540983607
602,4,4,0,888638517,888638547,30,148,1,3.902439024390244
602,4,3,-1,888638547,888638618,71,1,508,3.6923076923076925
602,3,3,0,888638618,888638703,85,508,118,3.2764227642276422
600,5,4,-1,888451492,888451582,90,515,684,3.847826086956522
600,4,4,0,888451582,888451664,82,684,530,4.125
600,4,3,-1,888451664,888451665,1,530,92,3.7142857142857144
600,3,4,1,888451665,888451750,85,92,188,3.625
600,4,2,-2,888451750,888451839,89,188,578,3.066666666666667
600,2,3,1,888451839,888451840,1,578,229,3.185185185185185
600,3,3,0,888451840,888451908,68,229,431,3.422222222222222
600,3,3,0,888451908,888452152,244,431,1188,2.45
600,3,3,0,888452152,888452491,339,1188,38,2.784313725490196
600,3,4,1,888452491,888452563,72,38,53,2.9523809523809526
600,4,2,-2,888452563,888453083,520,53,586,2.875
600,2,4,2,888453083,888453144,61,586,450,2.2758620689655173
600,4,2,-2,888453144,888453145,1,450,1274,1.8
605,4,5,1,879365132,879365158,26,340,288,3.5214285714285714
605,5,3,-2,879365158,879365237,79,288,301,3.2465753424657535
605,3,4,1,879365237,879365417,180,301,260,2.4716981132075473
605,4,4,0,879365417,879365773,356,260,276,3.6036036036036037
605,4,3,-1,879365773,879366256,483,276,293,3.630434782608696
605,3,1,-2,879366256,879424345,58089,293,143,3.56
605,1,3,2,879424345,879424369,24,143,475,3.956043956043956
605,3,4,1,879424369,879424429,60,475,527,3.823529411764706
605,4,3,-1,879424429,879424452,23,527,210,3.921259842519685
605,3,4,1,879424452,879424548,96,210,22,4.215909090909091
605,4,5,1,879424548,879424600,52,22,496,4.094594594594595
605,5,4,-1,879424600,879424661,61,496,582,3.7457627118644066
605,4,3,-1,879424661,879424680,19,582,70,3.5833333333333335
605,3,5,2,879424680,879424743,63,70,521,3.787878787878788
605,5,1,-4,879424743,879424783,40,521,238,3.888888888888889
605,1,4,3,879424783,879424784,1,238,153,3.7865168539325844
605,4,3,-1,879424784,879425457,673,153,754,3.5789473684210527
605,3,2,-1,879425457,879425689,232,754,1040,2.2666666666666666
605,2,4,2,879425689,879425706,17,1040,934,3.0294117647058822
605,4,3,-1,879425706,879426163,457,934,215,3.662921348314607
605,3,5,2,879426163,879426212,49,215,191,4.168674698795181
605,5,5,0,879426212,879426339,127,191,601,3.857142857142857
605,5,5,0,879426339,879426371,32,601,526,3.909090909090909
605,5,5,0,879426371,879427164,793,526,949,3.392857142857143
605,5,2,-3,879427164,879510904,83740,949,255,3.2027027027027026
605,2,4,2,879510904,879510953,49,255,252,2.911392405063291
605,4,4,0,879510953,880762205,1251252,252,619,3.4782608695652173
605,4,5,1,880762205,880762240,35,619,126,3.8620689655172415
605,5,5,0,880762240,881015099,252859,126,223,4.108695652173913
605,5,5,0,881015099,881016176,1077,223,462,3.7954545454545454
603,5,5,0,891955991,891956058,67,12,1240,3.5454545454545454
603,5,5,0,891956058,891956075,17,1240,7,3.76056338028169
603,5,5,0,891956075,891956091,16,7,313,4.323076923076923
603,5,1,-4,891956091,891956124,33,313,273,3.5238095238095237
603,1,5,4,891956124,891956139,15,273,172,4.225225225225225
603,5,5,0,891956139,891956154,15,172,181,3.98974358974359
603,5,5,0,891956154,891956173,19,181,250,3.4698795180722892
603,5,4,-1,891956173,891956242,69,250,751,3.3896103896103895
603,4,5,1,891956242,891956283,41,751,1483,3.25
603,5,5,0,891956283,891956302,19,1483,748,3.1043478260869564
603,5,4,-1,891956302,891956330,28,748,294,3.1052631578947367
603,4,4,0,891956330,891956529,199,294,988,2.5555555555555554
603,4,3,-1,891956529,891956715,186,988,21,2.9210526315789473
603,3,4,1,891956715,891956776,61,21,22,4.215909090909091
603,4,5,1,891956776,891956825,49,22,89,3.9615384615384617
603,5,3,-2,891956825,891956897,72,89,747,3.5526315789473686
603,3,5,2,891956897,891956927,30,747,11,3.8904109589041096
603,5,4,-1,891956927,891956946,19,11,180,3.9473684210526314
603,4,5,1,891956946,891956981,35,180,429,3.742857142857143
603,5,4,-1,891956981,891957012,31,429,385,3.6129032258064515
603,4,1,-3,891957012,891957031,19,385,157,3.5714285714285716
603,1,4,3,891957031,891957053,22,157,56,4.051724137931035
603,4,4,0,891957053,891957110,57,56,210,3.921259842519685
603,4,4,0,891957110,891957139,29,210,216,3.8454545454545452
595,3,3,0,886920602,886920632,30,288,324,3.2291666666666665
595,3,2,-1,886920632,886920655,23,324,748,3.1043478260869564
595,2,3,1,886920655,886920774,119,748,325,2.625
595,3,3,0,886920774,886920919,145,325,948,2.2962962962962963
595,3,2,-1,886920919,886920966,47,948,336,2.4
595,2,4,2,886920966,886921036,70,336,922,4.0
595,4,4,0,886921036,886921068,32,922,246,4.0
595,4,3,-1,886921068,886921088,20,246,129,3.744186046511628
595,3,2,-1,886921088,886921140,52,129,676,3.3142857142857145
595,2,4,2,886921140,886921166,26,676,275,4.087912087912088
595,4,5,1,886921166,886921199,33,275,127,4.162790697674419
595,5,5,0,886921199,886921223,24,127,14,4.101694915254237
595,5,3,-2,886921223,886921274,51,14,222,3.578125
595,3,4,1,886921274,886921344,70,222,1059,2.764705882352941
595,4,2,-2,886921344,886921365,21,1059,109,3.282608695652174
595,2,4,2,886921365,886921423,58,109,15,3.725663716814159
595,4,5,1,886921423,886921424,1,15,952,3.3529411764705883
595,5,3,-2,886921424,886921448,24,952,845,3.661290322580645
595,3,3,0,886921448,886921475,27,845,1028,2.857142857142857
595,3,2,-1,886921475,886921521,46,1028,742,3.5555555555555554
595,2,2,0,886921521,886921550,29,742,121,3.521212121212121
595,2,3,1,886921550,886921551,1,121,763,3.347826086956522
595,3,4,1,886921551,886921584,33,763,1009,3.2962962962962963
595,4,2,-2,886921584,886921606,22,1009,825,2.914285714285714
595,2,3,1,886921606,886921656,50,825,291,3.2
595,3,3,0,886921656,886921699,43,291,544,3.185185185185185
595,3,2,-1,886921699,886921722,23,544,929,2.8421052631578947
595,2,1,-1,886921722,886921748,26,929,1165,1.8
595,1,3,2,886921748,886921787,39,1165,1312,2.8333333333333335
595,3,3,0,886921787,886921820,33,1312,928,3.142857142857143
595,3,1,-2,886921820,886921897,77,928,926,2.7857142857142856
595,1,2,1,886921897,886921945,48,926,871,2.3823529411764706
595,2,3,1,886921945,886921977,32,871,369,2.5714285714285716
595,3,4,1,886921977,886922069,92,369,293,3.630434782608696
606,3,4,1,877642127,877642209,82,678,323,3.0
606,4,4,0,877642209,878142865,500656,323,93,3.5641025641025643
606,4,5,1,878142865,878143047,182,93,181,3.98974358974359
606,5,4,-1,878143047,878143247,200,181,477,3.1666666666666665
606,4,5,1,878143247,878143605,358,477,293,3.630434782608696
606,5,4,-1,878143605,878143729,124,293,628,3.573529411764706
606,4,4,0,878143729,878143785,56,628,475,3.956043956043956
606,4,3,-1,878143785,878147770,3985,475,222,3.578125
606,3,4,1,878147770,878148425,655,222,121,3.521212121212121
606,4,3,-1,878148425,878148493,68,121,1277,3.5555555555555554
606,3,4,1,878148493,878149415,922,1277,596,3.180327868852459
606,4,4,0,878149415,880922148,2772733,596,281,3.2
606,4,4,0,880922148,880922565,417,281,619,3.4782608695652173
606,4,3,-1,880922565,880922625,60,619,827,2.4375
606,3,4,1,880922625,880923689,1064,827,507,3.6285714285714286
606,4,4,0,880923689,880923690,1,507,1055,3.125
606,4,5,1,880923690,880923745,55,1055,418,3.825
606,5,5,0,880923745,880923862,117,418,200,3.8157894736842106
606,5,5,0,880923862,880923925,63,200,176,3.967032967032967
606,5,4,-1,880923925,880923989,64,176,421,3.462962962962963
606,4,4,0,880923989,880924106,117,421,427,4.2025316455696204
606,4,4,0,880924106,880924188,82,427,95,3.8194444444444446
606,4,5,1,880924188,880924323,135,95,1065,3.1578947368421053
606,5,5,0,880924323,880924483,160,1065,56,4.051724137931035
606,5,5,0,880924483,880924557,74,56,168,4.0476190476190474
606,5,3,-2,880924557,880924663,106,168,647,4.142857142857143
606,3,4,1,880924663,880924789,126,647,156,4.017857142857143
606,4,4,0,880924789,880924790,1,156,527,3.823529411764706
606,4,5,1,880924790,880924859,69,527,173,4.1441441441441444
606,5,4,-1,880924859,880924921,62,173,202,3.730337078651685
606,4,5,1,880924921,880925074,153,202,96,3.9130434782608696
606,5,4,-1,880925074,880925199,125,96,194,4.029411764705882
606,4,4,0,880925199,880925289,90,194,1149,3.857142857142857
606,4,5,1,880925289,880925290,1,1149,186,3.905263157894737
606,5,5,0,880925290,880925394,104,186,746,3.7560975609756095
606,5,5,0,880925394,880925579,185,746,216,3.8454545454545452
606,5,2,-3,880925579,880926084,505,216,230,3.3518518518518516
606,2,5,3,880926084,880926162,78,230,195,3.9072164948453607
606,5,3,-2,880926162,880926245,83,195,42,3.893617021276596
606,3,3,0,880926245,880926246,1,42,241,3.5625
606,3,5,2,880926246,880926339,93,241,432,3.719298245614035
606,5,5,0,880926339,880926470,131,432,660,3.71875
606,5,3,-2,880926470,880926700,230,660,153,3.7865168539325844
606,3,3,0,880926700,880926759,59,153,185,3.9726027397260273
606,3,4,1,880926759,880926760,1,185,1518,3.142857142857143
606,4,4,0,880926760,880926861,101,1518,187,4.215189873417722
606,4,4,0,880926861,880926862,1,187,549,3.4871794871794872
606,4,4,0,880926862,880926994,132,549,161,3.5844155844155843
606,4,4,0,880926994,880927179,185,161,238,3.888888888888889
606,4,4,0,880927179,880927247,68,238,729,3.3793103448275863
606,4,5,1,880927247,880927357,110,729,22,4.215909090909091
606,5,2,-3,880927357,880927358,1,22,816,2.0
606,2,4,2,880927358,880927417,59,816,201,3.75
606,4,4,0,880927417,880927468,51,201,747,3.5526315789473686
606,4,5,1,880927468,880927552,84,747,179,3.8823529411764706
606,5,4,-1,880927552,880927665,113,179,198,4.04
606,4,3,-1,880927665,880927666,1,198,63,3.125
606,3,3,0,880927666,880927923,257,63,138,2.6
606,3,2,-1,880927923,880928181,258,138,951,2.6666666666666665
606,2,4,2,880928181,887058788,6130607,951,258,3.7547169811320753
606,4,5,1,887058788,887060488,1700,258,763,3.347826086956522
606,5,3,-2,887060488,889137292,2076804,763,1151,2.6666666666666665
606,3,3,0,889137292,889137308,16,1151,1190,3.4285714285714284
608,1,3,2,880402327,880402368,41,300,262,3.5217391304347827
608,3,2,-1,880402368,880402450,82,262,327,3.5076923076923077
608,2,1,-1,880402450,880402564,114,327,886,2.857142857142857
608,1,2,1,880402564,880402633,69,886,321,3.0172413793103448
608,2,4,2,880402633,880402983,350,321,319,3.0408163265306123
608,4,4,0,880402983,880403055,72,319,187,4.215189873417722
608,4,4,0,880403055,880403280,225,187,100,4.0162162162162165
608,4,5,1,880403280,880403320,40,100,514,4.033333333333333
608,5,3,-2,880403320,880403388,68,514,166,4.0
608,3,4,1,880403388,880403484,96,166,499,4.0
608,4,3,-1,880403484,880403537,53,499,611,4.384615384615385
608,3,3,0,880403537,880403606,69,611,478,4.161290322580645
608,3,4,1,880403606,880403690,84,478,848,4.0
608,4,1,-3,880403690,880403765,75,848,50,4.306532663316583
608,1,5,4,880403765,880403810,45,50,238,3.888888888888889
608,5,1,-4,880403810,880403855,45,238,509,3.7058823529411766
608,1,4,3,880403855,880403856,1,509,517,3.625
608,4,3,-1,880403856,880403899,43,517,507,3.6285714285714286
608,3,5,2,880403899,880404693,794,507,61,4.190476190476191
608,5,5,0,880404693,880404847,154,61,234,3.7674418604651163
608,5,2,-3,880404847,880404975,128,234,276,3.6036036036036037
608,2,4,2,880404975,880405165,190,276,64,4.373737373737374
608,4,5,1,880405165,880405431,266,64,197,4.112676056338028
608,5,2,-3,880405431,880405484,53,197,8,3.903225806451613
608,2,5,3,880405484,880405527,43,8,317,3.774193548387097
608,5,5,0,880405527,880405565,38,317,695,3.0
608,5,3,-2,880405565,880405659,94,695,97,3.7282608695652173
608,3,4,1,880405659,880405702,43,97,69,3.8015873015873014
608,4,4,0,880405702,880405863,161,69,1101,3.793103448275862
608,4,4,0,880405863,880405896,33,1101,939,3.6333333333333333
608,4,3,-1,880405896,880405971,75,939,789,3.7777777777777777
608,3,4,1,880405971,880406032,61,789,131,3.731707317073171
608,4,5,1,880406032,880406095,63,131,1262,5.0
608,5,3,-2,880406095,880406168,73,1262,4,3.5538461538461537
608,3,5,2,880406168,880406469,301,4,65,3.511111111111111
608,5,3,-2,880406469,880406470,1,65,265,3.710144927536232
608,3,4,1,880406470,880406507,37,265,461,3.3333333333333335
608,4,4,0,880406507,880406552,45,461,462,3.7954545454545454
608,4,4,0,880406552,880406593,41,462,508,3.6923076923076925
608,4,4,0,880406593,880406623,30,508,283,3.901639344262295
608,4,4,0,880406623,880406727,104,283,423,3.7016129032258065
608,4,4,0,880406727,880406799,72,423,735,3.58
608,4,2,-2,880406799,880406800,1,735,1221,3.4285714285714284
608,2,1,-1,880406800,880406862,62,1221,702,2.764705882352941
608,1,2,1,880406862,880406950,88,702,16,3.411764705882353
608,2,4,2,880406950,880407079,129,16,729,3.3793103448275863
607,4,4,0,883879316,883879379,63,100,483,4.475609756097561
607,4,3,-1,883879379,883879516,137,483,174,4.253521126760563
607,3,5,2,883879516,883879556,40,174,511,4.096153846153846
607,5,3,-2,883879556,883879613,57,511,222,3.578125
607,3,4,1,883879613,883879638,25,222,847,3.7333333333333334
607,4,3,-1,883879638,883879691,53,847,950,2.625
607,3,4,1,883879691,883879811,120,950,475,3.956043956043956
607,4,3,-1,883879811,883880052,241,475,212,3.230769230769231
607,3,4,1,883880052,883880079,27,212,45,4.130434782608695
607,4,4,0,883880079,883880110,31,45,462,3.7954545454545454
607,4,5,1,883880110,883880155,45,462,56,4.051724137931035
607,5,4,-1,883880155,883880180,25,56,30,3.8181818181818183
610,3,4,1,888702795,888702815,20,288,272,4.2
610,4,4,0,888702815,888702841,26,272,750,4.027777777777778
610,4,3,-1,888702841,888702859,18,750,79,3.956989247311828
610,3,5,2,888702859,888702902,43,79,98,4.240875912408759
610,5,4,-1,888702902,888702961,59,98,50,4.306532663316583
610,4,5,1,888702961,888702962,1,50,480,4.283018867924528
610,5,2,-3,888702962,888703137,175,480,7,3.76056338028169
610,2,4,2,888703137,888703157,20,7,176,3.967032967032967
610,4,4,0,888703157,888703213,56,176,187,4.215189873417722
610,4,5,1,888703213,888703241,28,187,419,3.8208955223880596
610,5,4,-1,888703241,888703258,17,419,28,3.923076923076923
610,4,5,1,888703258,888703290,32,28,143,3.56
610,5,4,-1,888703290,888703291,1,143,216,3.8454545454545452
610,4,1,-3,888703291,888703343,52,216,204,3.6744186046511627
610,1,3,2,888703343,888703360,17,204,735,3.58
610,3,5,2,888703360,888703378,18,735,318,4.5046728971962615
610,5,4,-1,888703378,888703432,54,318,11,3.8904109589041096
610,4,3,-1,888703432,888703453,21,11,97,3.7282608695652173
610,3,3,0,888703453,888703475,22,97,1558,3.0
610,3,2,-1,888703475,888703507,32,1558,699,3.736842105263158
610,2,5,3,888703507,888703523,16,699,51,3.5277777777777777
610,5,4,-1,888703523,888703537,14,51,505,4.0625
610,4,3,-1,888703537,888703553,16,505,317,3.774193548387097
610,3,3,0,888703553,888703583,30,317,195,3.9072164948453607
610,3,4,1,888703583,888703609,26,195,70,3.5833333333333335
610,4,3,-1,888703609,888703629,20,70,508,3.6923076923076925
610,3,4,1,888703629,888703648,19,508,133,3.7777777777777777
610,4,3,-1,888703648,888703730,82,133,135,3.7974683544303796
610,3,4,1,888703730,888703749,19,135,203,3.826923076923077
610,4,4,0,888703749,888703766,17,203,276,3.6036036036036037
610,4,4,0,888703766,888703801,35,276,527,3.823529411764706
610,4,5,1,888703801,888703815,14,527,485,3.717948717948718
610,5,4,-1,888703815,888704000,185,485,117,3.689189189189189
611,5,5,0,891636073,891636098,25,302,272,4.2
611,5,4,-1,891636098,891636125,27,272,680,2.8333333333333335
611,4,3,-1,891636125,891636152,27,680,896,3.6666666666666665
611,3,4,1,891636152,891636192,40,896,882,3.6666666666666665
611,4,5,1,891636192,891636222,30,882,750,4.027777777777778
611,5,5,0,891636222,891636223,1,750,752,3.6666666666666665
611,5,3,-2,891636223,891636244,21,752,1243,3.6666666666666665
611,3,3,0,891636244,891636399,155,1243,324,3.2291666666666665
617,1,4,3,883788566,883788730,164,288,1021,3.8666666666666667
617,4,3,-1,883788730,883788782,52,1021,515,4.202898550724638
617,3,2,-1,883788782,883788859,77,515,531,3.7435897435897436
617,2,3,1,883788859,883788929,70,531,606,4.294117647058823
617,3,1,-2,883788929,883789006,77,606,132,3.929411764705882
617,1,4,3,883789006,883789042,36,132,427,4.2025316455696204
617,4,3,-1,883789042,883789079,37,427,136,3.764705882352941
617,3,2,-1,883789079,883789080,1,136,98,4.240875912408759
617,2,3,1,883789080,883789105,25,98,519,4.291666666666667
617,3,4,1,883789105,883789179,74,519,480,4.283018867924528
617,4,3,-1,883789179,883789212,33,480,429,3.742857142857143
617,3,3,0,883789212,883789249,37,429,238,3.888888888888889
617,3,1,-2,883789249,883789294,45,238,423,3.7016129032258065
617,1,5,4,883789294,883789424,130,423,320,4.75
617,5,4,-1,883789424,883789425,1,320,100,4.0162162162162165
617,4,1,-3,883789425,883789464,39,100,184,3.393939393939394
617,1,3,2,883789464,883789507,43,184,637,2.888888888888889
617,3,4,1,883789507,883789536,29,637,219,2.735294117647059
617,4,1,-3,883789536,883789537,1,219,569,2.4285714285714284
617,1,2,1,883789537,883789590,53,569,446,2.0
617,2,1,-1,883789590,883789635,45,446,860,1.8
617,1,1,0,883789635,883789664,29,860,164,3.6140350877192984
617,1,1,0,883789664,883789715,51,164,453,2.0
617,1,1,0,883789715,883789716,1,453,145,2.3636363636363638
617,1,1,0,883789716,883789747,31,145,563,2.0
618,4,3,-1,891306990,891306991,1,64,684,3.847826086956522
618,3,2,-1,891306991,891307019,28,684,497,3.35
618,2,4,2,891307019,891307175,156,497,56,4.051724137931035
618,4,4,0,891307175,891307224,49,56,186,3.905263157894737
618,4,5,1,891307224,891307263,39,186,181,3.98974358974359
618,5,3,-2,891307263,891307289,26,181,282,3.610526315789474
618,3,4,1,891307289,891307343,54,282,131,3.731707317073171
618,4,3,-1,891307343,891307404,61,131,173,4.1441441441441444
618,3,4,1,891307404,891307426,22,173,176,3.967032967032967
618,4,5,1,891307426,891307494,68,176,98,4.240875912408759
618,5,3,-2,891307494,891307495,1,98,70,3.5833333333333335
618,3,4,1,891307495,891307619,124,70,496,4.094594594594595
618,4,3,-1,891307619,891307646,27,496,485,3.717948717948718
618,3,4,1,891307646,891307714,68,485,234,3.7674418604651163
618,4,3,-1,891307714,891307749,35,234,96,3.9130434782608696
618,3,1,-2,891307749,891307784,35,96,962,3.142857142857143
618,1,3,2,891307784,891307862,78,962,8,3.903225806451613
618,3,4,1,891307862,891307889,27,8,196,3.9404761904761907
618,4,3,-1,891307889,891307931,42,196,87,3.9
618,3,2,-1,891307931,891307977,46,87,676,3.3142857142857145
618,2,3,1,891307977,891308019,42,676,99,3.8392857142857144
618,3,3,0,891308019,891308115,96,99,218,3.5555555555555554
618,3,3,0,891308115,891308141,26,218,9,3.8878504672897196
618,3,2,-1,891308141,891308175,34,9,150,3.803921568627451
618,2,4,2,891308175,891308176,1,150,69,3.8015873015873014
618,4,5,1,891308176,891308199,23,69,483,4.475609756097561
618,5,2,-3,891308199,891308260,61,483,25,3.3185840707964602
618,2,3,1,891308260,891308261,1,25,550,3.272727272727273
618,3,4,1,891308261,891308296,35,550,506,3.566666666666667
618,4,5,1,891308296,891308342,46,506,168,4.0476190476190474
618,5,4,-1,891308342,891308390,48,168,22,4.215909090909091
618,4,1,-3,891308390,891308391,1,22,238,3.888888888888889
618,1,4,3,891308391,891308432,41,238,193,3.883720930232558
618,4,3,-1,891308432,891308459,27,193,1063,3.642857142857143
618,3,3,0,891308459,891308515,56,1063,778,3.5925925925925926
618,3,1,-2,891308515,891308542,27,778,1071,3.0
618,1,3,2,891308542,891308571,29,1071,735,3.58
618,3,3,0,891308571,891308615,44,735,421,3.462962962962963
618,3,3,0,891308615,891308665,50,421,468,3.380952380952381
618,3,3,0,891308665,891308703,38,468,210,3.921259842519685
618,3,2,-1,891308703,891308791,88,210,477,3.1666666666666665
618,2,2,0,891308791,891308854,63,477,925,3.0
618,2,4,2,891308854,891308884,30,925,501,3.289473684210526
618,4,4,0,891308884,891308913,29,501,121,3.521212121212121
618,4,3,-1,891308913,891308945,32,121,729,3.3793103448275863
618,3,5,2,891308945,891308979,34,729,432,3.719298245614035
618,5,3,-2,891308979,891308980,1,432,371,3.0
618,3,3,0,891308980,891309041,61,371,164,3.6140350877192984
618,3,4,1,891309041,891309065,24,164,596,3.180327868852459
618,4,3,-1,891309065,891309114,49,596,1058,3.6
618,3,3,0,891309114,891309139,25,1058,673,3.393939393939394
618,3,3,0,891309139,891309163,24,673,420,3.5652173913043477
618,3,2,-1,891309163,891309192,29,420,1032,2.7142857142857144
618,2,4,2,891309192,891309217,25,1032,582,3.7457627118644066
618,4,4,0,891309217,891309239,22,582,507,3.6285714285714286
618,4,3,-1,891309239,891309266,27,507,276,3.6036036036036037
618,3,3,0,891309266,891309293,27,276,720,3.2
618,3,3,0,891309293,891309319,26,720,95,3.8194444444444446
618,3,3,0,891309319,891309351,32,95,785,3.4375
618,3,2,-1,891309351,891309382,31,785,1225,2.5
618,2,4,2,891309382,891309409,27,1225,568,3.5853658536585367
618,4,4,0,891309409,891309514,105,568,378,3.6904761904761907
618,4,4,0,891309514,891309552,38,378,815,3.135135135135135
618,4,3,-1,891309552,891309579,27,815,458,3.0588235294117645
618,3,4,1,891309579,891309608,29,458,576,3.125
618,4,2,-2,891309608,891309636,28,576,1221,3.4285714285714284
618,2,2,0,891309636,891309670,34,1221,755,3.085714285714286
618,2,4,2,891309670,891309697,27,755,66,3.4705882352941178
618,4,3,-1,891309697,891309720,23,66,65,3.511111111111111
618,3,4,1,891309720,891309886,166,65,531,3.7435897435897436
618,4,4,0,891309886,891309887,1,531,28,3.923076923076923
618,4,3,-1,891309887,891309929,42,28,895,3.142857142857143
614,2,4,2,879463669,879464063,394,289,9,3.8878504672897196
614,4,4,0,879464063,879464093,30,9,508,3.6923076923076925
614,4,3,-1,879464093,879464119,26,508,1009,3.2962962962962963
614,3,3,0,879464119,879464157,38,1009,293,3.630434782608696
614,3,4,1,879464157,879464183,26,293,126,3.8620689655172415
614,4,2,-2,879464183,879464215,32,126,7,3.76056338028169
614,2,2,0,879464215,879464216,1,7,237,3.7315436241610738
614,2,4,2,879464216,879464234,18,237,276,3.6036036036036037
614,4,3,-1,879464234,879464287,53,276,279,2.75
614,3,1,-2,879464287,879464376,89,279,25,3.3185840707964602
614,1,4,3,879464376,879464398,22,25,121,3.521212121212121
614,4,3,-1,879464398,879464416,18,121,472,2.984375
614,3,3,0,879464416,879464437,21,472,410,3.0434782608695654
614,3,3,0,879464437,879464456,19,410,287,3.4516129032258065
614,3,2,-1,879464456,879464507,51,287,286,3.442857142857143
614,2,2,0,879464507,879464556,49,286,1134,2.888888888888889
614,2,2,0,879464556,879465376,820,1134,871,2.3823529411764706
614,2,2,0,879465376,879465398,22,871,841,2.772727272727273
614,2,3,1,879465398,879465452,54,841,411,2.911764705882353
609,3,5,2,886894677,886894940,263,258,287,3.4516129032258065
609,5,1,-4,886894940,886895016,76,287,147,3.3142857142857145
609,1,5,4,886895016,886895150,134,147,15,3.725663716814159
609,5,2,-3,886895150,886895346,196,15,294,3.1052631578947367
609,2,4,2,886895346,886895397,51,294,750,4.027777777777778
609,4,5,1,886895397,886895436,39,750,304,3.5306122448979593
609,5,1,-4,886895436,886895516,80,304,319,3.0408163265306123
609,1,1,0,886895516,886895699,183,319,908,2.5714285714285716
609,1,1,0,886895699,886895763,64,908,259,2.492063492063492
609,1,1,0,886895763,886895795,32,259,538,3.25
609,1,1,0,886895795,886895827,32,538,878,2.0
609,1,1,0,886895827,886895852,25,878,894,2.0
609,1,1,0,886895852,886895886,34,894,243,2.357142857142857
609,1,1,0,886895886,886895914,28,243,890,1.7692307692307692
609,1,1,0,886895914,886895941,27,890,314,1.0
609,1,1,0,886895941,886896237,296,314,1012,3.2916666666666665
615,2,4,2,879447530,879447556,26,937,262,3.5217391304347827
615,4,4,0,879447556,879447613,57,262,300,3.6861313868613137
615,4,1,-3,879447613,879447642,29,300,259,2.492063492063492
615,1,2,1,879447642,879447670,28,259,289,2.988888888888889
615,2,2,0,879447670,879447692,22,289,886,2.857142857142857
615,2,1,-1,879447692,879447713,21,886,678,2.8181818181818183
615,1,4,3,879447713,879447895,182,678,170,4.242424242424242
615,4,4,0,879447895,879447919,24,170,475,3.956043956043956
615,4,4,0,879447919,879448015,96,475,283,3.901639344262295
615,4,5,1,879448015,879448016,1,283,14,4.101694915254237
615,5,5,0,879448016,879448036,20,14,529,4.142857142857143
615,5,4,-1,879448036,879448088,52,529,855,3.590909090909091
615,4,5,1,879448088,879448119,31,855,1021,3.8666666666666667
615,5,5,0,879448119,879448149,30,1021,736,4.083333333333333
615,5,3,-2,879448149,879448182,33,736,640,2.75
615,3,4,1,879448182,879448233,51,640,26,3.36
615,4,2,-2,879448233,879448270,37,26,666,2.0
615,2,5,3,879448270,879448399,129,666,48,4.055555555555555
615,5,5,0,879448399,879448439,40,48,175,3.8354430379746836
615,5,5,0,879448439,879448475,36,175,427,4.2025316455696204
615,5,5,0,879448475,879448547,72,427,178,4.378378378378378
615,5,4,-1,879448547,879448567,20,178,1065,3.1578947368421053
615,4,5,1,879448567,879448598,31,1065,187,4.215189873417722
615,5,4,-1,879448598,879448632,34,187,792,3.793103448275862
615,4,5,1,879448632,879448672,40,792,423,3.7016129032258065
615,5,3,-2,879448672,879448693,21,423,100,4.0162162162162165
615,3,4,1,879448693,879448735,42,100,526,3.909090909090909
615,4,5,1,879448735,879448759,24,526,191,4.168674698795181
615,5,5,0,879448759,879448780,21,191,192,4.090909090909091
615,5,4,-1,879448780,879448797,17,192,22,4.215909090909091
615,4,3,-1,879448797,879448823,26,22,699,3.736842105263158
615,3,4,1,879448823,879448843,20,699,237,3.7315436241610738
615,4,2,-2,879448843,879448882,39,237,708,3.3157894736842106
615,2,4,2,879448882,879448915,33,708,70,3.5833333333333335
615,4,3,-1,879448915,879449044,129,70,238,3.888888888888889
615,3,5,2,879449044,879449068,24,238,517,3.625
615,5,5,0,879449068,879449089,21,517,435,3.8933333333333335
615,5,5,0,879449089,879449110,21,435,514,4.033333333333333
615,5,5,0,879449110,879449111,1,514,428,3.744186046511628
615,5,4,-1,879449111,879449130,19,428,208,3.8125
615,4,4,0,879449130,879449184,54,208,13,3.5454545454545454
615,4,4,0,879449184,879449211,27,13,732,3.6266666666666665
616,5,3,-2,891224448,891224517,69,286,362,2.1666666666666665
616,3,4,1,891224517,891224558,41,362,303,3.75
616,4,3,-1,891224558,891224590,32,303,326,3.262295081967213
616,3,4,1,891224590,891224644,54,326,300,3.6861313868613137
616,4,4,0,891224644,891224676,32,300,258,3.7547169811320753
616,4,4,0,891224676,891224677,1,258,347,3.59375
616,4,3,-1,891224677,891224767,90,347,245,3.056179775280899
616,3,3,0,891224767,891224801,34,245,348,3.2
616,3,3,0,891224801,891224840,39,348,748,3.1043478260869564
616,3,4,1,891224840,891224864,24,748,879,3.2291666666666665
616,4,4,0,891224864,891224919,55,879,937,3.5
620,4,5,1,889986452,889986557,105,288,294,3.1052631578947367
620,5,5,0,889986557,889986580,23,294,323,3.0
620,5,3,-2,889986580,889986642,62,323,678,2.8181818181818183
620,3,3,0,889986642,889986676,34,678,243,2.357142857142857
620,3,2,-1,889986676,889986985,309,243,682,3.0476190476190474
620,2,2,0,889986985,889987073,88,682,834,2.0
620,2,4,2,889987073,889987123,50,834,237,3.7315436241610738
620,4,5,1,889987123,889987210,87,237,15,3.725663716814159
620,5,2,-3,889987210,889987255,45,15,125,3.5555555555555554
620,2,4,2,889987255,889987276,21,125,246,4.0
620,4,3,-1,889987276,889987299,23,246,147,3.3142857142857145
620,3,5,2,889987299,889987349,50,147,740,3.423076923076923
620,5,5,0,889987349,889987586,237,740,164,3.6140350877192984
620,5,3,-2,889987586,889987604,18,164,452,2.6129032258064515
620,3,4,1,889987604,889987656,52,452,379,3.35
620,4,4,0,889987656,889987657,1,379,859,2.75
620,4,5,1,889987657,889987682,25,859,145,2.3636363636363638
620,5,3,-2,889987682,889987706,24,145,706,2.3333333333333335
620,3,5,2,889987706,889987852,146,706,281,3.2
620,5,2,-3,889987852,889987875,23,281,930,2.793103448275862
620,2,4,2,889987875,889987954,79,930,820,3.0444444444444443
620,4,3,-1,889987954,889988005,51,820,625,3.25
620,3,4,1,889988005,889988036,31,625,432,3.719298245614035
620,4,5,1,889988036,889988037,1,432,627,3.3823529411764706
620,5,2,-3,889988037,889988069,32,627,91,3.6
620,2,5,3,889988069,889988121,52,91,699,3.736842105263158
620,5,5,0,889988121,889988169,48,699,755,3.085714285714286
620,5,4,-1,889988169,889988196,27,755,1503,3.25
620,4,4,0,889988196,889988232,36,1503,465,3.75
620,4,4,0,889988232,889988258,26,465,1036,3.0
620,4,3,-1,889988258,889988281,23,1036,1480,2.0
620,3,5,2,889988281,889988312,31,1480,138,2.6
571,4,3,-1,883354761,883354818,57,191,194,4.029411764705882
571,3,3,0,883354818,883354886,68,194,604,3.8181818181818183
571,3,4,1,883354886,883354940,54,604,174,4.253521126760563
571,4,4,0,883354940,883354992,52,174,462,3.7954545454545454
571,4,4,0,883354992,883355063,71,462,114,4.3478260869565215
619,2,4,2,885953574,885953600,26,333,302,4.133333333333334
619,4,2,-2,885953600,885953601,1,302,326,3.262295081967213
619,2,3,1,885953601,885953622,21,326,346,3.5128205128205128
619,3,1,-2,885953622,885953684,62,346,294,3.1052631578947367
619,1,4,3,885953684,885953743,59,294,245,3.056179775280899
619,4,4,0,885953743,885953778,35,245,127,4.162790697674419
619,4,3,-1,885953778,885953804,26,127,293,3.630434782608696
619,3,3,0,885953804,885953805,1,293,257,3.7154471544715446
619,3,3,0,885953805,885953826,21,257,405,3.25
619,3,5,2,885953826,885953827,1,405,118,3.2764227642276422
619,5,2,-3,885953827,885953850,23,118,825,2.914285714285714
619,2,3,1,885953850,885953878,28,825,323,3.0
619,3,3,0,885953878,885953931,53,323,288,3.5214285714285714
619,3,4,1,885953931,885953992,61,288,174,4.253521126760563
619,4,5,1,885953992,885954019,27,174,195,3.9072164948453607
619,5,5,0,885954019,885954053,34,195,176,3.967032967032967
619,5,3,-2,885954053,885954105,52,176,68,3.5714285714285716
619,3,5,2,885954105,885954133,28,68,226,3.378787878787879
619,5,5,0,885954133,885954134,1,226,550,3.272727272727273
619,5,5,0,885954134,885954159,25,550,403,3.298507462686567
619,5,2,-3,885954159,885954184,25,403,849,2.5625
619,2,4,2,885954184,885954185,1,849,231,2.938775510204082
619,4,2,-2,885954185,885954215,30,231,363,3.0
619,2,4,2,885954215,885954238,23,363,720,3.2
619,4,2,-2,885954238,885954341,103,720,53,2.9523809523809526
613,5,4,-1,891227204,891227236,32,64,607,4.136363636363637
613,4,5,1,891227236,891227262,26,607,530,4.125
613,5,5,0,891227262,891227298,36,530,603,4.315789473684211
613,5,5,0,891227298,891227365,67,603,258,3.7547169811320753
622,4,5,1,882590252,882590269,17,277,7,3.76056338028169
622,5,3,-2,882590269,882590291,22,7,845,3.661290322580645
622,3,4,1,882590291,882590344,53,845,1216,3.5
622,4,4,0,882590344,882590367,23,1216,24,3.3728813559322033
622,4,3,-1,882590367,882590420,53,24,742,3.5555555555555554
622,3,3,0,882590420,882590457,37,742,125,3.5555555555555554
622,3,3,0,882590457,882590485,28,125,257,3.7154471544715446
622,3,1,-2,882590485,882590670,185,257,284,3.1547619047619047
622,1,2,1,882590670,882590862,192,284,685,3.2666666666666666
622,2,4,2,882590862,882590886,24,685,405,3.25
622,4,1,-3,882590886,882590955,69,405,121,3.521212121212121
622,1,3,2,882590955,882591014,59,121,1016,3.559322033898305
622,3,4,1,882591014,882591047,33,1016,763,3.347826086956522
622,4,3,-1,882591047,882591091,44,763,532,2.7777777777777777
622,3,2,-1,882591091,882591172,81,532,106,2.8125
622,2,3,1,882591172,882591321,149,106,756,2.6885245901639343
622,3,2,-1,882591321,882591453,132,756,978,2.357142857142857
622,2,1,-1,882591453,882591582,129,978,252,2.911392405063291
622,1,2,1,882591582,882591663,81,252,1079,2.1923076923076925
622,2,3,1,882591663,882591687,24,1079,472,2.984375
622,3,2,-1,882591687,882591726,39,472,934,3.0294117647058822
622,2,2,0,882591726,882591804,78,934,977,2.473684210526316
622,2,4,2,882591804,882592041,237,977,69,3.8015873015873014
622,4,5,1,882592041,882592103,62,69,56,4.051724137931035
622,5,5,0,882592103,882592143,40,56,156,4.017857142857143
622,5,4,-1,882592143,882592178,35,156,427,4.2025316455696204
622,4,3,-1,882592178,882592217,39,427,705,3.7857142857142856
622,3,4,1,882592217,882592246,29,705,588,3.8358208955223883
622,4,5,1,882592246,882592278,32,588,207,3.4761904761904763
622,5,4,-1,882592278,882592314,36,207,153,3.7865168539325844
622,4,4,0,882592314,882592346,32,153,135,3.7974683544303796
622,4,4,0,882592346,882592383,37,135,99,3.8392857142857144
622,4,4,0,882592383,882592421,38,99,8,3.903225806451613
622,4,5,1,882592421,882592449,28,8,96,3.9130434782608696
622,5,3,-2,882592449,882592559,110,96,204,3.6744186046511627
622,3,2,-1,882592559,882592625,66,204,375,2.076923076923077
622,2,1,-1,882592625,882592643,18,375,120,2.3421052631578947
622,1,5,4,882592643,882592662,19,120,101,3.4827586206896552
622,5,5,0,882592662,882592678,16,101,737,3.12
622,5,4,-1,882592678,882592735,57,737,29,2.5714285714285716
622,4,2,-2,882592735,882592781,46,29,541,2.9473684210526314
622,2,1,-1,882592781,882592850,69,541,450,2.2758620689655173
622,1,5,4,882592850,882669391,76541,450,64,4.373737373737374
622,5,4,-1,882669391,882669414,23,64,480,4.283018867924528
622,4,5,1,882669414,882669449,35,480,98,4.240875912408759
622,5,5,0,882669449,882669468,19,98,12,4.358974358974359
622,5,4,-1,882669468,882669509,41,12,730,3.8
622,4,3,-1,882669509,882669594,85,730,31,3.642857142857143
622,3,3,0,882669594,882669645,51,31,1203,4.0
622,3,4,1,882669645,882669668,23,1203,479,4.25
622,4,4,0,882669668,882669740,72,479,11,3.8904109589041096
622,4,4,0,882669740,882669762,22,11,190,4.233333333333333
622,4,3,-1,882669762,882669784,22,190,210,3.921259842519685
622,3,5,2,882669784,882669826,42,210,172,4.225225225225225
622,5,4,-1,882669826,882669851,25,172,132,3.929411764705882
622,4,4,0,882669851,882669886,35,132,433,3.8035714285714284
622,4,3,-1,882669886,882669905,19,433,418,3.825
622,3,4,1,882669905,882669969,64,418,9,3.8878504672897196
622,4,4,0,882669969,882670009,40,9,419,3.8208955223880596
622,4,5,1,882670009,882670057,48,419,173,4.1441441441441444
622,5,3,-2,882670057,882670121,64,173,423,3.7016129032258065
622,3,3,0,882670121,882670139,18,423,506,3.566666666666667
622,3,5,2,882670139,882670169,30,506,431,3.422222222222222
622,5,4,-1,882670169,882670190,21,431,30,3.8181818181818183
622,4,4,0,882670190,882670211,21,30,755,3.085714285714286
622,4,3,-1,882670211,882670252,41,755,402,3.3076923076923075
622,3,3,0,882670252,882670309,57,402,159,3.3902439024390243
622,3,4,1,882670309,882670367,58,159,226,3.378787878787879
622,4,4,0,882670367,882670389,22,226,157,3.5714285714285716
622,4,3,-1,882670389,882670480,91,157,501,3.289473684210526
622,3,3,0,882670480,882670562,82,501,404,3.6578947368421053
622,3,4,1,882670562,882670587,25,404,86,3.869565217391304
622,4,4,0,882670587,882670610,23,86,46,3.6666666666666665
622,4,2,-2,882670610,882670653,43,46,1231,2.7
622,2,4,2,882670653,882670712,59,1231,367,3.4242424242424243
622,4,3,-1,882670712,882670749,37,367,88,3.433734939759036
622,3,3,0,882670749,882670767,18,88,82,3.6741573033707864
622,3,2,-1,882670767,882670793,26,82,1552,2.0
622,2,3,1,882670793,882670826,33,1552,142,3.1481481481481484
622,3,4,1,882670826,882670843,17,142,578,3.066666666666667
622,4,2,-2,882670843,882670862,19,578,797,3.1538461538461537
622,2,1,-1,882670862,882670899,37,797,206,3.0
622,1,2,1,882670899,882670929,30,206,674,2.6875
622,2,2,0,882670929,882671081,152,674,809,2.7058823529411766
622,2,4,2,882671081,882671120,39,809,4,3.5538461538461537
622,4,3,-1,882671120,882671142,22,4,72,3.175438596491228
622,3,3,0,882671142,882671160,18,72,1078,2.625
622,3,2,-1,882671160,882671185,25,1078,1074,2.857142857142857
622,2,4,2,882671185,882671221,36,1074,451,3.207792207792208
622,4,1,-3,882671221,882671222,1,451,396,2.84
622,1,3,2,882671222,882671273,51,396,49,3.3
622,3,4,1,882671273,882671363,90,49,2,3.0851063829787235
622,4,3,-1,882671363,882671381,18,2,1406,3.3333333333333335
622,3,3,0,882671381,882671446,65,1406,80,2.967741935483871
622,3,3,0,882671446,882671483,37,80,679,3.2432432432432434
622,3,3,0,882671483,882671534,51,679,808,2.4444444444444446
622,3,2,-1,882671534,882671554,20,808,739,3.391304347826087
622,2,4,2,882671554,882671574,20,739,780,3.08
622,4,2,-2,882671574,882671622,48,780,719,2.6666666666666665
622,2,4,2,882671622,882671664,42,719,1411,2.4615384615384617
622,4,2,-2,882671664,882671694,30,1411,94,2.8823529411764706
622,2,3,1,882671694,882671727,33,94,386,2.769230769230769
622,3,2,-1,882671727,882671827,100,386,391,2.4285714285714284
622,2,2,0,882671827,882671863,36,391,552,2.8095238095238093
622,2,2,0,882671863,882671958,95,552,1207,2.125
622,2,3,1,882671958,882672060,102,1207,41,3.0625
622,3,2,-1,882672060,882672079,19,41,795,2.4
622,2,2,0,882672079,882672120,41,795,1419,1.7142857142857142
622,2,2,0,882672120,882672143,23,1419,395,2.5714285714285716
622,2,3,1,882672143,882672177,34,395,725,3.0
622,3,3,0,882672177,882672941,764,725,949,3.392857142857143
621,3,2,-1,874962705,874962772,67,393,88,3.433734939759036
621,2,4,2,874962772,874962824,52,88,208,3.8125
621,4,2,-2,874962824,874962900,76,208,72,3.175438596491228
621,2,4,2,874962900,874962988,88,72,585,2.5384615384615383
621,4,1,-3,874962988,874963028,40,585,451,3.207792207792208
621,1,4,3,874963028,874963126,98,451,80,2.967741935483871
621,4,3,-1,874963126,874963166,40,80,940,2.4
621,3,1,-2,874963166,874963210,44,940,401,2.6774193548387095
621,1,3,2,874963210,874963273,63,401,40,2.7037037037037037
621,3,3,0,874963273,874963446,173,40,364,2.8095238095238093
621,3,4,1,874963446,874963594,148,364,183,3.951219512195122
621,4,3,-1,874963594,874964375,781,183,233,3.323529411764706
621,3,3,0,874964375,874964447,72,233,161,3.5844155844155843
621,3,3,0,874964447,874964495,48,161,38,2.784313725490196
621,3,4,1,874964495,874964496,1,38,62,3.048780487804878
621,4,4,0,874964496,874964604,108,62,241,3.5625
621,4,2,-2,874964604,874964605,1,241,398,2.1
621,2,3,1,874964605,874964657,52,398,810,2.9473684210526314
621,3,4,1,874964657,874964816,159,810,200,3.8157894736842106
621,4,5,1,874964816,874964915,99,200,559,3.477272727272727
621,5,4,-1,874964915,874964945,30,559,561,3.1515151515151514
621,4,3,-1,874964945,874964991,46,561,567,3.272727272727273
621,3,5,2,874964991,874965093,102,567,624,3.0
621,5,5,0,874965093,874965094,1,624,584,3.5238095238095237
621,5,3,-2,874965094,874965208,114,584,71,3.6575342465753424
621,3,3,0,874965208,874965298,90,71,418,3.825
621,3,3,0,874965298,874965299,1,418,142,3.1481481481481484
621,3,5,2,874965299,874965407,108,142,8,3.903225806451613
621,5,5,0,874965407,874965408,1,8,181,3.98974358974359
621,5,3,-2,874965408,874965496,88,181,404,3.6578947368421053
621,3,5,2,874965496,880226633,5261137,404,271,3.3134328358208953
621,5,4,-1,880226633,880226710,77,271,748,3.1043478260869564
621,4,5,1,880226710,880227104,394,748,100,4.0162162162162165
621,5,5,0,880227104,880227233,129,100,1012,3.2916666666666665
621,5,5,0,880227233,880227268,35,1012,117,3.689189189189189
621,5,4,-1,880227268,880736904,509636,117,222,3.578125
621,4,4,0,880736904,880737433,529,222,24,3.3728813559322033
621,4,4,0,880737433,880737785,352,24,1016,3.559322033898305
621,4,4,0,880737785,880737861,76,1016,1028,2.857142857142857
621,4,3,-1,880737861,880738080,219,1028,1047,2.6923076923076925
621,3,3,0,880738080,880738142,62,1047,235,3.106382978723404
621,3,3,0,880738142,880738282,140,235,147,3.3142857142857145
621,3,4,1,880738282,880738353,71,147,7,3.76056338028169
621,4,4,0,880738353,880738462,109,7,763,3.347826086956522
621,4,4,0,880738462,880738568,106,763,250,3.4698795180722892
621,4,4,0,880738568,880738623,55,250,410,3.0434782608695654
621,4,4,0,880738623,880738699,76,410,25,3.3185840707964602
621,4,2,-2,880738699,880738838,139,25,122,2.282608695652174
621,2,4,2,880738838,880738893,55,122,240,3.0350877192982457
621,4,3,-1,880738893,880738894,1,240,546,2.9789473684210526
621,3,5,2,880738894,880739852,958,546,686,3.9
621,5,3,-2,880739852,880739909,57,686,2,3.0851063829787235
621,3,5,2,880739909,880740034,125,2,405,3.25
621,5,3,-2,880740034,880740296,262,405,1228,2.5
621,3,3,0,880740296,881445012,704716,1228,1185,2.111111111111111
621,3,4,1,881445012,881445120,108,1185,804,3.0
621,4,4,0,881445120,883799651,2354531,804,751,3.3896103896103895
621,4,1,-3,883799651,883800011,360,751,263,2.2
621,1,4,3,883800011,885596884,1796873,263,197,4.112676056338028
621,4,3,-1,885596884,885596944,60,197,65,3.511111111111111
621,3,4,1,885596944,890517367,4920423,65,268,3.9838709677419355
621,4,4,0,890517367,890517503,136,268,333,3.546666666666667
621,4,3,-1,890517503,890517589,86,333,300,3.6861313868613137
604,3,2,-1,883668021,883668097,76,183,98,4.240875912408759
604,2,3,1,883668097,883668175,78,98,218,3.5555555555555554
604,3,5,2,883668175,883668352,177,218,670,2.9375
624,4,3,-1,879791819,879791884,65,327,340,3.7419354838709675
624,3,4,1,879791884,879791922,38,340,288,3.5214285714285714
624,4,4,0,879791922,879791962,40,288,690,3.260869565217391
624,4,3,-1,879791962,879792109,147,690,748,3.1043478260869564
624,3,4,1,879792109,879792131,22,748,328,3.4895833333333335
624,4,3,-1,879792131,879792132,1,328,881,2.769230769230769
624,3,3,0,879792132,879792155,23,881,678,2.8181818181818183
624,3,3,0,879792155,879792171,16,678,879,3.2291666666666665
624,3,3,0,879792171,879792251,80,879,876,3.0
624,3,3,0,879792251,879792358,107,876,236,3.2666666666666666
624,3,4,1,879792358,879792395,37,236,126,3.8620689655172415
624,4,3,-1,879792395,879792557,162,126,591,3.7169811320754715
624,3,4,1,879792557,879792581,24,591,1,3.902439024390244
624,4,4,0,879792581,879792623,42,1,137,3.9545454545454546
624,4,3,-1,879792623,879792671,48,137,763,3.347826086956522
624,3,3,0,879792671,879793093,422,763,125,3.5555555555555554
624,3,3,0,879793093,879793129,36,125,597,3.2771084337349397
624,3,4,1,879793129,879793156,27,597,410,3.0434782608695654
624,4,4,0,879793156,879793174,18,410,237,3.7315436241610738
624,4,4,0,879793174,879793223,49,237,696,3.138888888888889
624,4,4,0,879793223,879793269,46,696,411,2.911764705882353
624,4,4,0,879793269,879793358,89,411,980,3.142857142857143
624,4,3,-1,879793358,879793380,22,980,249,3.3275862068965516
624,3,4,1,879793380,879793408,28,249,1012,3.2916666666666665
624,4,3,-1,879793408,879793435,27,1012,255,3.2027027027027026
624,3,3,0,879793435,879793485,50,255,1028,2.857142857142857
624,3,4,1,879793485,879793486,1,1028,993,3.4838709677419355
624,4,4,0,879793486,879793511,25,993,979,3.1
624,4,3,-1,879793511,879793545,34,979,831,2.6097560975609757
624,3,4,1,879793545,879793582,37,831,833,2.9444444444444446
624,4,5,1,879793582,885215463,5421881,833,272,4.2
624,5,3,-2,885215463,891961056,6745593,272,307,3.6031746031746033
624,3,4,1,891961056,891961078,22,307,310,3.6666666666666665
624,4,4,0,891961078,891961120,42,310,269,4.085106382978723
624,4,3,-1,891961120,891961140,20,269,319,3.0408163265306123
624,3,4,1,891961140,891961163,23,319,750,4.027777777777778
624,4,3,-1,891961163,891961187,24,750,689,3.1538461538461537
624,3,4,1,891961187,891961232,45,689,316,4.285714285714286
624,4,4,0,891961232,891961250,18,316,905,3.357142857142857
624,4,3,-1,891961250,891961267,17,905,342,2.64
624,3,4,1,891961267,891961343,76,342,312,3.0
612,3,2,-1,875324294,875324355,61,322,243,2.357142857142857
612,2,5,3,875324355,875324710,355,243,275,4.087912087912088
612,5,4,-1,875324710,875324756,46,275,864,3.2142857142857144
612,4,2,-2,875324756,875324789,33,864,926,2.7857142857142856
612,2,4,2,875324789,875324790,1,926,100,4.0162162162162165
612,4,3,-1,875324790,875324876,86,100,7,3.76056338028169
612,3,3,0,875324876,875324915,39,7,25,3.3185840707964602
612,3,3,0,875324915,875324947,32,25,118,3.2764227642276422
612,3,4,1,875324947,875324975,28,118,147,3.3142857142857145
612,4,5,1,875324975,875325049,74,147,1063,3.642857142857143
612,5,2,-3,875325049,875325221,172,1063,202,3.730337078651685
612,2,4,2,875325221,875325256,35,202,604,3.8181818181818183
627,5,4,-1,879529432,879529486,54,271,328,3.4895833333333335
627,4,4,0,879529486,879529556,70,328,245,3.056179775280899
627,4,5,1,879529556,879529701,145,245,318,4.5046728971962615
627,5,5,0,879529701,879529730,29,318,197,4.112676056338028
627,5,2,-3,879529730,879529767,37,197,521,3.787878787878788
627,2,5,3,879529767,879529794,27,521,180,3.9473684210526314
627,5,4,-1,879529794,879529819,25,180,12,4.358974358974359
627,4,3,-1,879529819,879529885,66,12,631,3.581818181818182
627,3,4,1,879529885,879529916,31,631,182,3.842857142857143
627,4,4,0,879529916,879529957,41,182,191,4.168674698795181
627,4,2,-2,879529957,879529958,1,191,97,3.7282608695652173
627,2,4,2,879529958,879529986,28,97,511,4.096153846153846
627,4,3,-1,879529986,879529987,1,511,28,3.923076923076923
627,3,4,1,879529987,879530014,27,28,9,3.8878504672897196
627,4,5,1,879530014,879530042,28,9,467,4.071428571428571
627,5,5,0,879530042,879530071,29,467,317,3.774193548387097
627,5,4,-1,879530071,879530109,38,317,651,3.8627450980392157
627,4,4,0,879530109,879530110,1,651,157,3.5714285714285716
627,4,3,-1,879530110,879530145,35,157,423,3.7016129032258065
627,3,4,1,879530145,879530146,1,423,518,3.5833333333333335
627,4,5,1,879530146,879530172,26,518,196,3.9404761904761907
627,5,3,-2,879530172,879530173,1,196,76,3.1875
627,3,2,-1,879530173,879530205,32,76,693,3.6285714285714286
627,2,1,-1,879530205,879530263,58,693,699,3.736842105263158
627,1,3,2,879530263,879530264,1,699,939,3.6333333333333333
627,3,2,-1,879530264,879530306,42,939,284,3.1547619047619047
627,2,4,2,879530306,879530346,40,284,237,3.7315436241610738
627,4,4,0,879530346,879530408,62,237,39,3.107142857142857
627,4,1,-3,879530408,879530501,93,39,740,3.423076923076923
627,1,1,0,879530501,879530600,99,740,729,3.3793103448275863
627,1,3,2,879530600,879530625,25,729,1135,3.0526315789473686
627,3,3,0,879530625,879530662,37,1135,581,3.130434782608696
627,3,2,-1,879530662,879530694,32,581,403,3.298507462686567
627,2,4,2,879530694,879530762,68,403,1136,3.3076923076923075
627,4,3,-1,879530762,879530824,62,1136,26,3.36
627,3,3,0,879530824,879530866,42,26,402,3.3076923076923075
627,3,2,-1,879530866,879530899,33,402,1044,3.2777777777777777
627,2,3,1,879530899,879530967,68,1044,1478,2.7
627,3,3,0,879530967,879531158,191,1478,79,3.956989247311828
627,3,4,1,879531158,879531248,90,79,82,3.6741573033707864
627,4,3,-1,879531248,879531249,1,82,566,3.543859649122807
627,3,2,-1,879531249,879531301,52,566,568,3.5853658536585367
627,2,2,0,879531301,879531302,1,568,161,3.5844155844155843
627,2,3,1,879531302,879531351,49,161,578,3.066666666666667
627,3,3,0,879531351,879531352,1,578,2,3.0851063829787235
627,3,4,1,879531352,879531397,45,2,62,3.048780487804878
627,4,3,-1,879531397,879531458,61,62,405,3.25
627,3,3,0,879531458,879531459,1,405,665,2.72972972972973
627,3,4,1,879531459,879531504,45,665,541,2.9473684210526314
627,4,2,-2,879531504,879531557,53,541,808,2.4444444444444446
623,4,5,1,891032275,891032291,16,283,181,3.98974358974359
623,5,4,-1,891032291,891032358,67,181,258,3.7547169811320753
623,4,4,0,891032358,891032375,17,258,15,3.725663716814159
623,4,2,-2,891032375,891032433,58,15,298,3.779220779220779
623,2,4,2,891032433,891034129,1696,298,121,3.521212121212121
623,4,4,0,891034129,891034294,165,121,603,4.315789473684211
623,4,3,-1,891034294,891034472,178,603,642,3.4285714285714284
623,3,4,1,891034472,891034528,56,642,227,3.169811320754717
623,4,4,0,891034528,891034756,228,227,523,4.159090909090909
623,4,3,-1,891034756,891034757,1,523,153,3.7865168539325844
623,3,3,0,891034757,891034814,57,153,186,3.905263157894737
623,3,4,1,891034814,891034993,179,186,66,3.4705882352941178
628,4,5,1,880777046,880777095,49,301,340,3.7419354838709675
628,5,5,0,880777095,880777167,72,340,258,3.7547169811320753
625,3,3,0,891262633,891262724,91,209,514,4.033333333333333
625,3,4,1,891262724,891262783,59,514,484,4.116279069767442
625,4,3,-1,891262783,891262784,1,484,357,4.063291139240507
625,3,3,0,891262784,891262837,53,357,654,4.119047619047619
625,3,3,0,891262837,891262983,146,654,705,3.7857142857142856
625,3,3,0,891262983,891263057,74,705,602,3.533333333333333
625,3,2,-1,891263057,891263703,646,602,519,4.291666666666667
625,2,4,2,891263703,891263760,57,519,423,3.7016129032258065
625,4,4,0,891263760,891263822,62,423,647,4.142857142857143
625,4,3,-1,891263822,891263960,138,647,732,3.6266666666666665
625,3,3,0,891263960,891273698,9738,732,121,3.521212121212121
625,3,2,-1,891273698,891273699,1,121,1016,3.559322033898305
625,2,4,2,891273699,891273750,51,1016,250,3.4698795180722892
625,4,2,-2,891273750,891273897,147,250,546,2.9789473684210526
625,2,3,1,891273897,891536483,262586,546,294,3.1052631578947367
625,3,3,0,891536483,891636079,99596,294,191,4.168674698795181
625,3,3,0,891636079,891953617,317538,191,486,3.9565217391304346
625,3,5,2,891953617,891953755,138,486,428,3.744186046511628
625,5,3,-2,891953755,891961633,7878,428,528,4.241379310344827
625,3,3,0,891961633,891968320,6687,528,212,3.230769230769231
625,3,3,0,891968320,891999796,31476,212,640,2.75
625,3,3,0,891999796,891999926,130,640,165,3.9130434782608696
625,3,3,0,891999926,892000438,512,165,183,3.951219512195122
625,3,3,0,892000438,892000518,80,183,692,3.56
625,3,3,0,892000518,892000576,58,692,190,4.233333333333333
625,3,3,0,892000576,892000629,53,190,1020,3.727272727272727
625,3,3,0,892000629,892000686,57,1020,200,3.8157894736842106
625,3,3,0,892000686,892054095,53409,200,210,3.921259842519685
625,3,3,0,892054095,892054198,103,210,265,3.710144927536232
629,3,4,1,880115922,880115923,1,301,300,3.6861313868613137
629,4,2,-2,880115923,880115971,48,300,340,3.7419354838709675
629,2,3,1,880115971,880116023,52,340,876,3.0
629,3,3,0,880116023,880116067,44,876,331,3.5517241379310347
629,3,3,0,880116067,880116201,134,331,327,3.5076923076923077
629,3,3,0,880116201,880116240,39,327,309,2.3333333333333335
629,3,3,0,880116240,880116278,38,309,984,2.6666666666666665
629,3,4,1,880116278,880116756,478,984,435,3.8933333333333335
629,4,5,1,880116756,880116818,62,435,509,3.7058823529411766
629,5,4,-1,880116818,880116847,29,509,195,3.9072164948453607
629,4,4,0,880116847,880116887,40,195,265,3.710144927536232
629,4,5,1,880116887,880116911,24,265,241,3.5625
629,5,4,-1,880116911,880117000,89,241,207,3.4761904761904763
629,4,2,-2,880117000,880117001,1,207,273,3.5238095238095237
629,2,5,3,880117001,880117031,30,273,187,4.215189873417722
629,5,4,-1,880117031,880117062,31,187,357,4.063291139240507
629,4,4,0,880117062,880117094,32,357,55,4.051282051282051
629,4,5,1,880117094,880117163,69,55,86,3.869565217391304
629,5,5,0,880117163,880117215,52,86,693,3.6285714285714286
629,5,5,0,880117215,880117254,39,693,98,4.240875912408759
629,5,5,0,880117254,880117285,31,98,204,3.6744186046511627
629,5,5,0,880117285,880117395,110,204,566,3.543859649122807
629,5,5,0,880117395,880117459,64,566,277,3.6
629,5,3,-2,880117459,880117460,1,277,699,3.736842105263158
629,3,5,2,880117460,880117485,25,699,69,3.8015873015873014
629,5,5,0,880117485,880117513,28,69,64,4.373737373737374
629,5,5,0,880117513,880117534,21,64,147,3.3142857142857145
629,5,5,0,880117534,880117565,31,147,467,4.071428571428571
629,5,5,0,880117565,880117586,21,467,135,3.7974683544303796
629,5,5,0,880117586,880117605,19,135,127,4.162790697674419
629,5,5,0,880117605,880117635,30,127,87,3.9
629,5,5,0,880117635,880117689,54,87,111,3.5106382978723403
629,5,4,-1,880117689,880117719,30,111,504,4.085714285714285
629,4,2,-2,880117719,880117747,28,504,39,3.107142857142857
629,2,4,2,880117747,880117813,66,39,658,3.393939393939394
629,4,4,0,880117813,880117852,39,658,729,3.3793103448275863
633,4,3,-1,875324298,875324654,356,328,654,4.119047619047619
633,3,4,1,875324654,875324715,61,654,98,4.240875912408759
633,4,4,0,875324715,875324766,51,98,1019,3.7777777777777777
633,4,3,-1,875324766,875324812,46,1019,921,3.611111111111111
633,3,4,1,875324812,875324813,1,921,318,4.5046728971962615
633,4,4,0,875324813,875324891,78,318,237,3.7315436241610738
633,4,2,-2,875324891,875324922,31,237,498,4.290909090909091
633,2,4,2,875324922,875324997,75,498,195,3.9072164948453607
633,4,4,0,875324997,875325093,96,195,159,3.3902439024390243
633,4,5,1,875325093,875325128,35,159,79,3.956989247311828
633,5,3,-2,875325128,875325577,449,79,176,3.967032967032967
633,3,4,1,875325577,875325654,77,176,405,3.25
633,4,2,-2,875325654,875325691,37,405,1132,2.588235294117647
633,2,3,1,875325691,875325804,113,1132,71,3.6575342465753424
633,3,2,-1,875325804,875325865,61,71,410,3.0434782608695654
633,2,3,1,875325865,875325888,23,410,322,3.0476190476190474
633,3,4,1,875325888,875326664,776,322,50,4.306532663316583
633,4,3,-1,875326664,875326698,34,50,276,3.6036036036036037
633,3,4,1,875326698,877211134,1884436,276,143,3.56
633,4,3,-1,877211134,877211326,192,143,45,4.130434782608695
633,3,2,-1,877211326,877211886,560,45,778,3.5925925925925926
633,2,4,2,877211886,877212045,159,778,939,3.6333333333333333
633,4,4,0,877212045,877212085,40,939,226,3.378787878787879
633,4,3,-1,877212085,877212173,88,226,77,3.3857142857142857
633,3,3,0,877212173,877212283,110,77,651,3.8627450980392157
633,3,4,1,877212283,877212366,83,651,28,3.923076923076923
633,4,4,0,877212366,877212367,1,28,423,3.7016129032258065
632,3,5,2,879456910,879456955,45,432,95,3.8194444444444446
632,5,5,0,879456955,879457016,61,95,181,3.98974358974359
632,5,3,-2,879457016,879457157,141,181,228,3.7246376811594204
632,3,4,1,879457157,879457248,91,228,168,4.0476190476190474
632,4,5,1,879457248,879457317,69,168,79,3.956989247311828
632,5,4,-1,879457317,879457371,54,79,69,3.8015873015873014
632,4,4,0,879457371,879457394,23,69,22,4.215909090909091
632,4,3,-1,879457394,879457437,43,22,156,4.017857142857143
632,3,5,2,879457437,879457525,88,156,64,4.373737373737374
632,5,3,-2,879457525,879457582,57,64,475,3.956043956043956
632,3,3,0,879457582,879457603,21,475,100,4.0162162162162165
632,3,3,0,879457603,879457641,38,100,655,3.7857142857142856
632,3,3,0,879457641,879457812,171,655,176,3.967032967032967
632,3,2,-1,879457812,879457856,44,176,276,3.6036036036036037
632,2,5,3,879457856,879457902,46,276,96,3.9130434782608696
632,5,4,-1,879457902,879457903,1,96,82,3.6741573033707864
632,4,3,-1,879457903,879458277,374,82,56,4.051724137931035
632,3,4,1,879458277,879458649,372,56,71,3.6575342465753424
632,4,4,0,879458649,879458692,43,71,164,3.6140350877192984
632,4,3,-1,879458692,879458725,33,164,402,3.3076923076923075
632,3,4,1,879458725,879458806,81,402,282,3.610526315789474
632,4,4,0,879458806,879458834,28,282,215,3.662921348314607
632,4,4,0,879458834,879458856,22,215,97,3.7282608695652173
632,4,5,1,879458856,879458941,85,97,99,3.8392857142857144
632,5,4,-1,879458941,879459003,62,99,423,3.7016129032258065
632,4,3,-1,879459003,879459025,22,423,227,3.169811320754717
632,3,4,1,879459025,879459166,141,227,51,3.5277777777777777
632,4,4,0,879459166,879459248,82,51,356,3.2
632,4,3,-1,879459248,879459304,56,356,763,3.347826086956522
632,3,4,1,879459304,879459321,17,763,679,3.2432432432432434
632,4,2,-2,879459321,879459394,73,679,685,3.2666666666666666
632,2,4,2,879459394,879459418,24,685,622,3.3333333333333335
632,4,3,-1,879459418,879459441,23,622,233,3.323529411764706
632,3,3,0,879459441,879459460,19,233,159,3.3902439024390243
632,3,3,0,879459460,879459481,21,159,746,3.7560975609756095
632,3,5,2,879459481,879459544,63,746,404,3.6578947368421053
632,5,2,-3,879459544,879459649,105,404,1028,2.857142857142857
632,2,4,2,879459649,879459677,28,1028,470,3.72
632,4,5,1,879459677,879459738,61,470,186,3.905263157894737
632,5,5,0,879459738,879459739,1,186,480,4.283018867924528
632,5,1,-4,879459739,879459777,38,480,877,2.619047619047619
631,3,2,-1,888464916,888464941,25,288,334,3.4210526315789473
631,2,4,2,888464941,888464980,39,334,310,3.6666666666666665
631,4,4,0,888464980,888465004,24,310,346,3.5128205128205128
631,4,3,-1,888465004,888465033,29,346,286,3.442857142857143
631,3,2,-1,888465033,888465084,51,286,873,2.7586206896551726
631,2,4,2,888465084,888465107,23,873,301,3.2465753424657535
631,4,2,-2,888465107,888465131,24,301,877,2.619047619047619
631,2,3,1,888465131,888465180,49,877,332,3.6511627906976742
631,3,4,1,888465180,888465216,36,332,289,2.988888888888889
631,4,2,-2,888465216,888465247,31,289,682,3.0476190476190474
631,2,2,0,888465247,888465351,104,682,1527,2.0
634,3,3,0,875728834,875728913,79,275,222,3.578125
634,3,3,0,875728913,875729069,156,222,116,3.6666666666666665
634,3,4,1,875729069,875729105,36,116,129,3.744186046511628
634,4,3,-1,875729105,875729148,43,129,845,3.661290322580645
634,3,3,0,875729148,875729178,30,845,288,3.5214285714285714
634,3,3,0,875729178,875729239,61,288,991,2.4545454545454546
634,3,4,1,875729239,875729436,197,991,15,3.725663716814159
634,4,3,-1,875729436,875729456,20,15,1028,2.857142857142857
634,3,4,1,875729456,875729535,79,1028,546,2.9789473684210526
634,4,2,-2,875729535,875729558,23,546,473,2.9166666666666665
634,2,3,1,875729558,875729668,110,473,1048,2.857142857142857
634,3,3,0,875729668,875729710,42,1048,979,3.1
634,3,2,-1,875729710,875729749,39,979,740,3.423076923076923
634,2,2,0,875729749,875729794,45,740,840,3.090909090909091
634,2,3,1,875729794,875729825,31,840,235,3.106382978723404
634,3,2,-1,875729825,876171049,441224,235,819,2.6666666666666665
634,2,3,1,876171049,876171093,44,819,477,3.1666666666666665
634,3,4,1,876171093,877017829,846736,477,281,3.2
634,4,4,0,877017829,877017872,43,281,410,3.0434782608695654
634,4,3,-1,877017872,877017891,19,410,290,3.108108108108108
634,3,2,-1,877017891,877017951,60,290,1008,3.5
634,2,2,0,877017951,877018033,82,1008,934,3.0294117647058822
634,2,5,3,877018033,877018125,92,934,286,3.442857142857143
634,5,4,-1,877018125,877018311,186,286,248,3.746268656716418
634,4,4,0,877018311,877018347,36,248,50,4.306532663316583
634,4,3,-1,877018347,877368475,350128,50,864,3.2142857142857144
634,3,1,-2,877368475,877974690,606215,864,325,2.625
634,1,4,3,877974690,877979407,4717,325,547,3.6666666666666665
634,4,3,-1,877979407,879787667,1808260,547,762,3.3962264150943398
634,3,2,-1,879787667,890779883,10992216,762,341,3.0
639,4,3,-1,891238550,891238599,49,306,269,4.085106382978723
639,3,4,1,891238599,891238618,19,269,286,3.442857142857143
639,4,1,-3,891238618,891238668,50,286,305,3.5789473684210527
639,1,1,0,891238668,891238689,21,305,990,2.769230769230769
639,1,3,2,891238689,891238790,101,990,300,3.6861313868613137
639,3,1,-2,891238790,891238876,86,300,323,3.0
639,1,4,3,891238876,891239030,154,323,513,4.526315789473684
639,4,2,-2,891239030,891239048,18,513,1465,2.0
639,2,3,1,891239048,891239109,61,1465,191,4.168674698795181
639,3,1,-2,891239109,891239131,22,191,285,4.181818181818182
639,1,4,3,891239131,891239155,24,285,661,4.133333333333334
639,4,3,-1,891239155,891239156,1,661,357,4.063291139240507
639,3,4,1,891239156,891239239,83,357,528,4.241379310344827
639,4,4,0,891239239,891239240,1,528,511,4.096153846153846
639,4,3,-1,891239240,891239271,31,511,509,3.7058823529411766
639,3,4,1,891239271,891239295,24,509,48,4.055555555555555
639,4,3,-1,891239295,891239296,1,48,58,3.543859649122807
639,3,4,1,891239296,891239323,27,58,527,3.823529411764706
639,4,1,-3,891239323,891239324,1,527,179,3.8823529411764706
639,1,1,0,891239324,891239349,25,179,1163,2.1666666666666665
639,1,4,3,891239349,891239406,57,1163,673,3.393939393939394
639,4,2,-2,891239406,891239407,1,673,953,3.076923076923077
639,2,1,-1,891239407,891239427,20,953,865,2.6666666666666665
639,1,3,2,891239427,891239456,29,865,196,3.9404761904761907
639,3,3,0,891239456,891239491,35,196,648,3.9545454545454546
639,3,5,2,891239491,891239492,1,648,694,4.277777777777778
639,5,4,-1,891239492,891239529,37,694,451,3.207792207792208
639,4,3,-1,891239529,891239550,21,451,692,3.56
639,3,2,-1,891239550,891239581,31,692,202,3.730337078651685
639,2,3,1,891239581,891239638,57,202,155,3.0588235294117645
639,3,3,0,891239638,891239658,20,155,59,4.0
639,3,4,1,891239658,891239702,44,59,863,3.727272727272727
639,4,3,-1,891239702,891239739,37,863,582,3.7457627118644066
639,3,2,-1,891239739,891239759,20,582,512,3.888888888888889
639,2,3,1,891239759,891239790,31,512,60,4.105263157894737
639,3,2,-1,891239790,891239885,95,60,1121,3.5
639,2,2,0,891239885,891239886,1,1121,714,3.6
639,2,4,2,891239886,891239913,27,714,283,3.901639344262295
639,4,3,-1,891239913,891240111,198,283,659,4.027777777777778
639,3,3,0,891240111,891240136,25,659,210,3.921259842519685
639,3,5,2,891240136,891240520,384,210,483,4.475609756097561
639,5,4,-1,891240520,891240643,123,483,98,4.240875912408759
639,4,4,0,891240643,891240678,35,98,516,4.055555555555555
639,4,3,-1,891240678,891240719,41,516,414,3.3076923076923075
639,3,3,0,891240719,891240751,32,414,204,3.6744186046511627
639,3,3,0,891240751,891240752,1,204,153,3.7865168539325844
639,3,1,-2,891240752,891240805,53,153,716,3.1904761904761907
639,1,3,2,891240805,891240868,63,716,280,3.103448275862069
639,3,3,0,891240868,891241022,154,280,786,3.0
639,3,4,1,891241022,891241052,30,786,958,4.2
630,4,3,-1,885666018,885666211,193,294,322,3.0476190476190474
630,3,4,1,885666211,885666237,26,322,323,3.0
630,4,3,-1,885666237,885666301,64,323,325,2.625
630,3,2,-1,885666301,885666353,52,325,264,2.65
630,2,2,0,885666353,885666536,183,264,127,4.162790697674419
630,2,4,2,885666536,885666571,35,127,7,3.76056338028169
630,4,3,-1,885666571,885666592,21,7,100,4.0162162162162165
630,3,3,0,885666592,885666650,58,100,181,3.98974358974359
630,3,5,2,885666650,885666686,36,181,298,3.779220779220779
630,5,3,-2,885666686,885666718,32,298,15,3.725663716814159
630,3,5,2,885666718,885666740,22,15,255,3.2027027027027026
630,5,3,-2,885666740,885666804,64,255,282,3.610526315789474
630,3,5,2,885666804,885666823,19,282,237,3.7315436241610738
630,5,4,-1,885666823,885666955,132,237,471,3.5714285714285716
630,4,5,1,885666955,885666956,1,471,111,3.5106382978723403
630,5,3,-2,885666956,885667037,81,111,257,3.7154471544715446
630,3,3,0,885667037,885667056,19,257,546,2.9789473684210526
630,3,3,0,885667056,885667108,52,546,819,2.6666666666666665
630,3,2,-1,885667108,885667148,40,819,280,3.103448275862069
630,2,4,2,885667148,885667200,52,280,477,3.1666666666666665
630,4,3,-1,885667200,885667229,29,477,815,3.135135135135135
630,3,4,1,885667229,885667249,20,815,929,2.8421052631578947
630,4,4,0,885667249,885667305,56,929,126,3.8620689655172415
630,4,4,0,885667305,885667391,86,126,820,3.0444444444444443
630,4,2,-2,885667391,885667464,73,820,252,2.911392405063291
630,2,1,-1,885667464,885667508,44,252,1079,2.1923076923076925
630,1,2,1,885667508,885667528,20,1079,832,2.7142857142857144
630,2,4,2,885667528,885667551,23,832,756,2.6885245901639343
630,4,4,0,885667551,885667581,30,756,1023,2.5714285714285716
630,4,3,-1,885667581,885667624,43,1023,934,3.0294117647058822
630,3,4,1,885667624,885667660,36,934,1040,2.2666666666666666
630,4,4,0,885667660,885667661,1,1040,620,3.0
630,4,4,0,885667661,885667678,17,620,120,2.3421052631578947
630,4,3,-1,885667678,885667699,21,120,983,2.5
630,3,3,0,885667699,885667854,155,983,71,3.6575342465753424
630,3,5,2,885667854,885667898,44,71,98,4.240875912408759
630,5,3,-2,885667898,885667918,20,98,172,4.225225225225225
630,3,3,0,885667918,885667939,21,172,193,3.883720930232558
630,3,4,1,885667939,885667968,29,193,195,3.9072164948453607
630,4,5,1,885667968,885668028,60,195,11,3.8904109589041096
630,5,3,-2,885668028,885668090,62,11,357,4.063291139240507
630,3,3,0,885668090,885668131,41,357,174,4.253521126760563
630,3,4,1,885668131,885668203,72,174,732,3.6266666666666665
630,4,2,-2,885668203,885668231,28,732,735,3.58
630,2,1,-1,885668231,885668276,45,735,640,2.75
630,1,3,2,885668276,885668277,1,640,153,3.7865168539325844
630,3,3,0,885668277,885668328,51,153,22,4.215909090909091
642,5,4,-1,885601998,885602285,287,294,22,4.215909090909091
642,4,5,1,885602285,885602314,29,22,173,4.1441441441441444
642,5,3,-2,885602314,885602340,26,173,1000,3.3333333333333335
642,3,2,-1,885602340,885602369,29,1000,318,4.5046728971962615
642,2,4,2,885602369,885602418,49,318,97,3.7282608695652173
642,4,2,-2,885602418,885602446,28,97,1503,3.25
642,2,5,3,885602446,885602482,36,1503,64,4.373737373737374
642,5,3,-2,885602482,885602483,1,64,746,3.7560975609756095
642,3,3,0,885602483,885602506,23,746,423,3.7016129032258065
642,3,5,2,885602506,885602571,65,423,385,3.6129032258064515
642,5,3,-2,885602571,885602572,1,385,153,3.7865168539325844
642,3,4,1,885602572,885602593,21,153,204,3.6744186046511627
642,4,5,1,885602593,885602612,19,204,485,3.717948717948718
642,5,5,0,885602612,885602630,18,485,1039,3.9583333333333335
642,5,5,0,885602630,885602631,1,1039,69,3.8015873015873014
642,5,4,-1,885602631,885602656,25,69,56,4.051724137931035
642,4,3,-1,885602656,885602718,62,56,195,3.9072164948453607
642,3,5,2,885602718,885602739,21,195,186,3.905263157894737
642,5,5,0,885602739,885602839,100,186,742,3.5555555555555554
642,5,5,0,885602839,885603018,179,742,143,3.56
642,5,3,-2,885603018,885603083,65,143,216,3.8454545454545452
642,3,4,1,885603083,885603516,433,216,496,4.094594594594595
642,4,3,-1,885603516,885603517,1,496,378,3.6904761904761907
642,3,4,1,885603517,885603537,20,378,419,3.8208955223880596
642,4,5,1,885603537,885603565,28,419,1,3.902439024390244
642,5,3,-2,885603565,885603566,1,1,118,3.2764227642276422
642,3,4,1,885603566,885603586,20,118,125,3.5555555555555554
642,4,5,1,885603586,885603636,50,125,83,4.204081632653061
642,5,5,0,885603636,885603662,26,83,8,3.903225806451613
642,5,5,0,885603662,885603699,37,8,181,3.98974358974359
642,5,3,-2,885603699,885603740,41,181,1063,3.642857142857143
642,3,4,1,885603740,885603792,52,1063,402,3.3076923076923075
642,4,5,1,885603792,885603849,57,402,102,3.3684210526315788
642,5,2,-3,885603849,885603870,21,102,443,3.8421052631578947
642,2,4,2,885603870,885603897,27,443,91,3.6
642,4,4,0,885603897,885603932,35,91,1219,3.142857142857143
642,4,1,-3,885603932,885604085,153,1219,288,3.5214285714285714
642,1,5,4,885604085,885604113,28,288,596,3.180327868852459
642,5,5,0,885604113,885604163,50,596,148,3.2131147540983607
642,5,5,0,885604163,885604187,24,148,395,2.5714285714285716
642,5,5,0,885604187,885604280,93,395,50,4.306532663316583
642,5,5,0,885604280,885604299,19,50,172,4.225225225225225
642,5,5,0,885604299,885604434,135,172,166,4.0
642,5,4,-1,885604434,885604480,46,166,165,3.9130434782608696
642,4,3,-1,885604480,885604859,379,165,609,3.7058823529411766
642,3,5,2,885604859,885604874,15,609,559,3.477272727272727
642,5,2,-3,885604874,885604940,66,559,53,2.9523809523809526
642,2,5,3,885604940,885605095,155,53,259,2.492063492063492
642,5,5,0,885605095,885605148,53,259,21,2.9210526315789473
642,5,3,-2,885605148,885605347,199,21,41,3.0625
642,3,5,2,885605347,885605454,107,41,926,2.7857142857142856
642,5,4,-1,885605454,885605538,84,926,732,3.6266666666666665
642,4,4,0,885605538,885605735,197,732,73,3.588235294117647
642,4,3,-1,885605735,885605768,33,73,4,3.5538461538461537
642,3,5,2,885605768,885605794,26,4,451,3.207792207792208
642,5,3,-2,885605794,885605835,41,451,871,2.3823529411764706
642,3,4,1,885605835,885605866,31,871,40,2.7037037037037037
642,4,2,-2,885605866,885605932,66,40,996,2.1666666666666665
642,2,1,-1,885605932,885605988,56,996,410,3.0434782608695654
642,1,2,1,885605988,885606047,59,410,235,3.106382978723404
642,2,3,1,885606047,885606048,1,235,1179,3.0
642,3,4,1,885606048,885606067,19,1179,725,3.0
642,4,3,-1,885606067,885606090,23,725,63,3.125
642,3,3,0,885606090,885606113,23,63,722,2.9642857142857144
642,3,2,-1,885606113,885606137,24,722,934,3.0294117647058822
642,2,2,0,885606137,885606178,41,934,1182,2.4285714285714284
642,2,3,1,885606178,885606194,16,1182,376,2.9166666666666665
642,3,3,0,885606194,885606212,18,376,1209,2.3333333333333335
642,3,4,1,885606212,885606234,22,1209,1036,3.0
642,4,2,-2,885606234,885606270,36,1036,1509,2.5
642,2,3,1,885606270,885606327,57,1509,1047,2.6923076923076925
642,3,2,-1,885606327,885606463,136,1047,122,2.282608695652174
642,2,5,3,885606463,885606482,19,122,407,2.611111111111111
642,5,2,-3,885606482,885606520,38,407,1336,1.75
642,2,4,2,885606520,885606537,17,1336,579,2.727272727272727
642,4,3,-1,885606537,885606581,44,579,627,3.3823529411764706
642,3,4,1,885606581,885606609,28,627,768,3.238095238095238
642,4,2,-2,885606609,885606648,39,768,1076,2.5
642,2,4,2,885606648,885606735,87,1076,568,3.5853658536585367
642,4,3,-1,885606735,885606765,30,568,68,3.5714285714285716
642,3,5,2,885606765,885606787,22,68,720,3.2
642,5,4,-1,885606787,885606857,70,720,931,2.2758620689655173
642,4,3,-1,885606857,885606946,89,931,405,3.25
642,3,4,1,885606946,885606964,18,405,233,3.323529411764706
642,4,2,-2,885606964,885606986,22,233,679,3.2432432432432434
642,2,4,2,885606986,885607065,79,679,597,3.2771084337349397
642,4,5,1,885607065,885607081,16,597,472,2.984375
642,5,4,-1,885607081,885607097,16,472,1239,2.25
642,4,3,-1,885607097,885607115,18,1239,771,2.5714285714285716
642,3,2,-1,885607115,885607143,28,771,1181,2.6
642,2,5,3,885607143,885842610,235467,1181,210,3.921259842519685
642,5,5,0,885842610,885842903,293,210,769,2.2222222222222223
642,5,5,0,885842903,885843025,122,769,364,2.8095238095238093
642,5,4,-1,885843025,885843141,116,364,38,2.784313725490196
642,4,3,-1,885843141,885843177,36,38,779,2.2
642,3,1,-2,885843177,886131332,288155,779,827,2.4375
642,1,5,4,886131332,886131457,125,827,250,3.4698795180722892
642,5,5,0,886131457,886131546,89,250,88,3.433734939759036
642,5,5,0,886131546,886131563,17,88,477,3.1666666666666665
642,5,4,-1,886131563,886131655,92,477,117,3.689189189189189
642,4,4,0,886131655,886131674,19,117,728,3.05
642,4,4,0,886131674,886131707,33,728,366,3.4285714285714284
642,4,4,0,886131707,886132043,336,366,1285,3.1
642,4,4,0,886132043,886132088,45,1285,723,3.5384615384615383
642,4,3,-1,886132088,886132089,1,723,660,3.71875
642,3,4,1,886132089,886132104,15,660,356,3.2
642,4,3,-1,886132104,886132139,35,356,1058,3.6
642,3,5,2,886132139,886132153,14,1058,553,3.5
642,5,4,-1,886132153,886132172,19,553,65,3.511111111111111
642,4,5,1,886132172,886206274,74102,65,133,3.7777777777777777
642,5,4,-1,886206274,886206959,685,133,54,3.3714285714285714
642,4,4,0,886206959,886206991,32,54,470,3.72
642,4,4,0,886206991,886207132,141,470,527,3.823529411764706
642,4,4,0,886207132,886207151,19,527,942,3.4545454545454546
642,4,3,-1,886207151,886207279,128,942,1053,3.3846153846153846
642,3,4,1,886207279,886454812,247533,1053,254,2.7419354838709675
642,4,2,-2,886454812,886454837,25,254,398,2.1
642,2,3,1,886454837,886454901,64,398,575,2.619047619047619
642,3,1,-2,886454901,886454965,64,575,156,4.017857142857143
642,1,5,4,886454965,886455469,504,156,416,3.3846153846153846
642,5,2,-3,886455469,886455538,69,416,89,3.9615384615384617
642,2,3,1,886455538,886568479,112941,89,468,3.380952380952381
642,3,4,1,886568479,886568725,246,468,1469,3.4
642,4,3,-1,886568725,886568726,1,1469,155,3.0588235294117645
642,3,4,1,886568726,886568744,18,155,141,3.4827586206896552
642,4,5,1,886568744,886568838,94,141,739,3.391304347826087
642,5,4,-1,886568838,886568874,36,739,1473,4.5
642,4,5,1,886568874,886568959,85,1473,699,3.736842105263158
642,5,4,-1,886568959,886569012,53,699,1032,2.7142857142857144
642,4,5,1,886569012,886569140,128,1032,966,4.7
642,5,2,-3,886569140,886569209,69,966,581,3.130434782608696
642,2,3,1,886569209,886569257,48,581,140,3.238095238095238
642,3,3,0,886569257,886569278,21,140,1033,3.0
642,3,4,1,886569278,886569328,50,1033,447,3.46875
642,4,4,0,886569328,886569347,19,447,552,2.8095238095238093
642,4,4,0,886569347,886569380,33,552,142,3.1481481481481484
642,4,1,-3,886569380,886569417,37,142,139,2.7222222222222223
642,1,4,3,886569417,886569483,66,139,1055,3.125
642,4,4,0,886569483,886569570,87,1055,775,2.4285714285714284
642,4,3,-1,886569570,886569682,112,775,843,2.933333333333333
642,3,1,-2,886569682,886569699,17,843,452,2.6129032258064515
642,1,3,2,886569699,886569715,16,452,1311,2.125
642,3,4,1,886569715,886569732,17,1311,1140,2.1666666666666665
642,4,4,0,886569732,886569783,51,1140,1415,2.8
642,4,3,-1,886569783,886569809,26,1415,1413,3.75
642,3,5,2,886569809,886569828,19,1413,1152,3.4375
642,5,4,-1,886569828,886569870,42,1152,577,1.7058823529411764
642,4,4,0,886569870,886569922,52,577,365,2.95
642,4,1,-3,886569922,886569942,20,365,441,2.4
642,1,3,2,886569942,886569960,18,441,734,3.0
642,3,4,1,886569960,886570010,50,734,623,3.0454545454545454
642,4,2,-2,886570010,886570027,17,623,35,1.75
642,2,5,3,886570027,886570062,35,35,383,2.5
642,5,3,-2,886570062,886570084,22,383,78,2.3636363636363638
642,3,4,1,886570084,886570173,89,78,1030,2.3636363636363638
642,4,4,0,886570173,887663380,1093207,1030,220,3.433333333333333
642,4,4,0,887663380,891317923,3654543,220,245,3.056179775280899
642,4,4,0,891317923,891317955,32,245,993,3.4838709677419355
642,4,4,0,891317955,892241051,923096,993,815,3.135135135135135
637,1,3,2,882899608,882900047,439,873,245,3.056179775280899
637,3,3,0,882900047,882903191,3144,245,847,3.7333333333333334
637,3,3,0,882903191,882903250,59,847,273,3.5238095238095237
637,3,2,-1,882903250,882903301,51,273,508,3.6923076923076925
637,2,2,0,882903301,882903582,281,508,596,3.180327868852459
637,2,1,-1,882903582,882903644,62,596,741,3.3043478260869565
637,1,3,2,882903644,882903767,123,741,676,3.3142857142857145
637,3,2,-1,882903767,882903914,147,676,740,3.423076923076923
637,2,5,3,882903914,882904064,150,740,151,3.6544117647058822
637,5,5,0,882904064,882904065,1,151,274,3.5609756097560976
637,5,2,-3,882904065,882904148,83,274,1060,3.235294117647059
637,2,4,2,882904148,882904233,85,1060,742,3.5555555555555554
637,4,3,-1,882904233,882904537,304,742,595,2.9166666666666665
637,3,1,-2,882904537,882904678,141,595,411,2.911764705882353
637,1,2,1,882904678,882904679,1,411,280,3.103448275862069
637,2,3,1,882904679,882904829,150,280,685,3.2666666666666666
637,3,2,-1,882904829,882904898,69,685,926,2.7857142857142856
637,2,1,-1,882904898,882904961,63,926,1011,3.1
637,1,3,2,882904961,882905070,109,1011,148,3.2131147540983607
637,3,3,0,882905070,882905182,112,148,1028,2.857142857142857
637,3,4,1,882905182,882905183,1,1028,291,3.2
637,4,2,-2,882905183,882905284,101,291,985,2.9
637,2,1,-1,882905284,882905285,1,985,934,3.0294117647058822
637,1,2,1,882905285,882905388,103,934,460,3.0
637,2,3,1,882905388,882905572,184,460,717,2.9696969696969697
640,4,5,1,874777440,874777491,51,11,12,4.358974358974359
640,5,4,-1,874777491,874777623,132,12,474,4.172413793103448
640,4,4,0,874777623,874777658,35,474,770,3.25
640,4,5,1,874777658,874777701,43,770,64,4.373737373737374
640,5,4,-1,874777701,874777735,34,64,47,3.5869565217391304
640,4,5,1,874777735,874777765,30,47,55,4.051282051282051
640,5,5,0,874777765,874777890,125,55,169,4.548387096774194
640,5,5,0,874777890,874777925,35,169,182,3.842857142857143
640,5,5,0,874777925,874777948,23,182,318,4.5046728971962615
640,5,5,0,874777948,874777974,26,318,204,3.6744186046511627
640,5,4,-1,874777974,874777998,24,204,91,3.6
640,4,4,0,874777998,874778065,67,91,70,3.5833333333333335
640,4,5,1,874778065,874778095,30,70,941,3.5
640,5,5,0,874778095,874778096,1,941,580,3.625
640,5,5,0,874778096,874778154,58,580,209,3.8275862068965516
640,5,5,0,874778154,874778181,27,209,189,3.88
640,5,5,0,874778181,874778207,26,189,693,3.6285714285714286
640,5,5,0,874778207,874778240,33,693,663,3.948717948717949
640,5,5,0,874778240,874778299,59,663,428,3.744186046511628
640,5,5,0,874778299,874778345,46,428,42,3.893617021276596
640,5,5,0,874778345,874778366,21,42,202,3.730337078651685
640,5,5,0,874778366,874778424,58,202,231,2.938775510204082
640,5,4,-1,874778424,874778479,55,231,22,4.215909090909091
640,4,4,0,874778479,874778568,89,22,2,3.0851063829787235
640,4,5,1,874778568,874778569,1,2,385,3.6129032258064515
640,5,4,-1,874778569,874778612,43,385,38,2.784313725490196
640,4,5,1,874778612,874778613,1,38,761,3.0588235294117645
640,5,3,-2,874778613,874778696,83,761,33,3.2941176470588234
640,3,4,1,874778696,874778722,26,33,550,3.272727272727273
640,4,3,-1,874778722,874778756,34,550,802,3.076923076923077
640,3,5,2,874778756,876067710,1288954,802,210,3.921259842519685
640,5,5,0,876067710,886353780,10286070,210,342,2.64
640,5,4,-1,886353780,886353852,72,342,689,3.1538461538461537
640,4,5,1,886353852,886353894,42,689,315,4.15
640,5,5,0,886353894,886354270,376,315,173,4.1441441441441444
640,5,4,-1,886354270,886474493,120223,173,150,3.803921568627451
640,4,4,0,886474493,886474515,22,150,151,3.6544117647058822
640,4,4,0,886474515,886474538,23,151,952,3.3529411764705883
640,4,4,0,886474538,886474802,264,952,126,3.8620689655172415
640,4,3,-1,886474802,886474833,31,126,827,2.4375
640,3,3,0,886474833,886474849,16,827,1244,2.7777777777777777
640,3,3,0,886474849,886474866,17,1244,1258,2.3333333333333335
640,3,3,0,886474866,886474913,47,1258,926,2.7857142857142856
640,3,3,0,886474913,886474977,64,926,369,2.5714285714285716
640,3,4,1,886474977,889235993,2761016,369,1228,2.5
626,3,1,-2,878771243,878771281,38,288,292,3.6666666666666665
626,1,3,2,878771281,878771355,74,292,332,3.6511627906976742
626,3,1,-2,878771355,878771418,63,332,879,3.2291666666666665
626,1,4,3,878771418,878771419,1,879,327,3.5076923076923077
626,4,1,-3,878771419,878771477,58,327,336,2.4
626,1,1,0,878771477,878771505,28,336,358,2.6551724137931036
626,1,5,4,878771505,887772922,9001417,358,923,4.142857142857143
643,4,3,-1,891445176,891445230,54,408,282,3.610526315789474
643,3,5,2,891445230,891445312,82,282,246,4.0
643,5,3,-2,891445312,891445476,164,246,845,3.661290322580645
643,3,3,0,891445476,891445526,50,845,147,3.3142857142857145
643,3,4,1,891445526,891445550,24,147,1012,3.2916666666666665
643,4,4,0,891445550,891445597,47,1012,410,3.0434782608695654
643,4,4,0,891445597,891445660,63,410,928,3.142857142857143
643,4,4,0,891445660,891445698,38,928,235,3.106382978723404
643,4,2,-2,891445698,891445741,43,235,118,3.2764227642276422
643,2,5,3,891445741,891445823,82,118,150,3.803921568627451
643,5,3,-2,891445823,891445859,36,150,405,3.25
643,3,3,0,891445859,891446323,464,405,249,3.3275862068965516
643,3,3,0,891446323,891446381,58,249,820,3.0444444444444443
643,3,3,0,891446381,891446404,23,820,1028,2.857142857142857
643,3,3,0,891446404,891446489,85,1028,1215,2.0714285714285716
643,3,2,-1,891446489,891446581,92,1215,325,2.625
643,2,5,3,891446581,891446652,71,325,209,3.8275862068965516
643,5,3,-2,891446652,891446688,36,209,98,4.240875912408759
643,3,4,1,891446688,891446720,32,98,11,3.8904109589041096
643,4,4,0,891446720,891446750,30,11,42,3.893617021276596
643,4,5,1,891446750,891446791,41,42,56,4.051724137931035
643,5,4,-1,891446791,891446826,35,56,79,3.956989247311828
643,4,4,0,891446826,891446854,28,79,114,4.3478260869565215
643,4,5,1,891446854,891446889,35,114,357,4.063291139240507
643,5,4,-1,891446889,891446919,30,357,443,3.8421052631578947
643,4,5,1,891446919,891446955,36,443,474,4.172413793103448
643,5,4,-1,891446955,891446956,1,474,203,3.826923076923077
643,4,4,0,891446956,891446983,27,203,197,4.112676056338028
643,4,3,-1,891446983,891447037,54,197,215,3.662921348314607
643,3,4,1,891447037,891447063,26,215,482,3.9444444444444446
643,4,5,1,891447063,891447127,64,482,659,4.027777777777778
643,5,5,0,891447127,891447157,30,659,185,3.9726027397260273
643,5,4,-1,891447157,891447196,39,185,153,3.7865168539325844
643,4,4,0,891447196,891447222,26,153,169,4.548387096774194
643,4,4,0,891447222,891447260,38,169,228,3.7246376811594204
643,4,4,0,891447260,891447286,26,228,144,3.9545454545454546
643,4,5,1,891447286,891447314,28,144,435,3.8933333333333335
643,5,3,-2,891447314,891447338,24,435,68,3.5714285714285716
643,3,5,2,891447338,891447403,65,68,430,4.136363636363637
643,5,3,-2,891447403,891447430,27,430,69,3.8015873015873014
643,3,4,1,891447430,891447459,29,69,32,3.7222222222222223
643,4,4,0,891447459,891447485,26,32,99,3.8392857142857144
643,4,4,0,891447485,891447617,132,99,211,3.958904109589041
643,4,4,0,891447617,891447663,46,211,186,3.905263157894737
643,4,4,0,891447663,891447696,33,186,223,4.108695652173913
643,4,4,0,891447696,891447747,51,223,663,3.948717948717949
643,4,5,1,891447747,891447790,43,663,183,3.951219512195122
643,5,3,-2,891447790,891447835,45,183,1149,3.857142857142857
643,3,3,0,891447835,891447868,33,1149,732,3.6266666666666665
643,3,3,0,891447868,891447901,33,732,204,3.6744186046511627
643,3,3,0,891447901,891447930,29,204,631,3.581818181818182
643,3,4,1,891447930,891447959,29,631,404,3.6578947368421053
643,4,4,0,891447959,891448062,103,404,58,3.543859649122807
643,4,3,-1,891448062,891448095,33,58,82,3.6741573033707864
643,3,5,2,891448095,891448136,41,82,208,3.8125
643,5,3,-2,891448136,891448218,82,208,2,3.0851063829787235
643,3,5,2,891448218,891448265,47,2,132,3.929411764705882
643,5,4,-1,891448265,891448318,53,132,210,3.921259842519685
643,4,4,0,891448318,891448352,34,210,470,3.72
643,4,3,-1,891448352,891448436,84,470,162,3.4651162790697674
643,3,3,0,891448436,891448502,66,162,527,3.823529411764706
643,3,2,-1,891448502,891448630,128,527,1074,2.857142857142857
643,2,4,2,891448630,891449301,671,1074,72,3.175438596491228
643,4,3,-1,891449301,891449344,43,72,385,3.6129032258064515
643,3,2,-1,891449344,891449345,1,385,155,3.0588235294117645
643,2,2,0,891449345,891449417,72,155,88,3.433734939759036
643,2,4,2,891449417,891449476,59,88,67,3.106382978723404
643,4,3,-1,891449476,891449507,31,67,716,3.1904761904761907
643,3,3,0,891449507,891449534,27,716,403,3.298507462686567
643,3,3,0,891449534,891449557,23,403,77,3.3857142857142857
643,3,3,0,891449557,891449580,23,77,448,3.466666666666667
643,3,3,0,891449580,891449640,60,448,229,3.185185185185185
643,3,3,0,891449640,891449680,40,229,218,3.5555555555555554
643,3,3,0,891449680,891449681,1,218,824,2.590909090909091
643,3,4,1,891449681,891449719,38,824,53,2.9523809523809526
643,4,3,-1,891449719,891449741,22,53,5,3.1481481481481484
643,3,5,2,891449741,891449771,30,5,432,3.719298245614035
643,5,4,-1,891449771,891449803,32,432,420,3.5652173913043477
643,4,3,-1,891449803,891449848,45,420,49,3.3
643,3,4,1,891449848,891449900,52,49,468,3.380952380952381
643,4,2,-2,891449900,891449901,1,468,29,2.5714285714285716
643,2,3,1,891449901,891449930,29,29,665,2.72972972972973
643,3,5,2,891449930,891450210,280,665,715,3.257142857142857
643,5,4,-1,891450210,891450273,63,715,393,3.5125
643,4,3,-1,891450273,891450316,43,393,1221,3.4285714285714284
643,3,3,0,891450316,891450341,25,1221,572,2.857142857142857
643,3,3,0,891450341,891450376,35,572,794,3.6
643,3,3,0,891450376,892502480,1052104,794,262,3.5217391304347827
643,3,2,-1,892502480,892502531,51,262,721,3.4583333333333335
598,3,4,1,886710494,886710612,118,751,308,3.6153846153846154
598,4,4,0,886710612,886710735,123,308,292,3.6666666666666665
598,4,2,-2,886710735,886710795,60,292,343,3.0
598,2,4,2,886710795,886711034,239,343,748,3.1043478260869564
598,4,2,-2,886711034,886711192,158,748,243,2.357142857142857
598,2,5,3,886711192,886711521,329,243,22,4.215909090909091
638,5,5,0,876694787,876694861,74,22,144,3.9545454545454546
638,5,2,-3,876694861,876694917,56,144,82,3.6741573033707864
638,2,2,0,876694917,876694995,78,82,449,2.9069767441860463
638,2,3,1,876694995,876695059,64,449,554,2.9555555555555557
638,3,4,1,876695059,876695108,49,554,4,3.5538461538461537
638,4,3,-1,876695108,876695216,108,4,128,3.45
638,3,3,0,876695216,876695217,1,128,241,3.5625
638,3,2,-1,876695217,876695259,42,241,227,3.169811320754717
638,2,4,2,876695259,876695307,48,227,685,3.2666666666666666
638,4,3,-1,876695307,876695338,31,685,405,3.25
638,3,3,0,876695338,876695385,47,405,118,3.2764227642276422
638,3,1,-2,876695385,876695415,30,118,450,2.2758620689655173
638,1,3,2,876695415,876695478,63,450,511,4.096153846153846
638,3,3,0,876695478,876695560,82,511,98,4.240875912408759
638,3,4,1,876695560,876695627,67,98,234,3.7674418604651163
638,4,4,0,876695627,876695774,147,234,410,3.0434782608695654
638,4,4,0,876695774,876695819,45,410,238,3.888888888888889
638,4,5,1,876695819,876695859,40,238,186,3.905263157894737
635,3,4,1,878878588,878878654,66,294,331,3.5517241379310347
635,4,5,1,878878654,878878685,31,331,333,3.546666666666667
635,5,3,-2,878878685,878878714,29,333,874,3.230769230769231
635,3,5,2,878878714,878878752,38,874,327,3.5076923076923077
635,5,2,-3,878878752,878878838,86,327,875,2.736842105263158
635,2,3,1,878878838,878878866,28,875,879,3.2291666666666665
635,3,3,0,878878866,878878901,35,879,877,2.619047619047619
635,3,2,-1,878878901,878879164,263,877,13,3.5454545454545454
635,2,5,3,878879164,878879190,26,13,246,4.0
635,5,3,-2,878879190,878879236,46,246,150,3.803921568627451
635,3,3,0,878879236,878879257,21,150,276,3.6036036036036037
635,3,4,1,878879257,878879283,26,276,1,3.902439024390244
635,4,2,-2,878879283,878879284,1,1,117,3.689189189189189
635,2,3,1,878879284,878879346,62,117,15,3.725663716814159
644,3,4,1,889075967,889076031,64,333,307,3.6031746031746033
644,4,4,0,889076031,889076095,64,307,294,3.1052631578947367
644,4,5,1,889076095,889076148,53,294,326,3.262295081967213
644,5,4,-1,889076148,889076173,25,326,330,2.625
644,4,4,0,889076173,889076310,137,330,873,2.7586206896551726
644,4,5,1,889076310,889076364,54,873,322,3.0476190476190474
644,5,4,-1,889076364,889076433,69,322,1025,2.95
644,4,4,0,889076433,889076475,42,1025,988,2.5555555555555554
644,4,4,0,889076475,889076851,376,988,125,3.5555555555555554
644,4,4,0,889076851,889076875,24,125,546,2.9789473684210526
644,4,4,0,889076875,889076922,47,546,977,2.473684210526316
644,4,4,0,889076922,889076949,27,977,291,3.2
644,4,4,0,889076949,889076997,48,291,823,2.75
644,4,3,-1,889076997,889077115,118,823,1610,2.5
644,3,4,1,889077115,889077189,74,1610,181,3.98974358974359
644,4,5,1,889077189,889077278,89,181,257,3.7154471544715446
644,5,4,-1,889077278,889077418,140,257,117,3.689189189189189
644,4,4,0,889077418,889077463,45,117,250,3.4698795180722892
644,4,4,0,889077463,889077513,50,250,871,2.3823529411764706
636,3,5,2,891448185,891448228,43,9,100,4.0162162162162165
636,5,3,-2,891448228,891448229,1,100,275,4.087912087912088
636,3,5,2,891448229,891448297,68,275,813,4.055555555555555
636,5,5,0,891448297,891449212,915,813,596,3.180327868852459
636,5,5,0,891449212,891449237,25,596,25,3.3185840707964602
636,5,5,0,891449237,891449263,26,25,760,2.35
636,5,5,0,891449263,891449305,42,760,118,3.2764227642276422
636,5,4,-1,891449305,891449328,23,118,106,2.8125
636,4,4,0,891449328,891449371,43,106,235,3.106382978723404
645,3,4,1,892051741,892051844,103,288,286,3.442857142857143
645,4,1,-3,892051844,892052039,195,286,748,3.1043478260869564
645,1,2,1,892052039,892052070,31,748,301,3.2465753424657535
645,2,1,-1,892052070,892052232,162,301,243,2.357142857142857
645,1,4,3,892052232,892053274,1042,243,177,3.875
645,4,4,0,892053274,892053310,36,177,28,3.923076923076923
645,4,4,0,892053310,892053340,30,28,186,3.905263157894737
645,4,5,1,892053340,892053398,58,186,474,4.172413793103448
645,5,5,0,892053398,892053429,31,474,59,4.0
645,5,4,-1,892053429,892053456,27,59,203,3.826923076923077
645,4,5,1,892053456,892053483,27,203,209,3.8275862068965516
645,5,3,-2,892053483,892053518,35,209,202,3.730337078651685
645,3,5,2,892053518,892053644,126,202,191,4.168674698795181
645,5,4,-1,892053644,892053748,104,191,173,4.1441441441441444
645,4,3,-1,892053748,892054324,576,173,39,3.107142857142857
645,3,4,1,892054324,892054364,40,39,435,3.8933333333333335
645,4,4,0,892054364,892054402,38,435,664,3.15
645,4,5,1,892054402,892054481,79,664,513,4.526315789473684
645,5,4,-1,892054481,892054537,56,513,172,4.225225225225225
645,4,4,0,892054537,892054632,95,172,658,3.393939393939394
645,4,4,0,892054632,892054684,52,658,428,3.744186046511628
645,4,4,0,892054684,892054732,48,428,216,3.8454545454545452
645,4,4,0,892054732,892054797,65,216,168,4.0476190476190474
645,4,4,0,892054797,892054824,27,168,30,3.8181818181818183
645,4,5,1,892054824,892054906,82,30,200,3.8157894736842106
645,5,5,0,892054906,892054990,84,200,653,4.0
645,5,3,-2,892054990,892055039,49,653,367,3.4242424242424243
645,3,5,2,892055039,892055072,33,367,506,3.566666666666667
645,5,3,-2,892055072,892055213,141,506,184,3.393939393939394
645,3,2,-1,892055213,892055244,31,184,627,3.3823529411764706
645,2,4,2,892055244,892055325,81,627,70,3.5833333333333335
645,4,4,0,892055325,892055389,64,70,434,3.588235294117647
645,4,4,0,892055389,892055444,55,434,87,3.9
645,4,3,-1,892055444,892055445,1,87,73,3.588235294117647
645,3,3,0,892055445,892055603,158,73,403,3.298507462686567
645,3,3,0,892055603,892055728,125,403,772,3.3333333333333335
648,5,4,-1,882211016,882211066,50,50,929,2.8421052631578947
648,4,3,-1,882211066,882211109,43,929,7,3.76056338028169
648,3,5,2,882211109,882211175,66,7,742,3.5555555555555554
648,5,2,-3,882211175,882211223,48,742,14,4.101694915254237
648,2,5,3,882211223,882211258,35,14,222,3.578125
648,5,4,-1,882211258,882211301,43,222,740,3.423076923076923
648,4,3,-1,882211301,882211348,47,740,249,3.3275862068965516
648,3,3,0,882211348,882211419,71,249,596,3.180327868852459
648,3,4,1,882211419,882211464,45,596,295,3.769230769230769
648,4,3,-1,882211464,882211532,68,295,24,3.3728813559322033
648,3,3,0,882211532,882211585,53,24,477,3.1666666666666665
648,3,5,2,882211585,882211654,69,477,121,3.521212121212121
648,5,3,-2,882211654,882211707,53,121,290,3.108108108108108
648,3,2,-1,882211707,882211760,53,290,25,3.3185840707964602
648,2,2,0,882211760,882211857,97,25,240,3.0350877192982457
648,2,3,1,882211857,882211886,29,240,748,3.1043478260869564
648,3,5,2,882211886,882211924,38,748,685,3.2666666666666666
648,5,3,-2,882211924,882211965,41,685,473,2.9166666666666665
648,3,4,1,882211965,882212039,74,473,825,2.914285714285714
648,4,4,0,882212039,882212071,32,825,235,3.106382978723404
648,4,1,-3,882212071,882212131,60,235,831,2.6097560975609757
648,1,4,3,882212131,882212200,69,831,118,3.2764227642276422
648,4,2,-2,882212200,882212288,88,118,151,3.6544117647058822
648,2,4,2,882212288,882212374,86,151,252,2.911392405063291
648,4,3,-1,882212374,882212400,26,252,926,2.7857142857142856
648,3,5,2,882212400,882212526,126,926,323,3.0
648,5,1,-4,882212526,882212527,1,323,687,2.1481481481481484
648,1,3,2,882212527,882212560,33,687,105,2.6176470588235294
648,3,3,0,882212560,882212609,49,105,21,2.9210526315789473
648,3,5,2,882212609,882212651,42,21,568,3.5853658536585367
648,5,5,0,882212651,882212708,57,568,483,4.475609756097561
648,5,3,-2,882212708,882212709,1,483,23,3.9047619047619047
648,3,3,0,882212709,882213535,826,23,238,3.888888888888889
648,3,4,1,882213535,882213596,61,238,629,3.3333333333333335
648,4,5,1,882213596,882213597,1,629,186,3.905263157894737
648,5,2,-3,882213597,884366613,2153016,186,1258,2.3333333333333335
648,2,2,0,884366613,884366748,135,1258,368,1.8823529411764706
648,2,2,0,884366748,884366939,191,368,756,2.6885245901639343
648,2,3,1,884366939,884367248,309,756,254,2.7419354838709675
648,3,1,-2,884367248,884367274,26,254,104,1.0
648,1,3,2,884367274,884368165,891,104,71,3.6575342465753424
648,3,3,0,884368165,884368232,67,71,454,3.0
648,3,5,2,884368232,884368314,82,454,234,3.7674418604651163
648,5,3,-2,884368314,884368371,57,234,95,3.8194444444444446
648,3,5,2,884368371,884368485,114,95,185,3.9726027397260273
648,5,5,0,884368485,884368538,53,185,432,3.719298245614035
648,5,4,-1,884368538,884368643,105,432,211,3.958904109589041
648,4,5,1,884368643,884628437,259794,211,28,3.923076923076923
648,5,2,-3,884628437,884628534,97,28,357,4.063291139240507
648,2,1,-1,884628534,884628564,30,357,69,3.8015873015873014
648,1,3,2,884628564,884628607,43,69,205,3.717391304347826
648,3,3,0,884628607,884628644,37,205,197,4.112676056338028
648,3,1,-2,884628644,884796598,167954,197,507,3.6285714285714286
648,1,4,3,884796598,884796652,54,507,615,3.8333333333333335
648,4,2,-2,884796652,884796689,37,615,215,3.662921348314607
648,2,4,2,884796689,884796769,80,215,497,3.35
648,4,4,0,884796769,884796822,53,497,496,4.094594594594595
648,4,5,1,884796822,884797068,246,496,168,4.0476190476190474
648,5,5,0,884797068,884881563,84495,168,430,4.136363636363637
648,5,2,-3,884881563,884881592,29,430,70,3.5833333333333335
648,2,5,3,884881592,884881621,29,70,154,3.6031746031746033
648,5,1,-4,884881621,884881646,25,154,4,3.5538461538461537
648,1,4,3,884881646,884881679,33,4,88,3.433734939759036
648,4,2,-2,884881679,884881754,75,88,428,3.744186046511628
648,2,2,0,884881754,884881807,53,428,47,3.5869565217391304
648,2,4,2,884881807,884882103,296,47,63,3.125
648,4,3,-1,884882103,884882104,1,63,722,2.9642857142857144
648,3,4,1,884882104,884882192,88,722,67,3.106382978723404
648,4,4,0,884882192,884882235,43,67,384,2.7941176470588234
648,4,3,-1,884882235,884882271,36,384,726,2.8
648,3,4,1,884882271,884882375,104,726,1003,2.8
648,4,3,-1,884882375,884882407,32,1003,110,2.25
648,3,1,-2,884882407,884882441,34,110,862,1.6666666666666667
648,1,1,0,884882441,884882501,60,862,780,3.08
648,1,1,0,884882501,884882502,1,780,1092,2.5714285714285716
648,1,2,1,884882502,884882527,25,1092,1072,3.0
648,2,2,0,884882527,884882552,25,1072,1030,2.3636363636363638
648,2,3,1,884882552,884882553,1,1030,575,2.619047619047619
648,3,1,-2,884882553,884882636,83,575,997,2.7142857142857144
648,1,5,4,884882636,884882664,28,997,188,3.625
648,5,5,0,884882664,884882702,38,188,228,3.7246376811594204
648,5,5,0,884882702,884882742,40,228,82,3.6741573033707864
648,5,3,-2,884882742,884882802,60,82,679,3.2432432432432434
648,3,3,0,884882802,884882803,1,679,227,3.169811320754717
648,3,4,1,884882803,884882916,113,227,576,3.125
648,4,2,-2,884882916,884882987,71,576,231,2.938775510204082
648,2,3,1,884882987,884883149,162,231,373,3.142857142857143
648,3,4,1,884883149,884883323,174,373,554,2.9555555555555557
648,4,2,-2,884883323,884883424,101,554,675,3.625
648,2,2,0,884883424,884883679,255,675,561,3.1515151515151514
647,4,3,-1,876530784,876531583,799,174,1014,3.1
647,3,3,0,876531583,876532501,918,1014,294,3.1052631578947367
647,3,3,0,876532501,876532517,16,294,326,3.262295081967213
647,3,3,0,876532517,876533005,488,326,298,3.779220779220779
647,3,4,1,876533005,876533810,805,298,554,2.9555555555555557
647,4,4,0,876533810,876533832,22,554,568,3.5853658536585367
647,4,4,0,876533832,876533912,80,568,82,3.6741573033707864
647,4,4,0,876533912,876534009,97,82,402,3.3076923076923075
647,4,4,0,876534009,876534041,32,402,88,3.433734939759036
647,4,4,0,876534041,876534083,42,88,72,3.175438596491228
647,4,4,0,876534083,876534131,48,72,993,3.4838709677419355
647,4,3,-1,876534131,876534151,20,993,213,3.943396226415094
647,3,4,1,876534151,876534274,123,213,121,3.521212121212121
647,4,3,-1,876534274,876534275,1,121,291,3.2
647,3,4,1,876534275,876537620,3345,291,196,3.9404761904761907
647,4,5,1,876537620,876537697,77,196,73,3.588235294117647
647,5,3,-2,876537697,876776321,238624,73,203,3.826923076923077
650,3,4,1,891368914,891368959,45,898,270,3.7804878048780486
650,4,3,-1,891368959,891368960,1,270,258,3.7547169811320753
650,3,2,-1,891368960,891369001,41,258,751,3.3896103896103895
650,2,3,1,891369001,891369022,21,751,286,3.442857142857143
650,3,3,0,891369022,891369071,49,286,309,2.3333333333333335
650,3,3,0,891369071,891369143,72,309,271,3.3134328358208953
650,3,3,0,891369143,891369190,47,271,316,4.285714285714286
650,3,2,-1,891369190,891369215,25,316,243,2.357142857142857
650,2,3,1,891369215,891369285,70,243,323,3.0
650,3,4,1,891369285,891369442,157,323,172,4.225225225225225
650,4,3,-1,891369442,891369443,1,172,404,3.6578947368421053
650,3,3,0,891369443,891369480,37,404,1031,2.6
650,3,5,2,891369480,891369520,40,1031,511,4.096153846153846
650,5,3,-2,891369520,891369587,67,511,214,3.272727272727273
650,3,3,0,891369587,891369588,1,214,735,3.58
650,3,3,0,891369588,891369620,32,735,1050,3.6153846153846154
650,3,3,0,891369620,891369656,36,1050,223,4.108695652173913
650,3,4,1,891369656,891369678,22,223,515,4.202898550724638
650,4,3,-1,891369678,891369707,29,515,22,4.215909090909091
650,3,4,1,891369707,891369759,52,22,520,4.136363636363637
650,4,4,0,891369759,891369798,39,520,164,3.6140350877192984
650,4,2,-2,891369798,891369836,38,164,227,3.169811320754717
650,2,3,1,891369836,891369890,54,227,23,3.9047619047619047
650,3,3,0,891369890,891369924,34,23,673,3.393939393939394
650,3,4,1,891369924,891369954,30,673,100,4.0162162162162165
650,4,3,-1,891369954,891370065,111,100,642,3.4285714285714284
650,3,3,0,891370065,891370066,1,642,636,3.4146341463414633
650,3,3,0,891370066,891370113,47,636,561,3.1515151515151514
650,3,2,-1,891370113,891370155,42,561,581,3.130434782608696
650,2,3,1,891370155,891370182,27,581,579,2.727272727272727
650,3,2,-1,891370182,891370243,61,579,233,3.323529411764706
650,2,4,2,891370243,891370971,728,233,663,3.948717948717949
650,4,4,0,891370971,891370998,27,663,186,3.905263157894737
650,4,3,-1,891370998,891371020,22,186,514,4.033333333333333
650,3,5,2,891371020,891371061,41,514,630,3.25
650,5,4,-1,891371061,891371091,30,630,633,3.9
650,4,4,0,891371091,891371116,25,633,181,3.98974358974359
650,4,2,-2,891371116,891371152,36,181,215,3.662921348314607
650,2,4,2,891371152,891371153,1,215,705,3.7857142857142856
650,4,4,0,891371153,891371186,33,705,478,4.161290322580645
650,4,4,0,891371186,891372233,1047,478,197,4.112676056338028
650,4,3,-1,891372233,891372286,53,197,588,3.8358208955223883
650,3,5,2,891372286,891372315,29,588,483,4.475609756097561
650,5,4,-1,891372315,891372339,24,483,657,4.341463414634147
650,4,4,0,891372339,891381546,9207,657,118,3.2764227642276422
650,4,2,-2,891381546,891381585,39,118,187,4.215189873417722
650,2,3,1,891381585,891381634,49,187,232,3.0789473684210527
650,3,3,0,891381634,891381661,27,232,550,3.272727272727273
650,3,3,0,891381661,891381709,48,550,2,3.0851063829787235
650,3,2,-1,891381709,891381745,36,2,849,2.5625
650,2,3,1,891381745,891381784,39,849,62,3.048780487804878
650,3,3,0,891381784,891381818,34,62,597,3.2771084337349397
650,3,2,-1,891381818,891381819,1,597,665,2.72972972972973
650,2,3,1,891381819,891381850,31,665,1215,2.0714285714285716
650,3,3,0,891381850,891381884,34,1215,1419,1.7142857142857142
650,3,3,0,891381884,891381993,109,1419,154,3.6031746031746033
650,3,4,1,891381993,891382032,39,154,238,3.888888888888889
650,4,3,-1,891382032,891382033,1,238,517,3.625
650,3,3,0,891382033,891382066,33,517,523,4.159090909090909
650,3,4,1,891382066,891382218,152,523,434,3.588235294117647
650,4,2,-2,891382218,891382877,659,434,281,3.2
650,2,3,1,891382877,891382928,51,281,162,3.4651162790697674
650,3,3,0,891382928,891382960,32,162,157,3.5714285714285716
650,3,3,0,891382960,891383164,204,157,180,3.9473684210526314
650,3,3,0,891383164,891383206,42,180,715,3.257142857142857
650,3,3,0,891383206,891383272,66,715,402,3.3076923076923075
650,3,3,0,891383272,891383303,31,402,1119,3.5185185185185186
650,3,3,0,891383303,891383424,121,1119,631,3.581818181818182
650,3,4,1,891383424,891383523,99,631,429,3.742857142857143
650,4,4,0,891383523,891383547,24,429,1065,3.1578947368421053
650,4,3,-1,891383547,891383572,25,1065,160,3.4
650,3,3,0,891383572,891383594,22,160,15,3.725663716814159
650,3,3,0,891383594,891383713,119,15,212,3.230769230769231
650,3,3,0,891383713,891383786,73,212,1627,3.0
650,3,2,-1,891383786,891383832,46,1627,737,3.12
650,2,4,2,891383832,891383856,24,737,1149,3.857142857142857
650,4,3,-1,891383856,891383879,23,1149,378,3.6904761904761907
650,3,3,0,891383879,891383926,47,378,809,2.7058823529411766
650,3,2,-1,891383926,891383977,51,809,1135,3.0526315789473686
650,2,1,-1,891383977,891384110,133,1135,1247,1.5
650,1,3,2,891384110,891384201,91,1247,648,3.9545454545454546
650,3,3,0,891384201,891384202,1,648,747,3.5526315789473686
650,3,3,0,891384202,891384226,24,747,88,3.433734939759036
650,3,2,-1,891384226,891384249,23,88,155,3.0588235294117645
650,2,3,1,891384249,891384285,36,155,66,3.4705882352941178
650,3,2,-1,891384285,891384328,43,66,739,3.391304347826087
650,2,2,0,891384328,891385035,707,739,301,3.2465753424657535
650,2,3,1,891385035,891385105,70,301,137,3.9545454545454546
650,3,3,0,891385105,891385178,73,137,604,3.8181818181818183
650,3,3,0,891385178,891385206,28,604,661,4.133333333333334
650,3,3,0,891385206,891385288,82,661,1474,3.0
650,3,3,0,891385288,891385422,134,1474,485,3.717948717948718
650,3,3,0,891385422,891385508,86,485,506,3.566666666666667
650,3,3,0,891385508,891385775,267,506,491,3.55
650,3,3,0,891385775,891385826,51,491,25,3.3185840707964602
650,3,3,0,891385826,891385980,154,25,501,3.289473684210526
650,3,4,1,891385980,891386047,67,501,200,3.8157894736842106
650,4,3,-1,891386047,891386120,73,200,447,3.46875
650,3,3,0,891386120,891386167,47,447,109,3.282608695652174
650,3,4,1,891386167,891386210,43,109,141,3.4827586206896552
650,4,3,-1,891386210,891386695,485,141,4,3.5538461538461537
650,3,3,0,891386695,891386755,60,4,71,3.6575342465753424
650,3,3,0,891386755,891386778,23,71,393,3.5125
650,3,4,1,891386778,891386830,52,393,432,3.719298245614035
650,4,3,-1,891386830,891386878,48,432,163,3.53125
650,3,3,0,891386878,891386964,86,163,601,3.857142857142857
650,3,3,0,891386964,891387312,348,601,416,3.3846153846153846
650,3,3,0,891387312,891387353,41,416,637,2.888888888888889
650,3,3,0,891387353,891387398,45,637,629,3.3333333333333335
650,3,3,0,891387398,891387418,20,629,151,3.6544117647058822
650,3,3,0,891387418,891387468,50,151,622,3.3333333333333335
650,3,2,-1,891387468,891387490,22,622,367,3.4242424242424243
650,2,3,1,891387490,891387520,30,367,559,3.477272727272727
650,3,3,0,891387520,891387542,22,559,73,3.588235294117647
650,3,3,0,891387542,891387571,29,73,658,3.393939393939394
650,3,3,0,891387571,891387591,20,658,417,3.0588235294117645
650,3,3,0,891387591,891387616,25,417,521,3.787878787878788
650,3,2,-1,891387616,891387725,109,521,371,3.0
650,2,2,0,891387725,891387767,42,371,21,2.9210526315789473
650,2,3,1,891387767,891387915,148,21,571,2.5
650,3,3,0,891387915,891387953,38,571,145,2.3636363636363638
650,3,2,-1,891387953,891387979,26,145,290,3.108108108108108
650,2,3,1,891387979,891388080,101,290,235,3.106382978723404
650,3,3,0,891388080,891388170,90,235,563,2.0
650,3,4,1,891388170,891388210,40,563,445,3.727272727272727
650,4,2,-2,891388210,891388266,56,445,843,2.933333333333333
650,2,3,1,891388266,891388294,28,843,926,2.7857142857142856
650,3,2,-1,891388294,891388341,47,926,444,2.6842105263157894
650,2,4,2,891388341,891388467,126,444,1110,2.85
650,4,3,-1,891388467,891389162,695,1110,217,3.1538461538461537
651,2,4,2,879348881,879348965,84,292,127,4.162790697674419
651,4,5,1,879348965,880126473,777508,127,306,4.033333333333333
651,5,3,-2,880126473,880126508,35,306,690,3.260869565217391
654,5,3,-2,887862964,887863064,100,302,288,3.5214285714285714
654,3,3,0,887863064,887863127,63,288,294,3.1052631578947367
654,3,3,0,887863127,887863194,67,294,689,3.1538461538461537
654,3,5,2,887863194,887863323,129,689,50,4.306532663316583
654,5,4,-1,887863323,887863339,16,50,237,3.7315436241610738
654,4,1,-3,887863339,887863355,16,237,508,3.6923076923076925
654,1,5,4,887863355,887863394,39,508,275,4.087912087912088
654,5,4,-1,887863394,887863436,42,275,116,3.6666666666666665
654,4,4,0,887863436,887863471,35,116,151,3.6544117647058822
654,4,3,-1,887863471,887863488,17,151,147,3.3142857142857145
654,3,2,-1,887863488,887863513,25,147,255,3.2027027027027026
654,2,3,1,887863513,887863557,44,255,15,3.725663716814159
654,3,2,-1,887863557,887863596,39,15,248,3.746268656716418
654,2,3,1,887863596,887863635,39,248,109,3.282608695652174
654,3,4,1,887863635,887863651,16,109,24,3.3728813559322033
654,4,3,-1,887863651,887863757,106,24,278,3.0357142857142856
654,3,3,0,887863757,887863779,22,278,1115,3.3846153846153846
654,3,1,-2,887863779,887863780,1,1115,13,3.5454545454545454
654,1,3,2,887863780,887863802,22,13,596,3.180327868852459
654,3,4,1,887863802,887863841,39,596,1016,3.559322033898305
654,4,4,0,887863841,887863866,25,1016,405,3.25
654,4,3,-1,887863866,887863885,19,405,1009,3.2962962962962963
654,3,2,-1,887863885,887863914,29,1009,118,3.2764227642276422
654,2,2,0,887863914,887863933,19,118,473,2.9166666666666665
654,2,3,1,887863933,887863962,29,473,535,3.380952380952381
654,3,4,1,887863962,887863981,19,535,926,2.7857142857142856
654,4,2,-2,887863981,887864031,50,926,252,2.911392405063291
654,2,3,1,887864031,887864050,19,252,1048,2.857142857142857
654,3,5,2,887864050,887864181,131,1048,173,4.1441441441441444
654,5,5,0,887864181,887864204,23,173,969,3.8947368421052633
654,5,5,0,887864204,887864230,26,969,318,4.5046728971962615
654,5,5,0,887864230,887864275,45,318,143,3.56
654,5,5,0,887864275,887864292,17,143,22,4.215909090909091
654,5,4,-1,887864292,887864308,16,22,385,3.6129032258064515
654,4,2,-2,887864308,887864330,22,385,218,3.5555555555555554
654,2,4,2,887864330,887864350,20,218,117,3.689189189189189
654,4,4,0,887864350,887864369,19,117,168,4.0476190476190474
654,4,4,0,887864369,887864414,45,168,963,3.9285714285714284
654,4,4,0,887864414,887864432,18,963,423,3.7016129032258065
654,4,4,0,887864432,887864452,20,423,238,3.888888888888889
654,4,4,0,887864452,887864471,19,238,87,3.9
654,4,5,1,887864471,887864532,61,87,114,4.3478260869565215
654,5,4,-1,887864532,887864566,34,114,1020,3.727272727272727
654,4,4,0,887864566,887864587,21,1020,215,3.662921348314607
654,4,4,0,887864587,887864588,1,215,418,3.825
654,4,4,0,887864588,887864663,75,418,70,3.5833333333333335
654,4,5,1,887864663,887864680,17,70,83,4.204081632653061
654,5,4,-1,887864680,887864697,17,83,1035,3.03125
654,4,4,0,887864697,887864757,60,1035,468,3.380952380952381
654,4,5,1,887864757,887864797,40,468,82,3.6741573033707864
654,5,4,-1,887864797,887864812,15,82,597,3.2771084337349397
654,4,4,0,887864812,887864830,18,597,4,3.5538461538461537
654,4,2,-2,887864830,887864831,1,4,81,3.2857142857142856
654,2,4,2,887864831,887864846,15,81,735,3.58
654,4,4,0,887864846,887864868,22,735,568,3.5853658536585367
654,4,3,-1,887864868,887864886,18,568,381,3.2758620689655173
654,3,5,2,887864886,887864907,21,381,144,3.9545454545454546
654,5,4,-1,887864907,887864923,16,144,720,3.2
654,4,3,-1,887864923,887864941,18,720,54,3.3714285714285714
654,3,4,1,887864941,887864976,35,54,785,3.4375
654,4,4,0,887864976,887864998,22,785,462,3.7954545454545454
653,5,5,0,878853678,878853734,56,333,748,3.1043478260869564
653,5,5,0,878853734,878853780,46,748,127,4.162790697674419
653,5,5,0,878853780,878853936,156,127,746,3.7560975609756095
653,5,5,0,878853936,878853975,39,746,56,4.051724137931035
653,5,4,-1,878853975,878854051,76,56,79,3.956989247311828
653,4,5,1,878854051,878854100,49,79,50,4.306532663316583
653,5,5,0,878854100,878854190,90,50,566,3.543859649122807
653,5,5,0,878854190,878854247,57,566,684,3.847826086956522
653,5,4,-1,878854247,878854284,37,684,523,4.159090909090909
653,4,4,0,878854284,878854383,99,523,318,4.5046728971962615
653,4,4,0,878854383,878854441,58,318,521,3.787878787878788
653,4,5,1,878854441,878854475,34,521,239,3.423076923076923
653,5,5,0,878854475,878854593,118,239,180,3.9473684210526314
653,5,4,-1,878854593,878854633,40,180,156,4.017857142857143
653,4,4,0,878854633,878854737,104,156,840,3.090909090909091
653,4,1,-3,878854737,878854906,169,840,763,3.347826086956522
653,1,1,0,878854906,878855024,118,763,410,3.0434782608695654
653,1,3,2,878855024,878855109,85,410,1023,2.5714285714285716
653,3,2,-1,878855109,878855211,102,1023,476,3.1216216216216215
653,2,4,2,878855211,878855275,64,476,291,3.2
653,4,2,-2,878855275,878855365,90,291,237,3.7315436241610738
653,2,5,3,878855365,878855483,118,237,157,3.5714285714285716
653,5,3,-2,878855483,878866475,10992,157,151,3.6544117647058822
653,3,1,-2,878866475,878866604,129,151,642,3.4285714285714284
653,1,3,2,878866604,878866636,32,642,223,4.108695652173913
653,3,2,-1,878866636,878866679,43,223,496,4.094594594594595
653,2,2,0,878866679,878866724,45,496,732,3.6266666666666665
653,2,2,0,878866724,878866755,31,732,518,3.5833333333333335
653,2,4,2,878866755,878866814,59,518,28,3.923076923076923
653,4,3,-1,878866814,878866900,86,28,216,3.8454545454545452
653,3,2,-1,878866900,878866951,51,216,152,3.6785714285714284
653,2,4,2,878866951,878866952,1,152,200,3.8157894736842106
653,4,4,0,878866952,878866995,43,200,265,3.710144927536232
653,4,4,0,878866995,878867249,254,265,448,3.466666666666667
653,4,4,0,878867249,878867272,23,448,64,4.373737373737374
653,4,3,-1,878867272,878867346,74,64,226,3.378787878787879
653,3,1,-2,878867346,878867398,52,226,407,2.611111111111111
653,1,3,2,878867398,880149897,1282499,407,132,3.929411764705882
653,3,4,1,880149897,880149927,30,132,179,3.8823529411764706
653,4,1,-3,880149927,880149965,38,179,136,3.764705882352941
653,1,4,3,880149965,880149999,34,136,492,4.117647058823529
653,4,4,0,880149999,880150019,20,492,474,4.172413793103448
653,4,2,-2,880150019,880150040,21,474,510,3.823529411764706
653,2,4,2,880150040,880150103,63,510,210,3.921259842519685
653,4,3,-1,880150103,880150104,1,210,143,3.56
653,3,1,-2,880150104,880150126,22,143,205,3.717391304347826
653,1,2,1,880150126,880150190,64,205,213,3.943396226415094
653,2,2,0,880150190,880150218,28,213,482,3.9444444444444446
653,2,3,1,880150218,880150260,42,482,194,4.029411764705882
653,3,1,-2,880150260,880150330,70,194,517,3.625
653,1,2,1,880150330,880150348,18,517,973,2.0
653,2,2,0,880150348,880150412,64,973,631,3.581818181818182
653,2,2,0,880150412,880151340,928,631,70,3.5833333333333335
653,2,4,2,880151340,880151426,86,70,198,4.04
653,4,2,-2,880151426,880151461,35,198,403,3.298507462686567
653,2,3,1,880151461,880151488,27,403,227,3.169811320754717
653,3,2,-1,880151488,880151539,51,227,196,3.9404761904761907
653,2,5,3,880151539,880151557,18,196,186,3.905263157894737
653,5,3,-2,880151557,880151599,42,186,233,3.323529411764706
653,3,4,1,880151599,880151629,30,233,163,3.53125
653,4,1,-3,880151629,880151651,22,163,693,3.6285714285714286
653,1,3,2,880151651,880151691,40,693,62,3.048780487804878
653,3,1,-2,880151691,880151734,43,62,356,3.2
653,1,3,2,880151734,880151752,18,356,526,3.909090909090909
653,3,3,0,880151752,880151794,42,526,202,3.730337078651685
653,3,1,-2,880151794,880151839,45,202,2,3.0851063829787235
653,1,2,1,880151839,880151884,45,2,692,3.56
653,2,3,1,880151884,880151918,34,692,702,2.764705882352941
653,3,3,0,880151918,880151984,66,702,380,3.4878048780487805
653,3,2,-1,880151984,880152039,55,380,423,3.7016129032258065
653,2,1,-1,880152039,880152085,46,423,1065,3.1578947368421053
653,1,3,2,880152085,880152377,292,1065,622,3.3333333333333335
653,3,2,-1,880152377,880152426,49,622,232,3.0789473684210527
653,2,3,1,880152426,880152523,97,232,54,3.3714285714285714
653,3,2,-1,880152523,880152598,75,54,708,3.3157894736842106
653,2,2,0,880152598,880152657,59,708,944,2.75
653,2,2,0,880152657,880152759,102,944,1135,3.0526315789473686
653,2,1,-1,880152759,880152800,41,1135,722,2.9642857142857144
653,1,1,0,880152800,880152819,19,722,581,3.130434782608696
653,1,1,0,880152819,880152843,24,581,573,2.909090909090909
653,1,1,0,880152843,880152864,21,573,386,2.769230769230769
653,1,2,1,880152864,880152901,37,386,366,3.4285714285714284
653,2,2,0,880152901,880152902,1,366,1028,2.857142857142857
653,2,1,-1,880152902,880152955,53,1028,576,3.125
653,1,1,0,880152955,880152989,34,576,696,3.138888888888889
653,1,1,0,880152989,880153009,20,696,578,3.066666666666667
653,1,1,0,880153009,880153040,31,578,941,3.5
653,1,2,1,880153040,880153077,37,941,63,3.125
653,2,2,0,880153077,880153099,22,63,1035,3.03125
653,2,2,0,880153099,880153123,24,1035,967,3.3333333333333335
653,2,3,1,880153123,880153145,22,967,1139,2.611111111111111
653,3,1,-2,880153145,880153207,62,1139,765,3.0
653,1,1,0,880153207,880153253,46,765,1267,2.909090909090909
653,1,2,1,880153253,880153304,51,1267,53,2.9523809523809526
653,2,1,-1,880153304,880153329,25,53,444,2.6842105263157894
653,1,2,1,880153329,880153378,49,444,142,3.1481481481481484
653,2,2,0,880153378,880153406,28,142,679,3.2432432432432434
653,2,1,-1,880153406,880153429,23,679,1132,2.588235294117647
653,1,1,0,880153429,880153467,38,1132,779,2.2
653,1,2,1,880153467,880153522,55,779,572,2.857142857142857
653,2,1,-1,880153522,880153568,46,572,1188,2.45
653,1,3,2,880153568,880153639,71,1188,712,3.0434782608695654
653,3,1,-2,880153639,880153674,35,712,395,2.5714285714285716
653,1,2,1,880153674,880153705,31,395,145,2.3636363636363638
653,2,3,1,880153705,880153740,35,145,620,3.0
653,3,2,-1,880153740,880606620,452880,620,447,3.46875
653,2,1,-1,880606620,880606675,55,447,472,2.984375
653,1,4,3,880606675,884405406,3798731,472,310,3.6666666666666665
653,4,2,-2,884405406,884405560,154,310,471,3.5714285714285716
653,2,3,1,884405560,884405596,36,471,222,3.578125
653,3,3,0,884405596,884405616,20,222,282,3.610526315789474
653,3,2,-1,884405616,884405682,66,282,1014,3.1
653,2,3,1,884405682,884405730,48,1014,248,3.746268656716418
653,3,3,0,884405730,886052040,1646310,248,742,3.5555555555555554
653,3,3,0,886052040,886052198,158,742,508,3.6923076923076925
653,3,1,-2,886052198,886052230,32,508,225,3.0714285714285716
653,1,4,3,886052230,889151716,3099486,225,300,3.6861313868613137
653,4,3,-1,889151716,890181186,1029470,300,441,2.4
653,3,4,1,890181186,893276091,3094905,441,245,3.056179775280899
655,4,3,-1,887424795,887424831,36,242,286,3.442857142857143
655,3,3,0,887424831,887424883,52,286,359,3.8
655,3,3,0,887424883,887424948,65,359,1022,3.727272727272727
655,3,3,0,887424948,887424991,43,1022,995,3.0
655,3,3,0,887424991,887425025,34,995,1265,2.75
655,3,3,0,887425025,887425070,45,1265,903,2.6666666666666665
655,3,2,-1,887425070,887425197,127,903,325,2.625
655,2,4,2,887425197,887425458,261,325,515,4.202898550724638
655,4,3,-1,887425458,887425498,40,515,1538,3.0
655,3,3,0,887425498,887425530,32,1538,295,3.769230769230769
655,3,4,1,887425530,887425564,34,295,298,3.779220779220779
655,4,3,-1,887425564,887425601,37,298,181,3.98974358974359
655,3,4,1,887425601,887425625,24,181,1380,3.0
655,4,3,-1,887425625,887425655,30,1380,1256,2.0
655,3,3,0,887425655,887425732,77,1256,1255,3.0
655,3,4,1,887425732,887425812,80,1255,6,4.333333333333333
655,4,3,-1,887425812,887425845,33,6,224,3.4545454545454546
655,3,4,1,887425845,887425936,91,224,285,4.181818181818182
655,4,3,-1,887425936,887425969,33,285,7,3.76056338028169
655,3,3,0,887425969,887426008,39,7,129,3.744186046511628
655,3,2,-1,887426008,887426030,22,129,117,3.689189189189189
655,2,3,1,887426030,887426059,29,117,1356,3.0
655,3,3,0,887426059,887426087,28,1356,124,4.052631578947368
655,3,3,0,887426087,887426116,29,124,237,3.7315436241610738
655,3,2,-1,887426116,887426200,84,237,125,3.5555555555555554
655,2,3,1,887426200,887426201,1,125,741,3.3043478260869565
655,3,3,0,887426201,887426300,99,741,1008,3.5
655,3,3,0,887426300,887426373,73,1008,1319,3.0
655,3,2,-1,887426373,887426446,73,1319,845,3.661290322580645
655,2,2,0,887426446,887426583,137,845,220,3.433333333333333
655,2,2,0,887426583,887426665,82,220,676,3.3142857142857145
655,2,2,0,887426665,887426666,1,676,685,3.2666666666666666
655,2,2,0,887426666,887426732,66,685,126,3.8620689655172415
655,2,3,1,887426732,887426770,38,126,363,3.0
655,3,3,0,887426770,887426864,94,363,197,4.112676056338028
655,3,4,1,887426864,887426900,36,197,32,3.7222222222222223
655,4,4,0,887426900,887426931,31,32,64,4.373737373737374
655,4,3,-1,887426931,887426971,40,64,23,3.9047619047619047
655,3,3,0,887426971,887426972,1,23,772,3.3333333333333335
655,3,3,0,887426972,887427009,37,772,511,4.096153846153846
655,3,4,1,887427009,887427083,74,511,135,3.7974683544303796
655,4,2,-2,887427083,887427131,48,135,582,3.7457627118644066
655,2,3,1,887427131,887427243,112,582,953,3.076923076923077
655,3,3,0,887427243,887427268,25,953,1400,3.5
655,3,2,-1,887427268,887427307,39,1400,11,3.8904109589041096
655,2,3,1,887427307,887427338,31,11,26,3.36
655,3,3,0,887427338,887427371,33,26,81,3.2857142857142856
655,3,3,0,887427371,887427441,70,81,509,3.7058823529411766
655,3,3,0,887427441,887427473,32,509,1045,3.2
655,3,4,1,887427473,887427506,33,1045,558,3.75
655,4,3,-1,887427506,887427538,32,558,1445,3.5
655,3,3,0,887427538,887427568,30,1445,527,3.823529411764706
655,3,2,-1,887427568,887427636,68,527,744,3.5714285714285716
655,2,4,2,887427636,887427681,45,744,1211,3.5714285714285716
655,4,3,-1,887427681,887427743,62,1211,57,4.133333333333334
655,3,3,0,887427743,887427778,35,57,469,3.6842105263157894
655,3,2,-1,887427778,887427840,62,469,1267,2.909090909090909
655,2,2,0,887427840,887427866,26,1267,686,3.9
655,2,3,1,887427866,887427958,92,686,959,3.4583333333333335
655,3,2,-1,887427958,887428030,72,959,433,3.8035714285714284
655,2,3,1,887428030,887428031,1,433,367,3.4242424242424243
655,3,3,0,887428031,887428060,29,367,56,4.051724137931035
655,3,4,1,887428060,887428086,26,56,216,3.8454545454545452
655,4,3,-1,887428086,887428157,71,216,186,3.905263157894737
655,3,3,0,887428157,887428184,27,186,42,3.893617021276596
655,3,3,0,887428184,887428280,96,42,451,3.207792207792208
655,3,3,0,887428280,887428334,54,451,211,3.958904109589041
655,3,3,0,887428334,887428384,50,211,1167,3.6666666666666665
655,3,1,-2,887428384,887428417,33,1167,49,3.3
655,1,3,2,887428417,887428445,28,49,732,3.6266666666666665
655,3,2,-1,887428445,887428507,62,732,239,3.423076923076923
655,2,3,1,887428507,887428559,52,239,629,3.3333333333333335
655,3,2,-1,887428559,887428671,112,629,476,3.1216216216216215
655,2,3,1,887428671,887428735,64,476,1630,3.0
655,3,4,1,887428735,887428871,136,1630,198,4.04
655,4,3,-1,887428871,887428911,40,198,1266,3.6666666666666665
655,3,3,0,887428911,887428965,54,1266,1099,3.7142857142857144
655,3,3,0,887428965,887428993,28,1099,958,4.2
655,3,3,0,887428993,887429023,30,958,1535,3.5
655,3,3,0,887429023,887429077,54,1535,1462,3.0
655,3,3,0,887429077,887429107,30,1462,1149,3.857142857142857
655,3,2,-1,887429107,887429136,29,1149,1560,2.0
655,2,3,1,887429136,887429171,35,1560,584,3.5238095238095237
655,3,2,-1,887429171,887429302,131,584,55,4.051282051282051
655,2,3,1,887429302,887429594,292,55,144,3.9545454545454546
655,3,3,0,887429594,887429640,46,144,568,3.5853658536585367
655,3,2,-1,887429640,887429669,29,568,825,2.914285714285714
655,2,3,1,887429669,887429732,63,825,226,3.378787878787879
655,3,2,-1,887429732,887429784,52,226,391,2.4285714285714284
655,2,2,0,887429784,887429875,91,391,38,2.784313725490196
655,2,2,0,887429875,887429999,124,38,176,3.967032967032967
655,2,3,1,887429999,887430072,73,176,773,3.1666666666666665
655,3,3,0,887430072,887430142,70,773,670,2.9375
655,3,2,-1,887430142,887430197,55,670,800,3.2222222222222223
655,2,3,1,887430197,887430714,517,800,642,3.4285714285714284
655,3,3,0,887430714,887430746,32,642,77,3.3857142857142857
655,3,3,0,887430746,887430778,32,77,594,2.3333333333333335
655,3,3,0,887430778,887430804,26,594,356,3.2
655,3,1,-2,887430804,887430830,26,356,717,2.9696969696969697
655,1,1,0,887430830,887431047,217,717,722,2.9642857142857144
655,1,2,1,887431047,887431157,110,722,1173,3.0
655,2,3,1,887431157,887432079,922,1173,1635,3.0
655,3,2,-1,887432079,887433538,1459,1635,337,2.0
655,2,2,0,887433538,887433780,242,337,1278,3.8333333333333335
655,2,3,1,887433780,887472671,38891,1278,707,3.909090909090909
655,3,2,-1,887472671,887472719,48,707,19,3.9615384615384617
655,2,4,2,887472719,887472744,25,19,191,4.168674698795181
655,4,3,-1,887472744,887472814,70,191,288,3.5214285714285714
655,3,2,-1,887472814,887472879,65,288,333,3.546666666666667
655,2,5,3,887472879,887473639,760,333,904,4.125
655,5,5,0,887473639,887473674,35,904,962,3.142857142857143
655,5,3,-2,887473674,887473702,28,962,311,3.761904761904762
655,3,4,1,887473702,887473727,25,311,698,3.3333333333333335
655,4,3,-1,887473727,887473753,26,698,192,4.090909090909091
655,3,4,1,887473753,887473778,25,192,276,3.6036036036036037
655,4,3,-1,887473778,887473803,25,276,345,3.4782608695652173
655,3,3,0,887473803,887473831,28,345,209,3.8275862068965516
655,3,3,0,887473831,887473856,25,209,1111,4.0
655,3,3,0,887473856,887473879,23,1111,882,3.6666666666666665
655,3,3,0,887473879,887473905,26,882,1098,3.533333333333333
655,3,3,0,887473905,887473937,32,1098,310,3.6666666666666665
655,3,3,0,887473937,887473965,28,310,195,3.9072164948453607
655,3,3,0,887473965,887473995,30,195,863,3.727272727272727
655,3,3,0,887473995,887474050,55,863,512,3.888888888888889
655,3,3,0,887474050,887474241,191,512,605,3.3333333333333335
655,3,3,0,887474241,887474288,47,605,645,3.5714285714285716
655,3,3,0,887474288,887474289,1,645,1155,3.0
655,3,3,0,887474289,887474473,184,1155,1311,2.125
655,3,4,1,887474473,887474605,132,1311,1005,4.166666666666667
655,4,3,-1,887474605,887474630,25,1005,249,3.3275862068965516
655,3,3,0,887474630,887474656,26,249,921,3.611111111111111
655,3,3,0,887474656,887474699,43,921,1140,2.1666666666666665
655,3,2,-1,887474699,887474727,28,1140,70,3.5833333333333335
655,2,2,0,887474727,887475055,328,70,726,2.8
655,2,3,1,887475055,887475213,158,726,972,3.375
655,3,2,-1,887475213,887476031,818,972,729,3.3793103448275863
655,2,2,0,887476031,887476999,968,729,116,3.6666666666666665
655,2,2,0,887476999,887477000,1,116,581,3.130434782608696
655,2,2,0,887477000,887477025,25,581,974,3.125
655,2,3,1,887477025,887477191,166,974,1010,3.611111111111111
655,3,3,0,887477191,887477192,1,1010,204,3.6744186046511627
655,3,3,0,887477192,887477216,24,204,159,3.3902439024390243
655,3,2,-1,887477216,887477262,46,159,702,2.764705882352941
655,2,3,1,887477262,887477314,52,702,265,3.710144927536232
655,3,3,0,887477314,887477336,22,265,1388,2.0
655,3,3,0,887477336,887477360,24,1388,1193,3.0
655,3,3,0,887477360,887477409,49,1193,425,3.7027027027027026
655,3,2,-1,887477409,887477489,80,425,690,3.260869565217391
655,2,2,0,887477489,887477511,22,690,1284,2.5454545454545454
655,2,3,1,887477511,887489086,11575,1284,537,3.5
655,3,1,-2,887489086,887489159,73,537,1053,3.3846153846153846
655,1,2,1,887489159,887489222,63,1053,574,2.0
655,2,2,0,887489222,887489282,60,574,1213,2.0
655,2,2,0,887489282,887491131,1849,1213,1407,2.375
655,2,3,1,887491131,887523177,32046,1407,291,3.2
655,3,3,0,887523177,887523200,23,291,31,3.642857142857143
655,3,3,0,887523200,887523224,24,31,170,4.242424242424242
655,3,3,0,887523224,887523367,143,170,464,3.8
655,3,4,1,887523367,887523427,60,464,607,4.136363636363637
655,4,3,-1,887523427,887523453,26,607,498,4.290909090909091
655,3,3,0,887523453,887523477,24,498,218,3.5555555555555554
655,3,2,-1,887523477,887523581,104,218,516,4.055555555555555
655,2,2,0,887523581,887523605,24,516,122,2.282608695652174
655,2,2,0,887523605,887523641,36,122,153,3.7865168539325844
655,2,2,0,887523641,887523664,23,153,111,3.5106382978723403
655,2,2,0,887523664,887523815,151,111,775,2.4285714285714284
655,2,4,2,887523815,887523909,94,775,305,3.5789473684210527
655,4,2,-2,887523909,887564549,40640,305,831,2.6097560975609757
655,2,4,2,887564549,887564613,64,831,651,3.8627450980392157
655,4,3,-1,887564613,887564614,1,651,60,4.105263157894737
655,3,2,-1,887564614,887564639,25,60,44,3.1333333333333333
655,2,3,1,887564639,887611537,46898,44,1041,3.3333333333333335
655,3,3,0,887611537,887611566,29,1041,1017,3.0
655,3,3,0,887611566,887611594,28,1017,1134,2.888888888888889
655,3,2,-1,887611594,887611649,55,1134,4,3.5538461538461537
655,2,3,1,887611649,887650512,38863,4,1233,3.0
655,3,3,0,887650512,887650538,26,1233,205,3.717391304347826
655,3,2,-1,887650538,887650593,55,205,699,3.736842105263158
655,2,5,3,887650593,887650683,90,699,514,4.033333333333333
655,5,3,-2,887650683,887650714,31,514,1578,3.0
655,3,3,0,887650714,887650851,137,1578,723,3.5384615384615383
655,3,2,-1,887650851,887650876,25,723,1,3.902439024390244
655,2,4,2,887650876,887650943,67,1,270,3.7804878048780486
655,4,3,-1,887650943,887651060,117,270,121,3.521212121212121
655,3,2,-1,887651060,887651149,89,121,572,2.857142857142857
655,2,3,1,887651149,887768594,117445,572,1395,3.0
655,3,2,-1,887768594,887860616,92022,1395,435,3.8933333333333335
655,2,4,2,887860616,888474106,613490,435,133,3.7777777777777777
655,4,4,0,888474106,888474107,1,133,479,4.25
655,4,3,-1,888474107,888474138,31,479,733,3.3333333333333335
655,3,3,0,888474138,888474165,27,733,162,3.4651162790697674
655,3,3,0,888474165,888474285,120,162,655,3.7857142857142856
655,3,3,0,888474285,888474286,1,655,1600,4.0
655,3,1,-2,888474286,888474327,41,1600,1644,1.0
655,1,5,4,888474327,888474357,30,1644,187,4.215189873417722
655,5,2,-3,888474357,888474390,33,187,481,3.8421052631578947
655,2,2,0,888474390,888474424,34,481,22,4.215909090909091
655,2,3,1,888474424,888474456,32,22,43,3.1
655,3,2,-1,888474456,888474490,34,43,252,2.911392405063291
655,2,4,2,888474490,888474646,156,252,1418,3.6666666666666665
655,4,2,-2,888474646,888474679,33,1418,1436,2.0
655,2,4,2,888474679,888474713,34,1436,346,3.5128205128205128
655,4,2,-2,888474713,888474742,29,346,326,3.262295081967213
655,2,3,1,888474742,888474807,65,326,269,4.085106382978723
655,3,2,-1,888474807,888474843,36,269,1238,3.0
655,2,3,1,888474843,888474872,29,1238,274,3.5609756097560976
655,3,3,0,888474872,888474909,37,274,1063,3.642857142857143
655,3,4,1,888474909,888474934,25,1063,1176,4.0
655,4,3,-1,888474934,888474960,26,1176,462,3.7954545454545454
655,3,3,0,888474960,888474986,26,462,1141,3.6666666666666665
655,3,3,0,888474986,888475015,29,1141,963,3.9285714285714284
655,3,2,-1,888475015,888475101,86,963,304,3.5306122448979593
655,2,3,1,888475101,888685734,210633,304,736,4.083333333333333
655,3,3,0,888685734,888685735,1,736,961,3.4545454545454546
655,3,2,-1,888685735,888685787,52,961,21,2.9210526315789473
655,2,3,1,888685787,888685850,63,21,1605,3.0
655,3,3,0,888685850,888685879,29,1605,1379,3.0
655,3,2,-1,888685879,888685914,35,1379,535,3.380952380952381
655,2,2,0,888685914,888685955,41,535,36,2.4
655,2,3,1,888685955,888685989,34,36,649,3.625
655,3,2,-1,888685989,888686011,22,649,761,3.0588235294117645
655,2,3,1,888686011,888813272,127261,761,208,3.8125
655,3,3,0,888813272,888813306,34,208,474,4.172413793103448
655,3,4,1,888813306,888813371,65,474,507,3.6285714285714286
655,4,2,-2,888813371,888813416,45,507,906,3.8333333333333335
655,2,2,0,888813416,888893313,79897,906,576,3.125
655,2,2,0,888893313,888984293,90980,576,375,2.076923076923077
655,2,3,1,888984293,888984325,32,375,1406,3.3333333333333335
655,3,2,-1,888984325,888984354,29,1406,980,3.142857142857143
655,2,2,0,888984354,888984386,32,980,1273,2.5714285714285716
655,2,3,1,888984386,888984417,31,1273,251,3.8333333333333335
655,3,3,0,888984417,888984478,61,251,27,3.235294117647059
655,3,3,0,888984478,888984538,60,27,1198,3.0
655,3,3,0,888984538,888984539,1,1198,1351,2.5
655,3,2,-1,888984539,890497653,1513114,1351,730,3.8
655,2,2,0,890497653,891585279,1087626,730,847,3.7333333333333334
655,2,2,0,891585279,891585344,65,847,1142,4.0476190476190474
655,2,3,1,891585344,891585380,36,1142,792,3.793103448275862
655,3,3,0,891585380,891585450,70,792,766,3.3333333333333335
655,3,3,0,891585450,891585477,27,766,1281,3.0
655,3,3,0,891585477,891585504,27,1281,1007,4.117647058823529
655,3,3,0,891585504,891585530,26,1007,166,4.0
655,3,2,-1,891585530,891585573,43,166,672,2.7222222222222223
655,2,2,0,891585573,891585574,1,672,1549,2.0
655,2,2,0,891585574,891817472,231898,1549,1106,3.0
655,2,4,2,891817472,891817521,49,1106,913,2.5
655,4,3,-1,891817521,891817522,1,913,912,3.0
655,3,3,0,891817522,891913577,96055,912,1646,3.0
655,3,2,-1,891913577,892333973,420396,1646,902,3.9444444444444446
655,2,3,1,892333973,892333993,20,902,1649,3.0
655,3,2,-1,892333993,892436609,102616,1649,918,3.3333333333333335
649,5,3,-2,891440235,891440274,39,1,815,3.135135135135135
649,3,4,1,891440274,891440293,19,815,298,3.779220779220779
649,4,4,0,891440293,891440309,16,298,181,3.98974358974359
649,4,5,1,891440309,891440330,21,181,291,3.2
649,5,5,0,891440330,891440356,26,291,127,4.162790697674419
649,5,4,-1,891440356,891440373,17,127,15,3.725663716814159
649,4,5,1,891440373,891440460,87,15,117,3.689189189189189
649,5,5,0,891440460,891440496,36,117,257,3.7154471544715446
649,5,4,-1,891440496,891440511,15,257,1016,3.559322033898305
649,4,2,-2,891440511,891440528,17,1016,1283,2.9
649,2,3,1,891440528,891440562,34,1283,678,2.8181818181818183
649,3,3,0,891440562,891440624,62,678,323,3.0
649,3,4,1,891440624,891440695,71,323,254,2.7419354838709675
658,2,3,1,875145572,875145614,42,1079,181,3.98974358974359
658,3,4,1,875145614,875145667,53,181,475,3.956043956043956
658,4,3,-1,875145667,875145750,83,475,477,3.1666666666666665
658,3,3,0,875145750,875145841,91,477,628,3.573529411764706
658,3,3,0,875145841,875147591,1750,628,772,3.3333333333333335
658,3,4,1,875147591,875147873,282,772,518,3.5833333333333335
658,4,4,0,875147873,875147935,62,518,192,4.090909090909091
658,4,4,0,875147935,875147994,59,192,433,3.8035714285714284
658,4,3,-1,875147994,875147995,1,433,730,3.8
658,3,3,0,875147995,875148059,64,730,724,3.64
658,3,4,1,875148059,875148196,137,724,318,4.5046728971962615
658,4,4,0,875148196,875148262,66,318,273,3.5238095238095237
658,4,5,1,875148262,875148319,57,273,151,3.6544117647058822
656,3,3,0,892318450,892318488,38,316,346,3.5128205128205128
656,3,4,1,892318488,892318553,65,346,303,3.75
656,4,2,-2,892318553,892318614,61,303,300,3.6861313868613137
656,2,2,0,892318614,892318738,124,300,327,3.5076923076923077
656,2,2,0,892318738,892318777,39,327,903,2.6666666666666665
656,2,1,-1,892318777,892319084,307,903,245,3.056179775280899
656,1,1,0,892319084,892319238,154,245,322,3.0476190476190474
656,1,2,1,892319238,892319276,38,322,689,3.1538461538461537
660,4,3,-1,891197481,891197503,22,272,307,3.6031746031746033
660,3,3,0,891197503,891197561,58,307,271,3.3134328358208953
660,3,3,0,891197561,891197585,24,271,328,3.4895833333333335
660,3,2,-1,891197585,891197639,54,328,266,2.6666666666666665
660,2,3,1,891197639,891197661,22,266,301,3.2465753424657535
660,3,4,1,891197661,891197778,117,301,259,2.492063492063492
660,4,2,-2,891197778,891197796,18,259,358,2.6551724137931036
660,2,4,2,891197796,891197934,138,358,257,3.7154471544715446
660,4,4,0,891197934,891197980,46,257,50,4.306532663316583
660,4,4,0,891197980,891197998,18,50,181,3.98974358974359
660,4,3,-1,891197998,891198063,65,181,100,4.0162162162162165
660,3,4,1,891198063,891198174,111,100,250,3.4698795180722892
660,4,3,-1,891198174,891198203,29,250,7,3.76056338028169
660,3,3,0,891198203,891198277,74,7,24,3.3728813559322033
660,3,2,-1,891198277,891198312,35,24,742,3.5555555555555554
660,2,5,3,891198312,891198335,23,742,151,3.6544117647058822
660,5,3,-2,891198335,891198401,66,151,235,3.106382978723404
660,3,3,0,891198401,891198421,20,235,125,3.5555555555555554
660,3,2,-1,891198421,891198441,20,125,1615,3.5
660,2,2,0,891198441,891198459,18,1615,252,2.911392405063291
660,2,2,0,891198459,891198479,20,252,118,3.2764227642276422
660,2,2,0,891198479,891198549,70,118,825,2.914285714285714
660,2,2,0,891198549,891198588,39,825,546,2.9789473684210526
660,2,2,0,891198588,891198762,174,546,930,2.793103448275862
660,2,4,2,891198762,891199017,255,930,172,4.225225225225225
660,4,3,-1,891199017,891199035,18,172,64,4.373737373737374
660,3,3,0,891199035,891199056,21,64,510,3.823529411764706
660,3,3,0,891199056,891199082,26,510,496,4.094594594594595
660,3,4,1,891199082,891199104,22,496,211,3.958904109589041
660,4,2,-2,891199104,891199133,29,211,87,3.9
660,2,4,2,891199133,891199153,20,87,134,4.174603174603175
660,4,3,-1,891199153,891199182,29,134,176,3.967032967032967
660,3,4,1,891199182,891199201,19,176,208,3.8125
660,4,2,-2,891199201,891199241,40,208,265,3.710144927536232
660,2,4,2,891199241,891199262,21,265,22,4.215909090909091
660,4,4,0,891199262,891199293,31,22,174,4.253521126760563
660,4,2,-2,891199293,891199348,55,174,79,3.956989247311828
660,2,3,1,891199348,891199367,19,79,175,3.8354430379746836
660,3,4,1,891199367,891199391,24,175,68,3.5714285714285716
660,4,5,1,891199391,891199477,86,68,168,4.0476190476190474
660,5,4,-1,891199477,891199478,1,168,746,3.7560975609756095
660,4,4,0,891199478,891199557,79,746,196,3.9404761904761907
660,4,2,-2,891199557,891199579,22,196,657,4.341463414634147
660,2,3,1,891199579,891199683,104,657,132,3.929411764705882
660,3,4,1,891199683,891199747,64,132,430,4.136363636363637
660,4,2,-2,891199747,891199804,57,430,216,3.8454545454545452
660,2,2,0,891199804,891199833,29,216,663,3.948717948717949
660,2,3,1,891199833,891199856,23,663,144,3.9545454545454546
660,3,2,-1,891199856,891199883,27,144,470,3.72
660,2,3,1,891199883,891199942,59,470,710,3.41025641025641
660,3,3,0,891199942,891199965,23,710,89,3.9615384615384617
660,3,2,-1,891199965,891199992,27,89,163,3.53125
660,2,2,0,891199992,891200014,22,163,357,4.063291139240507
660,2,3,1,891200014,891200073,59,357,527,3.823529411764706
660,3,3,0,891200073,891200193,120,527,228,3.7246376811594204
660,3,2,-1,891200193,891200213,20,228,182,3.842857142857143
660,2,3,1,891200213,891200340,127,182,238,3.888888888888889
660,3,4,1,891200340,891200388,48,238,153,3.7865168539325844
660,4,3,-1,891200388,891200406,18,153,97,3.7282608695652173
660,3,3,0,891200406,891200430,24,97,96,3.9130434782608696
660,3,2,-1,891200430,891200456,26,96,47,3.5869565217391304
660,2,3,1,891200456,891200513,57,47,201,3.75
660,3,4,1,891200513,891200534,21,201,154,3.6031746031746033
660,4,3,-1,891200534,891200594,60,154,774,3.0
660,3,2,-1,891200594,891200621,27,774,404,3.6578947368421053
660,2,4,2,891200621,891200639,18,404,747,3.5526315789473686
660,4,4,0,891200639,891200658,19,747,431,3.422222222222222
660,4,4,0,891200658,891200678,20,431,1050,3.6153846153846154
660,4,2,-2,891200678,891200704,26,1050,99,3.8392857142857144
660,2,3,1,891200704,891200741,37,99,184,3.393939393939394
660,3,2,-1,891200741,891200817,76,184,217,3.1538461538461537
660,2,2,0,891200817,891200904,87,217,386,2.769230769230769
660,2,2,0,891200904,891201026,122,386,755,3.085714285714286
660,2,2,0,891201026,891201069,43,755,679,3.2432432432432434
660,2,2,0,891201069,891201151,82,679,2,3.0851063829787235
660,2,2,0,891201151,891201172,21,2,227,3.169811320754717
660,2,1,-1,891201172,891201223,51,227,640,2.75
660,1,3,2,891201223,891201243,20,640,101,3.4827586206896552
660,3,2,-1,891201243,891201294,51,101,1411,2.4615384615384617
660,2,2,0,891201294,891201346,52,1411,90,3.0
660,2,1,-1,891201346,891201399,53,90,1074,2.857142857142857
660,1,2,1,891201399,891201419,20,1074,1133,3.076923076923077
660,2,3,1,891201419,891201436,17,1133,72,3.175438596491228
660,3,2,-1,891201436,891201499,63,72,569,2.4285714285714284
660,2,2,0,891201499,891201521,22,569,1078,2.625
660,2,2,0,891201521,891201541,20,1078,550,3.272727272727273
660,2,2,0,891201541,891201674,133,550,40,2.7037037037037037
660,2,2,0,891201674,891201696,22,40,946,3.1153846153846154
660,2,2,0,891201696,891201753,57,946,797,3.1538461538461537
660,2,3,1,891201753,891201796,43,797,449,2.9069767441860463
660,3,2,-1,891201796,891201823,27,449,84,3.0
660,2,1,-1,891201823,891201859,36,84,67,3.106382978723404
660,1,2,1,891201859,891201887,28,67,542,2.888888888888889
660,2,2,0,891201887,891201948,61,542,444,2.6842105263157894
660,2,2,0,891201948,891201966,18,444,1139,2.611111111111111
660,2,1,-1,891201966,891202022,56,1139,1419,1.7142857142857142
660,1,2,1,891202022,891202060,38,1419,139,2.7222222222222223
660,2,3,1,891202060,891265495,63435,139,810,2.9473684210526314
659,3,3,0,891044882,891044991,109,50,315,4.15
659,3,3,0,891044991,891045161,170,315,255,3.2027027027027026
659,3,4,1,891045161,891045266,105,255,1138,3.0
659,4,4,0,891045266,891045892,626,1138,216,3.8454545454545452
659,4,3,-1,891045892,891045943,51,216,170,4.242424242424242
659,3,3,0,891045943,891331322,285379,170,319,3.0408163265306123
659,3,4,1,891331322,891331361,39,319,13,3.5454545454545454
659,4,4,0,891331361,891331417,56,13,693,3.6285714285714286
659,4,3,-1,891331417,891331534,117,693,476,3.1216216216216215
659,3,3,0,891331534,891331564,30,476,7,3.76056338028169
659,3,5,2,891331564,891331916,352,7,661,4.133333333333334
659,5,5,0,891331916,891331959,43,661,606,4.294117647058823
659,5,3,-2,891331959,891332006,47,606,520,4.136363636363637
659,3,4,1,891332006,891332044,38,520,182,3.842857142857143
659,4,4,0,891332044,891332122,78,182,1172,3.4
659,4,4,0,891332122,891332158,36,1172,524,4.166666666666667
659,4,4,0,891332158,891332189,31,524,134,4.174603174603175
659,4,4,0,891332189,891332223,34,134,185,3.9726027397260273
659,4,5,1,891332223,891332224,1,185,526,3.909090909090909
659,5,5,0,891332224,891332261,37,526,178,4.378378378378378
659,5,5,0,891332261,891383561,51300,178,805,3.909090909090909
659,5,4,-1,891383561,891383636,75,805,157,3.5714285714285716
659,4,4,0,891383636,891383674,38,157,482,3.9444444444444446
659,4,4,0,891383674,891383733,59,482,486,3.9565217391304346
659,4,3,-1,891383733,891383917,184,486,4,3.5538461538461537
659,3,4,1,891383917,891384003,86,4,792,3.793103448275862
659,4,4,0,891384003,891384036,33,792,79,3.956989247311828
659,4,1,-3,891384036,891384077,41,79,179,3.8823529411764706
659,1,3,2,891384077,891384107,30,179,181,3.98974358974359
659,3,4,1,891384107,891384215,108,181,174,4.253521126760563
659,4,4,0,891384215,891384372,157,174,192,4.090909090909091
659,4,5,1,891384372,891384499,127,192,521,3.787878787878788
659,5,4,-1,891384499,891384526,27,521,654,4.119047619047619
659,4,4,0,891384526,891384552,26,654,96,3.9130434782608696
659,4,4,0,891384552,891384606,54,96,164,3.6140350877192984
659,4,4,0,891384606,891384637,31,164,89,3.9615384615384617
659,4,2,-2,891384637,891384739,102,89,474,4.172413793103448
659,2,4,2,891384739,891384798,59,474,218,3.5555555555555554
659,4,3,-1,891384798,891384823,25,218,647,4.142857142857143
659,3,3,0,891384823,891384916,93,647,69,3.8015873015873014
659,3,5,2,891384916,891384973,57,69,143,3.56
659,5,5,0,891384973,891385044,71,143,514,4.033333333333333
659,5,3,-2,891385044,891385079,35,514,735,3.58
659,3,5,2,891385079,891385080,1,735,197,4.112676056338028
659,5,3,-2,891385080,891385166,86,197,367,3.4242424242424243
659,3,3,0,891385166,891385197,31,367,186,3.905263157894737
659,3,4,1,891385197,891385258,61,186,1203,4.0
659,4,4,0,891385258,891385306,48,1203,202,3.730337078651685
659,4,3,-1,891385306,891385379,73,202,506,3.566666666666667
659,3,3,0,891385379,891385438,59,506,167,2.8181818181818183
659,3,5,2,891385438,891385534,96,167,451,3.207792207792208
659,5,2,-3,891385534,891385689,155,451,670,2.9375
659,2,5,3,891385689,891385866,177,670,481,3.8421052631578947
659,5,4,-1,891385866,891385986,120,481,602,3.533333333333333
659,4,5,1,891385986,891386071,85,602,86,3.869565217391304
659,5,3,-2,891386071,891386241,170,86,601,3.857142857142857
659,3,3,0,891386241,891386307,66,601,837,4.0
659,3,3,0,891386307,891386347,40,837,942,3.4545454545454546
659,3,3,0,891386347,891386492,145,942,161,3.5844155844155843
659,3,4,1,891386492,891386540,48,161,159,3.3902439024390243
659,4,4,0,891386540,891386680,140,159,629,3.3333333333333335
659,4,5,1,891386680,891386829,149,629,175,3.8354430379746836
659,5,4,-1,891386829,891386936,107,175,675,3.625
659,4,4,0,891386936,891387022,86,675,739,3.391304347826087
659,4,3,-1,891387022,891387054,32,739,393,3.5125
659,3,4,1,891387054,891387083,29,393,73,3.588235294117647
659,4,3,-1,891387083,891387121,38,73,241,3.5625
659,3,4,1,891387121,891387194,73,241,226,3.378787878787879
659,4,3,-1,891387194,891387227,33,226,762,3.3962264150943398
659,3,2,-1,891387227,891387306,79,762,1297,3.0
659,2,3,1,891387306,891387351,45,1297,578,3.066666666666667
659,3,3,0,891387351,891387399,48,578,214,3.272727272727273
659,3,3,0,891387399,891387400,1,214,636,3.4146341463414633
646,3,3,0,888528417,888528418,1,690,300,3.6861313868613137
646,3,5,2,888528418,888528457,39,300,313,4.323076923076923
646,5,4,-1,888528457,888528483,26,313,272,4.2
646,4,3,-1,888528483,888528902,419,272,750,4.027777777777778
646,3,3,0,888528902,888528927,25,750,286,3.442857142857143
646,3,4,1,888528927,888528955,28,286,1176,4.0
646,4,3,-1,888528955,888528978,23,1176,895,3.142857142857143
646,3,3,0,888528978,888529014,36,895,877,2.619047619047619
646,3,3,0,888529014,888529054,40,877,319,3.0408163265306123
646,3,3,0,888529054,888529080,26,319,893,2.625
646,3,3,0,888529080,888529127,47,893,880,2.8421052631578947
646,3,1,-2,888529127,888529153,26,880,352,1.8333333333333333
646,1,3,2,888529153,888529180,27,352,1313,3.142857142857143
663,3,4,1,889491560,889491617,57,258,288,3.5214285714285714
663,4,5,1,889491617,889491655,38,288,333,3.546666666666667
663,5,4,-1,889491655,889491690,35,333,307,3.6031746031746033
663,4,2,-2,889491690,889491739,49,307,299,3.0
663,2,3,1,889491739,889491811,72,299,294,3.1052631578947367
663,3,4,1,889491811,889491891,80,294,245,3.056179775280899
663,4,2,-2,889491891,889491919,28,245,351,2.4444444444444446
663,2,4,2,889491919,889491974,55,351,316,4.285714285714286
663,4,3,-1,889491974,889492076,102,316,243,2.357142857142857
663,3,2,-1,889492076,889492140,64,243,678,2.8181818181818183
663,2,1,-1,889492140,889492229,89,678,319,3.0408163265306123
663,1,2,1,889492229,889492230,1,319,323,3.0
663,2,4,2,889492230,889492258,28,323,948,2.2962962962962963
663,4,3,-1,889492258,889492351,93,948,924,3.3703703703703702
663,3,4,1,889492351,889492390,39,924,117,3.689189189189189
663,4,5,1,889492390,889492435,45,117,150,3.803921568627451
663,5,3,-2,889492435,889492503,68,150,129,3.744186046511628
663,3,3,0,889492503,889492562,59,129,13,3.5454545454545454
663,3,2,-1,889492562,889492614,52,13,1059,2.764705882352941
663,2,4,2,889492614,889492615,1,1059,628,3.573529411764706
663,4,2,-2,889492615,889492679,64,628,1017,3.0
663,2,4,2,889492679,889492720,41,1017,742,3.5555555555555554
663,4,3,-1,889492720,889492759,39,742,410,3.0434782608695654
663,3,3,0,889492759,889492841,82,410,151,3.6544117647058822
663,3,4,1,889492841,889492917,76,151,685,3.2666666666666666
663,4,3,-1,889492917,889492959,42,685,1086,3.857142857142857
663,3,4,1,889492959,889492989,30,1086,148,3.2131147540983607
663,4,3,-1,889492989,889493069,80,148,147,3.3142857142857145
663,3,3,0,889493069,889493118,49,147,1051,3.625
663,3,4,1,889493118,889493210,92,1051,1327,4.0
663,4,4,0,889493210,889493351,141,1327,741,3.3043478260869565
663,4,3,-1,889493351,889493437,86,741,710,3.41025641025641
663,3,4,1,889493437,889493467,30,710,658,3.393939393939394
663,4,5,1,889493467,889493502,35,658,176,3.967032967032967
663,5,5,0,889493502,889493540,38,176,127,4.162790697674419
663,5,4,-1,889493540,889493628,88,127,192,4.090909090909091
663,4,4,0,889493628,889493691,63,192,265,3.710144927536232
663,4,4,0,889493691,889493732,41,265,181,3.98974358974359
663,4,4,0,889493732,889493770,38,181,69,3.8015873015873014
663,4,4,0,889493770,889493818,48,69,89,3.9615384615384617
663,4,5,1,889493818,889493869,51,89,187,4.215189873417722
664,3,4,1,876523093,876523133,40,268,319,3.0408163265306123
664,4,2,-2,876523133,876523225,92,319,326,3.262295081967213
664,2,3,1,876523225,876523314,89,326,328,3.4895833333333335
664,3,5,2,876523314,876523833,519,328,528,4.241379310344827
664,5,4,-1,876523833,876524096,263,528,192,4.090909090909091
664,4,3,-1,876524096,876524097,1,192,655,3.7857142857142856
664,3,3,0,876524097,876524641,544,655,222,3.578125
664,3,5,2,876524641,876524699,58,222,187,4.215189873417722
664,5,3,-2,876524699,876524731,32,187,160,3.4
664,3,4,1,876524731,876524869,138,160,83,4.204081632653061
664,4,3,-1,876524869,876524937,68,83,425,3.7027027027027026
664,3,3,0,876524937,876525002,65,425,1101,3.793103448275862
664,3,1,-2,876525002,876525044,42,1101,582,3.7457627118644066
664,1,4,3,876525044,876525076,32,582,47,3.5869565217391304
664,4,4,0,876525076,876525077,1,47,631,3.581818181818182
664,4,3,-1,876525077,876525192,115,631,778,3.5925925925925926
664,3,4,1,876525192,876525292,100,778,58,3.543859649122807
664,4,4,0,876525292,876525293,1,58,215,3.662921348314607
664,4,3,-1,876525293,876525315,22,215,732,3.6266666666666665
664,3,3,0,876525315,876525363,48,732,97,3.7282608695652173
664,3,3,0,876525363,876525364,1,97,69,3.8015873015873014
664,3,5,2,876525364,876525736,372,69,52,3.727272727272727
664,5,4,-1,876525736,876525764,28,52,162,3.4651162790697674
664,4,4,0,876525764,876525962,198,162,56,4.051724137931035
664,4,4,0,876525962,876525998,36,56,209,3.8275862068965516
664,4,3,-1,876525998,876526152,154,209,367,3.4242424242424243
664,3,5,2,876526152,876526179,27,367,514,4.033333333333333
664,5,5,0,876526179,876526518,339,514,603,4.315789473684211
664,5,3,-2,876526518,876526554,36,603,234,3.7674418604651163
664,3,4,1,876526554,876526580,26,234,684,3.847826086956522
664,4,3,-1,876526580,876526604,24,684,118,3.2764227642276422
664,3,3,0,876526604,876526631,27,118,636,3.4146341463414633
664,3,3,0,876526631,876526659,28,636,121,3.521212121212121
664,3,3,0,876526659,876526684,25,121,54,3.3714285714285714
664,3,4,1,876526684,876526685,1,54,203,3.826923076923077
664,4,2,-2,876526685,876526718,33,203,449,2.9069767441860463
664,2,4,2,876526718,876526784,66,449,156,4.017857142857143
664,4,4,0,876526784,878090054,1563270,156,210,3.921259842519685
664,4,4,0,878090054,878090087,33,210,1,3.902439024390244
664,4,4,0,878090087,878090125,38,1,71,3.6575342465753424
664,4,4,0,878090125,878090180,55,71,212,3.230769230769231
664,4,5,1,878090180,878090415,235,212,50,4.306532663316583
664,5,2,-3,878090415,878090764,349,50,73,3.588235294117647
664,2,3,1,878090764,878091463,699,73,458,3.0588235294117645
664,3,4,1,878091463,878092758,1295,458,764,3.1176470588235294
657,2,4,2,884237751,884238162,411,300,346,3.5128205128205128
657,4,5,1,884238162,884238247,85,346,294,3.1052631578947367
657,5,3,-2,884238247,884238614,367,294,873,2.7586206896551726
657,3,4,1,884238614,884239123,509,873,922,4.0
657,4,3,-1,884239123,884239566,443,922,273,3.5238095238095237
657,3,3,0,884239566,884239745,179,273,282,3.610526315789474
657,3,4,1,884239745,884239886,141,282,151,3.6544117647058822
657,4,1,-3,884239886,884240732,846,151,118,3.2764227642276422
665,2,2,0,884289897,884289922,25,346,294,3.1052631578947367
665,2,4,2,884289922,884290096,174,294,301,3.2465753424657535
665,4,2,-2,884290096,884290143,47,301,687,2.1481481481481484
665,2,4,2,884290143,884290432,289,687,50,4.306532663316583
665,4,4,0,884290432,884290480,48,50,762,3.3962264150943398
665,4,4,0,884290480,884290491,11,762,1,3.902439024390244
665,4,2,-2,884290491,884290515,24,1,685,3.2666666666666666
665,2,4,2,884290515,884290575,60,685,117,3.689189189189189
665,4,4,0,884290575,884290608,33,117,9,3.8878504672897196
665,4,3,-1,884290608,884290635,27,9,237,3.7315436241610738
665,3,3,0,884290635,884290676,41,237,222,3.578125
665,3,2,-1,884290676,884290751,75,222,508,3.6923076923076925
665,2,3,1,884290751,884290853,102,508,597,3.2771084337349397
665,3,4,1,884290853,884290882,29,597,473,2.9166666666666665
665,4,3,-1,884290882,884291017,135,473,151,3.6544117647058822
665,3,4,1,884291017,884291094,77,151,535,3.380952380952381
665,4,4,0,884291094,884291133,39,535,476,3.1216216216216215
665,4,3,-1,884291133,884291165,32,476,410,3.0434782608695654
665,3,4,1,884291165,884291210,45,410,763,3.347826086956522
665,4,3,-1,884291210,884291242,32,763,472,2.984375
665,3,5,2,884291242,884291271,29,472,240,3.0350877192982457
665,5,3,-2,884291271,884291300,29,240,24,3.3728813559322033
665,3,4,1,884291300,884291340,40,24,125,3.5555555555555554
665,4,2,-2,884291340,884291376,36,125,546,2.9789473684210526
665,2,4,2,884291376,884291413,37,546,1315,3.4444444444444446
665,4,4,0,884291413,884291550,137,1315,1040,2.2666666666666666
665,4,3,-1,884291550,884291613,63,1040,620,3.0
665,3,2,-1,884291613,884291662,49,620,1132,2.588235294117647
665,2,4,2,884291662,884291747,85,1132,369,2.5714285714285716
665,4,2,-2,884291747,884291810,63,369,105,2.6176470588235294
665,2,4,2,884291810,884291936,126,105,1009,3.2962962962962963
665,4,4,0,884291936,884292068,132,1009,248,3.746268656716418
665,4,4,0,884292068,884293366,1298,248,188,3.625
665,4,4,0,884293366,884293475,109,188,143,3.56
665,4,4,0,884293475,884293523,48,143,65,3.511111111111111
665,4,3,-1,884293523,884293569,46,65,417,3.0588235294117645
665,3,2,-1,884293569,884293741,172,417,566,3.543859649122807
665,2,4,2,884293741,884293789,48,566,210,3.921259842519685
665,4,2,-2,884293789,884293873,84,210,33,3.2941176470588234
665,2,4,2,884293873,884293933,60,33,71,3.6575342465753424
665,4,4,0,884293933,884293979,46,71,357,4.063291139240507
665,4,3,-1,884293979,884294025,46,357,154,3.6031746031746033
665,3,3,0,884294025,884294237,212,154,378,3.6904761904761907
665,3,3,0,884294237,884294286,49,378,684,3.847826086956522
665,3,2,-1,884294286,884294329,43,684,97,3.7282608695652173
665,2,3,1,884294329,884294374,45,97,177,3.875
665,3,2,-1,884294374,884294459,85,177,631,3.581818181818182
665,2,4,2,884294459,884294552,93,631,421,3.462962962962963
665,4,5,1,884294552,884294611,59,421,56,4.051724137931035
665,5,3,-2,884294611,884294671,60,56,157,3.5714285714285716
665,3,3,0,884294671,884294716,45,157,265,3.710144927536232
665,3,3,0,884294716,884294771,55,265,133,3.7777777777777777
665,3,5,2,884294771,884294772,1,133,156,4.017857142857143
665,5,3,-2,884294772,884294880,108,156,527,3.823529411764706
665,3,4,1,884294880,884294935,55,527,89,3.9615384615384617
665,4,4,0,884294935,884295080,145,89,92,3.7142857142857144
665,4,4,0,884295080,884295126,46,92,419,3.8208955223880596
666,3,3,0,880138720,880138865,145,270,245,3.056179775280899
666,3,3,0,880138865,880139037,172,245,294,3.1052631578947367
666,3,3,0,880139037,880139090,53,294,963,3.9285714285714284
666,3,4,1,880139090,880139120,30,963,213,3.943396226415094
666,4,4,0,880139120,880139149,29,213,484,4.116279069767442
666,4,4,0,880139149,880139205,56,484,209,3.8275862068965516
666,4,4,0,880139205,880139252,47,209,492,4.117647058823529
666,4,4,0,880139252,880139253,1,492,527,3.823529411764706
666,4,3,-1,880139253,880139274,21,527,265,3.710144927536232
666,3,4,1,880139274,880139348,74,265,46,3.6666666666666665
666,4,3,-1,880139348,880139349,1,46,381,3.2758620689655173
666,3,3,0,880139349,880139381,32,381,28,3.923076923076923
666,3,5,2,880139381,880139409,28,28,429,3.742857142857143
666,5,4,-1,880139409,880139466,57,429,185,3.9726027397260273
666,4,4,0,880139466,880139467,1,185,23,3.9047619047619047
666,4,4,0,880139467,880139526,59,23,478,4.161290322580645
666,4,3,-1,880139526,880139562,36,478,520,4.136363636363637
666,3,3,0,880139562,880139563,1,520,638,3.923076923076923
666,3,5,2,880139563,880139586,23,638,642,3.4285714285714284
666,5,2,-3,880139586,880139587,1,642,186,3.905263157894737
666,2,3,1,880139587,880139614,27,186,1451,4.0
666,3,4,1,880139614,880139615,1,1451,238,3.888888888888889
666,4,3,-1,880139615,880139642,27,238,216,3.8454545454545452
666,3,4,1,880139642,880139669,27,216,206,3.0
666,4,4,0,880139669,880139765,96,206,661,4.133333333333334
666,4,5,1,880139765,880313230,173465,661,515,4.202898550724638
666,5,4,-1,880313230,880313250,20,515,236,3.2666666666666666
666,4,4,0,880313250,880313270,20,236,116,3.6666666666666665
666,4,3,-1,880313270,880313310,40,116,293,3.630434782608696
666,3,4,1,880313310,880313329,19,293,7,3.76056338028169
666,4,3,-1,880313329,880313391,62,7,237,3.7315436241610738
666,3,3,0,880313391,880313423,32,237,222,3.578125
666,3,3,0,880313423,880313447,24,222,50,4.306532663316583
666,3,3,0,880313447,880313523,76,50,111,3.5106382978723403
666,3,4,1,880313523,880313542,19,111,13,3.5454545454545454
666,4,2,-2,880313542,880313582,40,13,924,3.3703703703703702
666,2,3,1,880313582,880313603,21,924,121,3.521212121212121
666,3,3,0,880313603,880313640,37,121,291,3.2
666,3,2,-1,880313640,880313662,22,291,405,3.25
666,2,3,1,880313662,880313682,20,405,257,3.7154471544715446
666,3,2,-1,880313682,880313811,129,257,370,2.8125
666,2,2,0,880313811,880313841,30,370,831,2.6097560975609757
666,2,3,1,880313841,880313858,17,831,1047,2.6923076923076925
666,3,3,0,880313858,880313903,45,1047,118,3.2764227642276422
666,3,3,0,880313903,880313929,26,118,108,3.107142857142857
666,3,2,-1,880313929,880313992,63,108,106,2.8125
666,2,3,1,880313992,880314029,37,106,1013,2.388888888888889
666,3,5,2,880314029,880314103,74,1013,707,3.909090909090909
666,5,3,-2,880314103,880314144,41,707,223,4.108695652173913
666,3,4,1,880314144,880314225,81,223,729,3.3793103448275863
666,4,3,-1,880314225,880314272,47,729,195,3.9072164948453607
666,3,4,1,880314272,880314310,38,195,494,3.8333333333333335
666,4,3,-1,880314310,880314366,56,494,1110,2.85
666,3,4,1,880314366,880314384,18,1110,1098,3.533333333333333
666,4,3,-1,880314384,880314453,69,1098,644,3.7
666,3,4,1,880314453,880314477,24,644,640,2.75
666,4,3,-1,880314477,880567658,253181,640,1154,3.6
666,3,5,2,880567658,880567695,37,1154,134,4.174603174603175
666,5,3,-2,880567695,880567742,47,134,163,3.53125
666,3,3,0,880567742,880567771,29,163,507,3.6285714285714286
666,3,3,0,880567771,880567883,112,507,502,3.272727272727273
666,3,3,0,880567883,880567919,36,502,79,3.956989247311828
666,3,4,1,880567919,880567943,24,79,603,4.315789473684211
666,4,4,0,880567943,880567974,31,603,1045,3.2
666,4,4,0,880567974,880567997,23,1045,482,3.9444444444444446
666,4,3,-1,880567997,880568028,31,482,385,3.6129032258064515
666,3,4,1,880568028,880568063,35,385,684,3.847826086956522
666,4,2,-2,880568063,880568064,1,684,143,3.56
666,2,4,2,880568064,880568094,30,143,660,3.71875
666,4,3,-1,880568094,880568129,35,660,196,3.9404761904761907
666,3,4,1,880568129,880568322,193,196,636,3.4146341463414633
666,4,4,0,880568322,880568396,74,636,811,4.166666666666667
666,4,4,0,880568396,880568436,40,811,805,3.909090909090909
666,4,2,-2,880568436,880568465,29,805,5,3.1481481481481484
666,2,4,2,880568465,880568560,95,5,66,3.4705882352941178
666,4,4,0,880568560,880568637,77,66,956,3.5714285714285716
666,4,4,0,880568637,880568638,1,956,443,3.8421052631578947
666,4,3,-1,880568638,880568662,24,443,154,3.6031746031746033
666,3,3,0,880568662,880568694,32,154,649,3.625
661,3,3,0,876013121,876013398,277,222,514,4.033333333333333
661,3,5,2,876013398,876013447,49,514,174,4.253521126760563
661,5,4,-1,876013447,876013492,45,174,69,3.8015873015873014
661,4,3,-1,876013492,876013552,60,69,140,3.238095238095238
661,3,4,1,876013552,876013588,36,140,161,3.5844155844155843
661,4,4,0,876013588,876013774,186,161,615,3.8333333333333335
661,4,4,0,876013774,876013850,76,615,189,3.88
661,4,4,0,876013850,876013975,125,189,197,4.112676056338028
661,4,4,0,876013975,876014060,85,197,64,4.373737373737374
661,4,4,0,876014060,876014125,65,64,179,3.8823529411764706
661,4,4,0,876014125,876015607,1482,179,96,3.9130434782608696
661,4,3,-1,876015607,876015657,50,96,215,3.662921348314607
661,3,4,1,876015657,876015688,31,215,566,3.543859649122807
661,4,5,1,876015688,876016545,857,566,1,3.902439024390244
661,5,3,-2,876016545,876016581,36,1,972,3.375
661,3,5,2,876016581,876016667,86,972,194,4.029411764705882
661,5,4,-1,876016667,876016726,59,194,48,4.055555555555555
661,4,4,0,876016726,876017029,303,48,52,3.727272727272727
661,4,3,-1,876017029,876017717,688,52,1035,3.03125
661,3,5,2,876017717,876017801,84,1035,498,4.290909090909091
661,5,4,-1,876017801,876035933,18132,498,443,3.8421052631578947
661,4,4,0,876035933,876036043,110,443,436,3.5
661,4,5,1,876036043,876036190,147,436,95,3.8194444444444446
661,5,4,-1,876036190,876036240,50,95,418,3.825
661,4,5,1,876036240,876036358,118,418,172,4.225225225225225
661,5,4,-1,876036358,876036384,26,172,294,3.1052631578947367
661,4,3,-1,876036384,876036477,93,294,300,3.6861313868613137
661,3,3,0,876036477,876037088,611,300,255,3.2027027027027026
661,3,2,-1,876037088,876037121,33,255,762,3.3962264150943398
661,2,4,2,876037121,876037167,46,762,471,3.5714285714285716
661,4,4,0,876037167,876037199,32,471,274,3.5609756097560976
661,4,2,-2,876037199,876037619,420,274,121,3.521212121212121
661,2,3,1,876037619,886830056,10792437,121,538,3.25
661,3,4,1,886830056,886841250,11194,538,117,3.689189189189189
661,4,3,-1,886841250,886841443,193,117,249,3.3275862068965516
661,3,3,0,886841443,886841562,119,249,280,3.103448275862069
661,3,4,1,886841562,886841685,123,280,709,4.171428571428572
661,4,3,-1,886841685,886841831,146,709,631,3.581818181818182
661,3,3,0,886841831,886841865,34,631,506,3.566666666666667
661,3,4,1,886841865,888299980,1458115,506,97,3.7282608695652173
661,4,4,0,888299980,888300344,364,97,191,4.168674698795181
661,4,5,1,888300344,888300488,144,191,195,3.9072164948453607
661,5,2,-3,888300488,888300680,192,195,652,3.9642857142857144
662,3,4,1,880569520,880570112,592,319,591,3.7169811320754715
662,4,4,0,880570112,880570265,153,591,13,3.5454545454545454
662,4,4,0,880570265,880570301,36,13,1511,3.3333333333333335
662,4,2,-2,880570301,880570487,186,1511,291,3.2
662,2,2,0,880570487,880570952,465,291,1380,3.0
662,2,5,3,880570952,880571005,53,1380,1381,3.75
662,5,4,-1,880571005,880571006,1,1381,985,2.9
667,4,5,1,891034426,891034444,18,315,269,4.085106382978723
667,5,1,-4,891034444,891034513,69,269,301,3.2465753424657535
667,1,3,2,891034513,891034568,55,301,880,2.8421052631578947
667,3,4,1,891034568,891034584,16,880,316,4.285714285714286
667,4,4,0,891034584,891034730,146,316,694,4.277777777777778
667,4,5,1,891034730,891034767,37,694,182,3.842857142857143
667,5,5,0,891034767,891034810,43,182,131,3.731707317073171
667,5,5,0,891034810,891034831,21,131,9,3.8878504672897196
667,5,4,-1,891034831,891034894,63,9,216,3.8454545454545452
667,4,4,0,891034894,891034947,53,216,283,3.901639344262295
667,4,5,1,891034947,891034976,29,283,318,4.5046728971962615
667,5,3,-2,891034976,891035015,39,318,1101,3.793103448275862
667,3,4,1,891035015,891035033,18,1101,186,3.905263157894737
667,4,5,1,891035033,891035051,18,186,475,3.956043956043956
667,5,4,-1,891035051,891035084,33,475,275,4.087912087912088
667,4,3,-1,891035084,891035104,20,275,69,3.8015873015873014
667,3,4,1,891035104,891035121,17,69,527,3.823529411764706
667,4,3,-1,891035121,891035140,19,527,238,3.888888888888889
667,3,5,2,891035140,891035164,24,238,124,4.052631578947368
667,5,3,-2,891035164,891035206,42,124,137,3.9545454545454546
641,4,5,1,879369827,879369848,21,268,305,3.5789473684210527
641,5,4,-1,879369848,879369925,77,305,301,3.2465753424657535
641,4,3,-1,879369925,879369958,33,301,338,2.75
641,3,5,2,879369958,879370028,70,338,198,4.04
641,5,4,-1,879370028,879370062,34,198,657,4.341463414634147
641,4,5,1,879370062,879370119,57,657,432,3.719298245614035
641,5,4,-1,879370119,879370150,31,432,192,4.090909090909091
641,4,4,0,879370150,879370259,109,192,59,4.0
641,4,5,1,879370259,879370364,105,59,23,3.9047619047619047
641,5,4,-1,879370364,879370365,1,23,209,3.8275862068965516
668,4,5,1,881523737,881523787,50,340,538,3.25
668,5,3,-2,881523787,881524153,366,538,358,2.6551724137931036
668,3,4,1,881524153,881591075,66922,358,13,3.5454545454545454
668,4,4,0,881591075,881591198,123,13,323,3.0
668,4,4,0,881591198,881591257,59,323,993,3.4838709677419355
668,4,3,-1,881591257,881591297,40,993,596,3.180327868852459
668,3,4,1,881591297,881605210,13913,596,475,3.956043956043956
668,4,5,1,881605210,881605324,114,475,283,3.901639344262295
668,5,4,-1,881605324,881605433,109,283,403,3.298507462686567
668,4,3,-1,881605433,881605489,56,403,124,4.052631578947368
668,3,5,2,881605489,881605587,98,124,367,3.4242424242424243
668,5,5,0,881605587,881605642,55,367,50,4.306532663316583
668,5,2,-3,881605642,881702632,96990,50,97,3.7282608695652173
668,2,3,1,881702632,881702723,91,97,554,2.9555555555555557
668,3,4,1,881702723,882818604,1115881,554,288,3.5214285714285714
668,4,2,-2,882818604,890349041,7530437,288,345,3.4782608695652173
668,2,4,2,890349041,890349060,19,345,354,3.6923076923076925
668,4,3,-1,890349060,890349076,16,354,294,3.1052631578947367
668,3,3,0,890349076,890349136,60,294,895,3.142857142857143
668,3,2,-1,890349136,890349190,54,895,355,2.75
668,2,2,0,890349190,890349285,95,355,902,3.9444444444444446
673,2,5,3,888786969,888786997,28,258,310,3.6666666666666665
673,5,3,-2,888786997,888787312,315,310,898,3.0869565217391304
673,3,5,2,888787312,888787355,43,898,896,3.6666666666666665
673,5,4,-1,888787355,888787376,21,896,292,3.6666666666666665
673,4,4,0,888787376,888787396,20,292,311,3.761904761904762
673,4,3,-1,888787396,888787423,27,311,895,3.142857142857143
673,3,4,1,888787423,888787508,85,895,242,3.5217391304347827
673,4,4,0,888787508,888787587,79,242,12,4.358974358974359
671,5,3,-2,875388720,883546890,8158170,257,55,4.051282051282051
671,3,3,0,883546890,883949781,402891,55,1073,3.6315789473684212
671,3,4,1,883949781,884035303,85522,1073,566,3.543859649122807
671,4,2,-2,884035303,884035406,103,566,526,3.909090909090909
671,2,5,3,884035406,884035686,280,526,96,3.9130434782608696
671,5,4,-1,884035686,884035774,88,96,11,3.8904109589041096
671,4,3,-1,884035774,884035775,1,11,947,2.6666666666666665
671,3,5,2,884035775,884035939,164,947,576,3.125
671,5,3,-2,884035939,884035992,53,576,265,3.710144927536232
671,3,3,0,884035992,884035993,1,265,231,2.938775510204082
671,3,3,0,884035993,884036050,57,231,720,3.2
671,3,4,1,884036050,884036411,361,720,554,2.9555555555555557
671,4,5,1,884036411,884036846,435,554,553,3.5
671,5,5,0,884036846,884037003,157,553,237,3.7315436241610738
671,5,5,0,884037003,884204510,167507,237,204,3.6744186046511627
669,1,1,0,891182622,891182678,56,354,326,3.262295081967213
669,1,2,1,891182678,891182703,25,326,879,3.2291666666666665
669,2,2,0,891182703,891182792,89,879,355,2.75
669,2,3,1,891182792,891182948,156,355,347,3.59375
669,3,2,-1,891182948,891260392,77444,347,96,3.9130434782608696
669,2,4,2,891260392,891260440,48,96,64,4.373737373737374
669,4,2,-2,891260440,891260474,34,64,79,3.956989247311828
669,2,4,2,891260474,891260519,45,79,132,3.929411764705882
669,4,2,-2,891260519,891260542,23,132,195,3.9072164948453607
669,2,3,1,891260542,891260577,35,195,183,3.951219512195122
669,3,5,2,891260577,891260719,142,183,603,4.315789473684211
669,5,4,-1,891260719,891260754,35,603,649,3.625
669,4,4,0,891260754,891260778,24,649,614,3.727272727272727
669,4,5,1,891260778,891260806,28,614,479,4.25
669,5,5,0,891260806,891517185,256379,479,657,4.341463414634147
669,5,2,-3,891517185,891517215,30,657,208,3.8125
669,2,5,3,891517215,891517238,23,208,515,4.202898550724638
669,5,4,-1,891517238,891517259,21,515,168,4.0476190476190474
669,4,5,1,891517259,891517287,28,168,12,4.358974358974359
669,5,3,-2,891517287,892549178,1031891,12,915,4.0
669,3,4,1,892549178,892549238,60,915,300,3.6861313868613137
669,4,3,-1,892549238,892549266,28,300,7,3.76056338028169
669,3,5,2,892549266,892549316,50,7,408,4.4772727272727275
669,5,3,-2,892549316,892549336,20,408,475,3.956043956043956
669,3,5,2,892549336,892549390,54,475,181,3.98974358974359
669,5,4,-1,892549390,892549412,22,181,248,3.746268656716418
669,4,3,-1,892549412,892549434,22,248,222,3.578125
669,3,3,0,892549434,892549477,43,222,150,3.803921568627451
669,3,3,0,892549477,892549514,37,150,257,3.7154471544715446
669,3,4,1,892549514,892549583,69,257,111,3.5106382978723403
669,4,3,-1,892549583,892549622,39,111,125,3.5555555555555554
669,3,3,0,892549622,892549673,51,125,121,3.521212121212121
669,3,2,-1,892549673,892549820,147,121,290,3.108108108108108
669,2,2,0,892549820,892549838,18,290,118,3.2764227642276422
669,2,5,3,892549838,892550196,358,118,114,4.3478260869565215
669,5,3,-2,892550196,892550234,38,114,196,3.9404761904761907
669,3,2,-1,892550234,892550259,25,196,276,3.6036036036036037
669,2,3,1,892550259,892550282,23,276,517,3.625
669,3,3,0,892550282,892550310,28,517,531,3.7435897435897436
676,2,4,2,892685370,892685403,33,258,303,3.75
676,4,3,-1,892685403,892685489,86,303,912,3.0
676,3,4,1,892685489,892685538,49,912,748,3.1043478260869564
676,4,1,-3,892685538,892685562,24,748,895,3.142857142857143
676,1,4,3,892685562,892685591,29,895,294,3.1052631578947367
676,4,2,-2,892685591,892685592,1,294,326,3.262295081967213
676,2,2,0,892685592,892685621,29,326,345,3.4782608695652173
676,2,1,-1,892685621,892685695,74,345,688,2.111111111111111
676,1,4,3,892685695,892685740,45,688,902,3.9444444444444446
676,4,1,-3,892685740,892685803,63,902,948,2.2962962962962963
676,1,4,3,892685803,892685826,23,948,1483,3.25
676,4,5,1,892685826,892685849,23,1483,916,3.3333333333333335
676,5,1,-4,892685849,892685875,26,916,352,1.8333333333333333
676,1,1,0,892685875,892685900,25,352,890,1.7692307692307692
676,1,4,3,892685900,892685920,20,890,539,2.6666666666666665
676,4,1,-3,892685920,892685960,40,539,1654,1.0
676,1,5,4,892685960,892686083,123,1654,50,4.306532663316583
676,5,1,-4,892686083,892686134,51,50,508,3.6923076923076925
676,1,5,4,892686134,892686188,54,508,1,3.902439024390244
676,5,5,0,892686188,892686220,32,1,257,3.7154471544715446
676,5,3,-2,892686220,892686273,53,257,471,3.5714285714285716
676,3,5,2,892686273,892686294,21,471,993,3.4838709677419355
676,5,1,-4,892686294,892686319,25,993,13,3.5454545454545454
676,1,5,4,892686319,892686348,29,13,255,3.2027027027027026
676,5,5,0,892686348,892686459,111,255,318,4.5046728971962615
676,5,5,0,892686459,892686490,31,318,172,4.225225225225225
676,5,5,0,892686490,892686524,34,172,169,4.548387096774194
676,5,4,-1,892686524,892686525,1,169,962,3.142857142857143
676,4,5,1,892686525,892686563,38,962,64,4.373737373737374
676,5,5,0,892686563,892686606,43,64,22,4.215909090909091
676,5,5,0,892686606,892686665,59,22,173,4.1441441441441444
676,5,4,-1,892686665,892686702,37,173,482,3.9444444444444446
676,4,5,1,892686702,892686703,1,482,132,3.929411764705882
676,5,4,-1,892686703,892686758,55,132,520,4.136363636363637
674,3,4,1,887762398,887762415,17,751,292,3.6666666666666665
674,4,4,0,887762415,887762430,15,292,245,3.056179775280899
674,4,3,-1,887762430,887762480,50,245,678,2.8181818181818183
674,3,4,1,887762480,887762584,104,678,15,3.725663716814159
674,4,4,0,887762584,887762603,19,15,181,3.98974358974359
674,4,5,1,887762603,887762714,111,181,742,3.5555555555555554
674,5,5,0,887762714,887762779,65,742,125,3.5555555555555554
674,5,4,-1,887762779,887762799,20,125,1,3.902439024390244
674,4,3,-1,887762799,887762839,40,1,222,3.578125
674,3,5,2,887762839,887762861,22,222,117,3.689189189189189
674,5,3,-2,887762861,887762937,76,117,323,3.0
674,3,4,1,887762937,887763012,75,323,255,3.2027027027027026
674,4,5,1,887763012,887763062,50,255,866,3.3962264150943398
674,5,2,-3,887763062,887763151,89,866,289,2.988888888888889
674,2,2,0,887763151,887763274,123,289,151,3.6544117647058822
674,2,5,3,887763274,887763336,62,151,111,3.5106382978723403
674,5,3,-2,887763336,887763386,50,111,1197,3.625
652,4,3,-1,882566890,882566924,34,300,879,3.2291666666666665
652,3,1,-2,882566924,882566948,24,879,301,3.2465753424657535
652,1,4,3,882566948,882567058,110,301,328,3.4895833333333335
652,4,3,-1,882567058,882567100,42,328,323,3.0
652,3,2,-1,882567100,882567180,80,323,984,2.6666666666666665
652,2,4,2,882567180,882567356,176,984,96,3.9130434782608696
677,5,4,-1,885191227,885191280,53,294,322,3.0476190476190474
677,4,5,1,885191280,885191403,123,322,245,3.056179775280899
677,5,5,0,885191403,885191454,51,245,358,2.6551724137931036
677,5,3,-2,885191454,889399113,4207659,358,539,2.6666666666666665
677,3,4,1,889399113,889399171,58,539,222,3.578125
677,4,5,1,889399171,889399199,28,222,129,3.744186046511628
677,5,1,-4,889399199,889399295,96,129,290,3.108108108108108
677,1,1,0,889399295,889399327,32,290,109,3.282608695652174
677,1,4,3,889399327,889399328,1,109,405,3.25
677,4,4,0,889399328,889399431,103,405,151,3.6544117647058822
677,4,5,1,889399431,889399470,39,151,455,3.1702127659574466
682,3,2,-1,888516841,888516865,24,245,948,2.2962962962962963
682,2,3,1,888516865,888516953,88,948,28,3.923076923076923
682,3,3,0,888516953,888516979,26,28,357,4.063291139240507
682,3,3,0,888516979,888517011,32,357,100,4.0162162162162165
682,3,2,-1,888517011,888517097,86,100,124,4.052631578947368
682,2,4,2,888517097,888517197,100,124,150,3.803921568627451
682,4,2,-2,888517197,888517235,38,150,509,3.7058823529411766
682,2,4,2,888517235,888517264,29,509,48,4.055555555555555
682,4,3,-1,888517264,888517324,60,48,237,3.7315436241610738
682,3,1,-2,888517324,888517364,40,237,291,3.2
682,1,4,3,888517364,888517390,26,291,658,3.393939393939394
682,4,3,-1,888517390,888517415,25,658,549,3.4871794871794872
682,3,4,1,888517415,888517416,1,549,70,3.5833333333333335
682,4,3,-1,888517416,888517439,23,70,239,3.423076923076923
682,3,4,1,888517439,888517484,45,239,157,3.5714285714285716
682,4,3,-1,888517484,888517537,53,157,693,3.6285714285714286
682,3,2,-1,888517537,888517538,1,693,1440,3.0
682,2,2,0,888517538,888517587,49,1440,583,3.4285714285714284
682,2,3,1,888517587,888517627,40,583,58,3.543859649122807
682,3,4,1,888517627,888517628,1,58,54,3.3714285714285714
682,4,3,-1,888517628,888517792,164,54,1045,3.2
682,3,1,-2,888517792,888517816,24,1045,582,3.7457627118644066
682,1,2,1,888517816,888517840,24,582,556,2.7142857142857144
682,2,5,3,888517840,888517869,29,556,468,3.380952380952381
682,5,1,-4,888517869,888517870,1,468,47,3.5869565217391304
682,1,2,1,888517870,888517896,26,47,1107,2.9
682,2,2,0,888517896,888517922,26,1107,1655,2.0
682,2,4,2,888517922,888517948,26,1655,724,3.64
682,4,3,-1,888517948,888517986,38,724,26,3.36
682,3,4,1,888517986,888518009,23,26,39,3.107142857142857
682,4,3,-1,888518009,888518104,95,39,708,3.3157894736842106
682,3,4,1,888518104,888518130,26,708,1220,2.9166666666666665
682,4,3,-1,888518130,888518131,1,1220,1428,3.2857142857142856
682,3,3,0,888518131,888518164,33,1428,205,3.717391304347826
682,3,4,1,888518164,888518185,21,205,75,3.3333333333333335
682,4,2,-2,888518185,888518206,21,75,86,3.869565217391304
682,2,2,0,888518206,888518251,45,86,362,2.1666666666666665
682,2,2,0,888518251,888518320,69,362,346,3.5128205128205128
682,2,4,2,888518320,888518363,43,346,299,3.0
682,4,4,0,888518363,888518380,17,299,895,3.142857142857143
682,4,4,0,888518380,888518468,88,895,351,2.4444444444444446
682,4,2,-2,888518468,888518503,35,351,683,2.176470588235294
682,2,2,0,888518503,888518564,61,683,890,1.7692307692307692
682,2,4,2,888518564,888518639,75,890,298,3.779220779220779
682,4,3,-1,888518639,888518640,1,298,248,3.746268656716418
682,3,5,2,888518640,888518659,19,248,246,4.0
682,5,3,-2,888518659,888518722,63,246,249,3.3275862068965516
682,3,2,-1,888518722,888518747,25,249,1016,3.559322033898305
682,2,3,1,888518747,888518773,26,1016,252,2.911392405063291
682,3,4,1,888518773,888518937,164,252,721,3.4583333333333335
682,4,5,1,888518937,888518979,42,721,42,3.893617021276596
682,5,5,0,888518979,888519059,80,42,92,3.7142857142857144
682,5,4,-1,888519059,888519077,18,92,56,4.051724137931035
682,4,3,-1,888519077,888519113,36,56,3,3.0625
682,3,5,2,888519113,888519206,93,3,423,3.7016129032258065
682,5,5,0,888519206,888519207,1,423,156,4.017857142857143
682,5,3,-2,888519207,888519226,19,156,1478,2.7
682,3,3,0,888519226,888519260,34,1478,566,3.543859649122807
682,3,4,1,888519260,888519307,47,566,184,3.393939393939394
682,4,4,0,888519307,888519365,58,184,201,3.75
682,4,3,-1,888519365,888519408,43,201,232,3.0789473684210527
682,3,2,-1,888519408,888519519,111,232,53,2.9523809523809526
682,2,3,1,888519519,888519738,219,53,742,3.5555555555555554
682,3,4,1,888519738,888519918,180,742,282,3.610526315789474
682,4,4,0,888519918,888520638,720,282,98,4.240875912408759
682,4,4,0,888520638,888520639,1,98,185,3.9726027397260273
682,4,4,0,888520639,888520705,66,185,79,3.956989247311828
682,4,4,0,888520705,888520799,94,79,654,4.119047619047619
682,4,4,0,888520799,888520864,65,654,273,3.5238095238095237
682,4,3,-1,888520864,888520922,58,273,265,3.710144927536232
682,3,3,0,888520922,888520923,1,265,925,3.0
682,3,3,0,888520923,888520977,54,925,443,3.8421052631578947
682,3,2,-1,888520977,888521047,70,443,1090,2.3529411764705883
682,2,3,1,888521047,888521090,43,1090,717,2.9696969696969697
682,3,3,0,888521090,888521116,26,717,38,2.784313725490196
682,3,4,1,888521116,888521174,58,38,325,2.625
682,4,4,0,888521174,888521195,21,325,176,3.967032967032967
682,4,2,-2,888521195,888521291,96,176,783,2.388888888888889
682,2,4,2,888521291,888521413,122,783,186,3.905263157894737
682,4,3,-1,888521413,888521465,52,186,475,3.956043956043956
682,3,3,0,888521465,888521539,74,475,109,3.282608695652174
682,3,4,1,888521539,888521564,25,109,25,3.3185840707964602
682,4,4,0,888521564,888521599,35,25,88,3.433734939759036
682,4,3,-1,888521599,888521637,38,88,762,3.3962264150943398
682,3,3,0,888521637,888521711,74,762,1118,3.533333333333333
682,3,3,0,888521711,888521740,29,1118,804,3.0
682,3,3,0,888521740,888521783,43,804,367,3.4242424242424243
682,3,3,0,888521783,888521803,20,367,1047,2.6923076923076925
682,3,2,-1,888521803,888521833,30,1047,781,3.4166666666666665
682,2,1,-1,888521833,888521866,33,781,1178,2.375
682,1,1,0,888521866,888521907,41,1178,824,2.590909090909091
682,1,2,1,888521907,888521942,35,824,756,2.6885245901639343
682,2,1,-1,888521942,888521981,39,756,775,2.4285714285714284
682,1,2,1,888521981,888521982,1,775,719,2.6666666666666665
682,2,1,-1,888521982,888522017,35,719,932,2.5
682,1,1,0,888522017,888522021,4,932,862,1.6666666666666667
682,1,3,2,888522021,888522073,52,862,41,3.0625
682,3,2,-1,888522073,888522074,1,41,716,3.1904761904761907
682,2,3,1,888522074,888522194,120,716,49,3.3
682,3,3,0,888522194,888522217,23,49,780,3.08
682,3,1,-2,888522217,888522260,43,780,401,2.6774193548387095
682,1,4,3,888522260,888522311,51,401,211,3.958904109589041
682,4,4,0,888522311,888522326,15,211,210,3.921259842519685
682,4,4,0,888522326,888522417,91,210,188,3.625
682,4,4,0,888522417,888522418,1,188,195,3.9072164948453607
682,4,2,-2,888522418,888522456,38,195,405,3.25
682,2,2,0,888522456,888522541,85,405,550,3.272727272727273
682,2,3,1,888522541,888522542,1,550,161,3.5844155844155843
682,3,4,1,888522542,888522575,33,161,24,3.3728813559322033
682,4,2,-2,888522575,888522612,37,24,1231,2.7
682,2,2,0,888522612,888522613,1,1231,823,2.75
682,2,2,0,888522613,888522699,86,823,29,2.5714285714285716
682,2,2,0,888522699,888522700,1,29,562,3.2941176470588234
682,2,3,1,888522700,888522754,54,562,779,2.2
682,3,2,-1,888522754,888522755,1,779,809,2.7058823529411766
682,2,4,2,888522755,888522837,82,809,559,3.477272727272727
682,4,2,-2,888522837,888522857,20,559,219,2.735294117647059
682,2,2,0,888522857,888522894,37,219,672,2.7222222222222223
682,2,2,0,888522894,888522951,57,672,769,2.2222222222222223
682,2,3,1,888522951,888522971,20,769,834,2.0
682,3,2,-1,888522971,888522977,6,834,551,1.6666666666666667
682,2,3,1,888522977,888523054,77,551,419,3.8208955223880596
682,3,3,0,888523054,888523115,61,419,143,3.56
682,3,5,2,888523115,888523135,20,143,71,3.6575342465753424
682,5,3,-2,888523135,888523155,20,71,625,3.25
682,3,4,1,888523155,888523171,16,625,627,3.3823529411764706
682,4,2,-2,888523171,888523227,56,627,542,2.888888888888889
682,2,3,1,888523227,888523288,61,542,1091,2.5384615384615383
682,3,3,0,888523288,888523323,35,1091,820,3.0444444444444443
682,3,1,-2,888523323,888523619,296,820,147,3.3142857142857145
682,1,4,3,888523619,888523634,15,147,752,3.6666666666666665
682,4,4,0,888523634,888523635,1,752,125,3.5555555555555554
682,4,3,-1,888523635,888523658,23,125,699,3.736842105263158
682,3,1,-2,888523658,888523810,152,699,304,3.5306122448979593
679,1,4,3,884312763,884312834,71,294,268,3.9838709677419355
679,4,4,0,884312834,884312926,92,268,748,3.1043478260869564
679,4,4,0,884312926,884486658,173732,748,484,4.116279069767442
679,4,5,1,884486658,884486694,36,484,83,4.204081632653061
679,5,5,0,884486694,884486732,38,83,28,3.923076923076923
679,5,5,0,884486732,884486812,80,28,318,4.5046728971962615
679,5,3,-2,884486812,884486837,25,318,174,4.253521126760563
679,3,2,-1,884486837,884486856,19,174,8,3.903225806451613
679,2,5,3,884486856,884486966,110,8,173,4.1441441441441444
679,5,4,-1,884486966,884486985,19,173,527,3.823529411764706
679,4,4,0,884486985,884487031,46,527,520,4.136363636363637
679,4,4,0,884487031,884487052,21,520,64,4.373737373737374
679,4,3,-1,884487052,884487089,37,64,100,4.0162162162162165
679,3,3,0,884487089,884487112,23,100,423,3.7016129032258065
679,3,4,1,884487112,884487153,41,423,531,3.7435897435897436
679,4,3,-1,884487153,884487191,38,531,204,3.6744186046511627
679,3,4,1,884487191,884487325,134,204,70,3.5833333333333335
679,4,4,0,884487325,884487374,49,70,710,3.41025641025641
679,4,4,0,884487374,884487491,117,710,184,3.393939393939394
679,4,4,0,884487491,884487514,23,184,432,3.719298245614035
679,4,5,1,884487514,884487534,20,432,168,4.0476190476190474
679,5,4,-1,884487534,884487584,50,168,42,3.893617021276596
679,4,3,-1,884487584,884487611,27,42,721,3.4583333333333335
679,3,4,1,884487611,884487688,77,721,69,3.8015873015873014
679,4,2,-2,884487688,884487715,27,69,290,3.108108108108108
679,2,3,1,884487715,884487825,110,290,588,3.8358208955223883
679,3,4,1,884487825,884487960,135,588,291,3.2
679,4,4,0,884487960,884487961,1,291,727,3.5517241379310347
679,4,3,-1,884487961,884487999,38,727,215,3.662921348314607
679,3,4,1,884487999,884488036,37,215,73,3.588235294117647
679,4,3,-1,884488036,884488226,190,73,416,3.3846153846153846
679,3,2,-1,884488226,884488259,33,416,568,3.5853658536585367
679,2,2,0,884488259,884488260,1,568,121,3.521212121212121
679,2,3,1,884488260,884488283,23,121,109,3.282608695652174
684,3,5,2,875810633,875810796,163,151,408,4.4772727272727275
684,5,4,-1,875810796,875810897,101,408,50,4.306532663316583
684,4,4,0,875810897,875810928,31,50,1,3.902439024390244
684,4,4,0,875810928,875810999,71,1,117,3.689189189189189
684,4,3,-1,875810999,875811158,159,117,934,3.0294117647058822
684,3,4,1,875811158,875811274,116,934,282,3.610526315789474
684,4,3,-1,875811274,875811341,67,282,225,3.0714285714285716
684,3,5,2,875811341,875812109,768,225,710,3.41025641025641
684,5,5,0,875812109,875812176,67,710,215,3.662921348314607
684,5,5,0,875812176,875812227,51,215,82,3.6741573033707864
684,5,4,-1,875812227,875812299,72,82,204,3.6744186046511627
684,4,3,-1,875812299,875812351,52,204,596,3.180327868852459
684,3,4,1,875812351,878576614,2764263,596,692,3.56
684,4,5,1,878576614,878576905,291,692,483,4.475609756097561
684,5,3,-2,878576905,878759310,182405,483,402,3.3076923076923075
684,3,4,1,878759310,878759384,74,402,202,3.730337078651685
684,4,4,0,878759384,878759435,51,202,265,3.710144927536232
684,4,3,-1,878759435,878759474,39,265,210,3.921259842519685
684,3,3,0,878759474,878759545,71,210,238,3.888888888888889
684,3,3,0,878759545,878759635,90,238,38,2.784313725490196
684,3,4,1,878759635,878759820,185,38,365,2.95
684,4,2,-2,878759820,878759884,64,365,274,3.5609756097560976
684,2,4,2,878759884,878759907,23,274,64,4.373737373737374
684,4,4,0,878759907,878759970,63,64,98,4.240875912408759
684,4,3,-1,878759970,878760019,49,98,1301,3.6666666666666665
684,3,3,0,878760019,878760137,118,1301,161,3.5844155844155843
684,3,4,1,878760137,878760164,27,161,111,3.5106382978723403
684,4,4,0,878760164,878760250,86,111,178,4.378378378378378
684,4,4,0,878760250,878760305,55,178,553,3.5
684,4,3,-1,878760305,878761717,1412,553,216,3.8454545454545452
684,3,4,1,878761717,878761751,34,216,393,3.5125
684,4,4,0,878761751,878762087,336,393,63,3.125
684,4,4,0,878762087,878762118,31,63,239,3.423076923076923
684,4,3,-1,878762118,878762144,26,239,67,3.106382978723404
684,3,3,0,878762144,878762183,39,67,94,2.8823529411764706
684,3,3,0,878762183,878762273,90,94,376,2.9166666666666665
685,1,2,1,879451211,879451234,23,886,327,3.5076923076923077
685,2,2,0,879451234,879451253,19,327,289,2.988888888888889
685,2,1,-1,879451253,879451282,29,289,991,2.4545454545454546
685,1,2,1,879451282,879451401,119,991,337,2.0
685,2,2,0,879451401,879451540,139,337,299,3.0
683,3,3,0,893282978,893283049,71,258,311,3.761904761904762
683,3,2,-1,893283049,893283104,55,311,914,3.5
683,2,3,1,893283104,893283642,538,914,259,2.492063492063492
683,3,2,-1,893283642,893283728,86,259,245,3.056179775280899
683,2,3,1,893283728,893283903,175,245,323,3.0
683,3,2,-1,893283903,893283948,45,323,358,2.6551724137931036
683,2,3,1,893283948,893283997,49,358,879,3.2291666666666665
683,3,3,0,893283997,893284032,35,879,1280,2.3333333333333335
683,3,3,0,893284032,893284183,151,1280,271,3.3134328358208953
683,3,3,0,893284183,893284184,1,271,754,3.5789473684210527
683,3,5,2,893284184,893286208,2024,754,513,4.526315789473684
683,5,3,-2,893286208,893286259,51,513,288,3.5214285714285714
683,3,4,1,893286259,893286260,1,288,340,3.7419354838709675
683,4,4,0,893286260,893286261,1,340,906,3.8333333333333335
683,4,3,-1,893286261,893286346,85,906,1483,3.25
683,3,3,0,893286346,893286347,1,1483,306,4.033333333333333
683,3,4,1,893286347,893286501,154,306,127,4.162790697674419
683,4,3,-1,893286501,893286502,1,127,609,3.7058823529411766
683,3,4,1,893286502,893286550,48,609,22,4.215909090909091
683,4,4,0,893286550,893286584,34,22,588,3.8358208955223883
683,4,4,0,893286584,893286603,19,588,248,3.746268656716418
691,5,4,-1,875543025,875543108,83,79,227,3.169811320754717
691,4,5,1,875543108,875543153,45,227,524,4.166666666666667
691,5,4,-1,875543153,875543281,128,524,98,4.240875912408759
691,4,2,-2,875543281,875543346,65,98,8,3.903225806451613
691,2,5,3,875543346,875543395,49,8,205,3.717391304347826
672,4,4,0,879787500,879787643,143,301,874,3.230769230769231
672,4,4,0,879787643,879787729,86,874,127,4.162790697674419
672,4,3,-1,879787729,879787753,24,127,50,4.306532663316583
672,3,3,0,879787753,879787922,169,50,15,3.725663716814159
672,3,5,2,879787922,879787955,33,15,275,4.087912087912088
672,5,4,-1,879787955,879788774,819,275,109,3.282608695652174
672,4,5,1,879788774,879789056,282,109,25,3.3185840707964602
672,5,2,-3,879789056,879789244,188,25,756,2.6885245901639343
672,2,2,0,879789244,879789437,193,756,225,3.0714285714285716
672,2,5,3,879789437,879789462,25,225,476,3.1216216216216215
672,5,4,-1,879789462,879789566,104,476,1061,2.9166666666666665
672,4,2,-2,879789566,879789672,106,1061,1023,2.5714285714285716
692,2,3,1,876953204,876953279,75,168,476,3.1216216216216215
692,3,4,1,876953279,876953482,203,476,100,4.0162162162162165
692,4,1,-3,876953482,876953553,71,100,1012,3.2916666666666665
692,1,2,1,876953553,876953616,63,1012,1047,2.6923076923076925
692,2,4,2,876953616,876953681,65,1047,762,3.3962264150943398
692,4,4,0,876953681,876953733,52,762,866,3.3962264150943398
692,4,3,-1,876953733,876953823,90,866,1028,2.857142857142857
692,3,4,1,876953823,876953954,131,1028,1132,2.588235294117647
692,4,2,-2,876953954,876954021,67,1132,1040,2.2666666666666666
692,2,2,0,876954021,876954083,62,1040,1023,2.5714285714285716
692,2,4,2,876954083,876954196,113,1023,412,2.272727272727273
692,4,3,-1,876954196,876954197,1,412,1054,2.5454545454545454
690,4,4,0,881177272,881177302,30,655,216,3.8454545454545452
690,4,3,-1,881177302,881177349,47,216,211,3.958904109589041
690,3,4,1,881177349,881177376,27,211,663,3.948717948717949
690,4,3,-1,881177376,881177459,83,663,4,3.5538461538461537
690,3,5,2,881177459,881177485,26,4,153,3.7865168539325844
690,5,1,-4,881177485,881177506,21,153,428,3.744186046511628
690,1,4,3,881177506,881177553,47,428,763,3.347826086956522
690,4,3,-1,881177553,881177581,28,763,210,3.921259842519685
690,3,4,1,881177581,881177616,35,210,393,3.5125
690,4,2,-2,881177616,881177662,46,393,167,2.8181818181818183
690,2,4,2,881177662,881177689,27,167,232,3.0789473684210527
690,4,3,-1,881177689,881177721,32,232,274,3.5609756097560976
690,3,3,0,881177721,881177778,57,274,80,2.967741935483871
690,3,3,0,881177778,881177804,26,80,63,3.125
690,3,4,1,881177804,881177835,31,63,158,2.7027027027027026
690,4,4,0,881177835,881177836,1,158,1028,2.857142857142857
690,4,2,-2,881177836,881177861,25,1028,396,2.84
690,2,4,2,881177861,881177880,19,396,712,3.0434782608695654
690,4,3,-1,881177880,881177910,30,712,376,2.9166666666666665
690,3,3,0,881177910,881177970,60,376,790,2.8518518518518516
690,3,3,0,881177970,881178026,56,790,364,2.8095238095238093
690,3,4,1,881178026,881178213,187,364,127,4.162790697674419
690,4,3,-1,881178213,881178232,19,127,9,3.8878504672897196
690,3,3,0,881178232,881178293,61,9,276,3.6036036036036037
690,3,4,1,881178293,881178330,37,276,237,3.7315436241610738
690,4,3,-1,881178330,881178365,35,237,148,3.2131147540983607
690,3,4,1,881178365,881178383,18,148,546,2.9789473684210526
690,4,5,1,881178383,881179122,739,546,357,4.063291139240507
690,5,5,0,881179122,881179196,74,357,98,4.240875912408759
690,5,4,-1,881179196,881179222,26,98,496,4.094594594594595
690,4,1,-3,881179222,881179469,247,496,120,2.3421052631578947
690,1,2,1,881179469,881179505,36,120,89,3.9615384615384617
690,2,2,0,881179505,881179584,79,89,70,3.5833333333333335
690,2,5,3,881179584,881179682,98,70,64,4.373737373737374
690,5,4,-1,881179682,881179809,127,64,79,3.956989247311828
690,4,3,-1,881179809,881179878,69,79,742,3.5555555555555554
690,3,5,2,881179878,881179906,28,742,218,3.5555555555555554
690,5,3,-2,881179906,881179937,31,218,642,3.4285714285714284
690,3,3,0,881179937,881179968,31,642,233,3.323529411764706
690,3,3,0,881179968,881179969,1,233,226,3.378787878787879
690,3,4,1,881179969,881180056,87,226,118,3.2764227642276422
690,4,2,-2,881180056,881180109,53,118,581,3.130434782608696
690,2,3,1,881180109,881180138,29,581,1090,2.3529411764705883
690,3,3,0,881180138,881180427,289,1090,747,3.5526315789473686
690,3,3,0,881180427,881180543,116,747,51,3.5277777777777777
690,3,3,0,881180543,881180564,21,51,739,3.391304347826087
689,5,2,-3,876674637,876674692,55,748,879,3.2291666666666665
689,2,4,2,876674692,876674762,70,879,358,2.6551724137931036
689,4,5,1,876674762,876674954,192,358,258,3.7547169811320753
689,5,3,-2,876674954,876675152,198,258,125,3.5555555555555554
689,3,4,1,876675152,876676165,1013,125,597,3.2771084337349397
689,4,3,-1,876676165,876676211,46,597,1,3.902439024390244
689,3,5,2,876676211,876676292,81,1,405,3.25
689,5,4,-1,876676292,876676334,42,405,475,3.956043956043956
689,4,3,-1,876676334,876676359,25,475,717,2.9696969696969697
689,3,5,2,876676359,876676397,38,717,257,3.7154471544715446
689,5,5,0,876676397,876676433,36,257,121,3.521212121212121
689,5,3,-2,876676433,876676501,68,121,111,3.5106382978723403
689,3,5,2,876676501,876676502,1,111,15,3.725663716814159
689,5,3,-2,876676502,879211543,2535041,15,260,2.4716981132075473
686,5,5,0,879543557,879545340,1783,299,134,4.174603174603175
686,5,3,-2,879545340,879545413,73,134,176,3.967032967032967
686,3,5,2,879545413,879545481,68,176,187,4.215189873417722
686,5,5,0,879545481,879545549,68,187,357,4.063291139240507
686,5,5,0,879545549,879545550,1,357,209,3.8275862068965516
686,5,5,0,879545550,879545603,53,209,185,3.9726027397260273
686,5,5,0,879545603,879545662,59,185,504,4.085714285714285
686,5,5,0,879545662,879545758,96,504,435,3.8933333333333335
686,5,4,-1,879545758,879546083,325,435,11,3.8904109589041096
686,4,4,0,879546083,879546147,64,11,28,3.923076923076923
686,4,5,1,879546147,879546217,70,28,182,3.842857142857143
686,5,5,0,879546217,879546319,102,182,806,3.6666666666666665
686,5,4,-1,879546319,879546443,124,806,79,3.956989247311828
686,4,5,1,879546443,879546497,54,79,518,3.5833333333333335
686,5,4,-1,879546497,879546553,56,518,204,3.6744186046511627
686,4,5,1,879546553,879546715,162,204,178,4.378378378378378
686,5,4,-1,879546715,879546786,71,178,430,4.136363636363637
686,4,5,1,879546786,879546847,61,430,603,4.315789473684211
686,5,5,0,879546847,879546954,107,603,654,4.119047619047619
686,5,5,0,879546954,879547043,89,654,170,4.242424242424242
686,5,5,0,879547043,879547129,86,170,168,4.0476190476190474
686,5,3,-2,879547129,879547177,48,168,527,3.823529411764706
686,3,5,2,879547177,879547224,47,527,64,4.373737373737374
686,5,5,0,879547224,879547276,52,64,135,3.7974683544303796
686,5,4,-1,879547276,879547337,61,135,181,3.98974358974359
693,3,4,1,875481397,875482092,695,333,318,4.5046728971962615
693,4,3,-1,875482092,875482136,44,318,64,4.373737373737374
693,3,4,1,875482136,875482168,32,64,23,3.9047619047619047
693,4,5,1,875482168,875482169,1,23,357,4.063291139240507
693,5,4,-1,875482169,875482197,28,357,11,3.8904109589041096
693,4,3,-1,875482197,875482280,83,11,527,3.823529411764706
693,3,3,0,875482280,875482309,29,527,180,3.9473684210526314
693,3,3,0,875482309,875482364,55,180,650,3.1363636363636362
693,3,2,-1,875482364,875482396,32,650,942,3.4545454545454546
693,2,2,0,875482396,875482447,51,942,508,3.6923076923076925
693,2,2,0,875482447,875482477,30,508,582,3.7457627118644066
693,2,2,0,875482477,875482524,47,582,222,3.578125
693,2,2,0,875482524,875482548,24,222,196,3.9404761904761907
693,2,3,1,875482548,875482604,56,196,655,3.7857142857142856
693,3,4,1,875482604,875482626,22,655,282,3.610526315789474
693,4,3,-1,875482626,875482653,27,282,471,3.5714285714285716
693,3,4,1,875482653,875482689,36,471,382,3.764705882352941
693,4,4,0,875482689,875482779,90,382,157,3.5714285714285716
693,4,3,-1,875482779,875482826,47,157,631,3.581818181818182
693,3,2,-1,875482826,875482860,34,631,77,3.3857142857142857
693,2,4,2,875482860,875482912,52,77,729,3.3793103448275863
693,4,1,-3,875482912,875482939,27,729,1311,2.125
693,1,3,2,875482939,875483020,81,1311,660,3.71875
693,3,3,0,875483020,875483049,29,660,708,3.3157894736842106
693,3,4,1,875483049,875483050,1,708,673,3.393939393939394
693,4,2,-2,875483050,875483114,64,673,1232,2.6666666666666665
693,2,1,-1,875483114,875483144,30,1232,130,1.8461538461538463
693,1,1,0,875483144,875483234,90,130,546,2.9789473684210526
693,1,4,3,875483234,875483268,34,546,98,4.240875912408759
693,4,2,-2,875483268,875483301,33,98,183,3.951219512195122
693,2,5,3,875483301,875483302,1,183,504,4.085714285714285
693,5,2,-3,875483302,875483330,28,504,234,3.7674418604651163
693,2,2,0,875483330,875483435,105,234,229,3.185185185185185
693,2,4,2,875483435,875483473,38,229,218,3.5555555555555554
693,4,4,0,875483473,875483521,48,218,159,3.3902439024390243
693,4,3,-1,875483521,875483670,149,159,1522,2.5
693,3,2,-1,875483670,875483847,177,1522,188,3.625
693,2,3,1,875483847,875483947,100,188,172,4.225225225225225
693,3,4,1,875483947,875483977,30,172,117,3.689189189189189
693,4,3,-1,875483977,875484044,67,117,210,3.921259842519685
693,3,3,0,875484044,875484089,45,210,472,2.984375
693,3,2,-1,875484089,875484148,59,472,572,2.857142857142857
693,2,4,2,875484148,875484406,258,572,611,4.384615384615385
693,4,4,0,875484406,875484431,25,611,514,4.033333333333333
693,4,2,-2,875484431,875484501,70,514,419,3.8208955223880596
693,2,4,2,875484501,875484539,38,419,134,4.174603174603175
693,4,4,0,875484539,875484562,23,134,132,3.929411764705882
693,4,4,0,875484562,875484584,22,132,606,4.294117647058823
693,4,4,0,875484584,875484613,29,606,216,3.8454545454545452
693,4,3,-1,875484613,875484763,150,216,428,3.744186046511628
693,3,3,0,875484763,875484837,74,428,484,4.116279069767442
693,3,2,-1,875484837,875484882,45,484,186,3.905263157894737
693,2,4,2,875484882,875484908,26,186,432,3.719298245614035
693,4,2,-2,875484908,875484932,24,432,506,3.566666666666667
693,2,3,1,875484932,875484953,21,506,131,3.731707317073171
693,3,2,-1,875484953,875485037,84,131,520,4.136363636363637
693,2,3,1,875485037,883975358,8490321,520,1136,3.3076923076923075
693,3,2,-1,883975358,883975537,179,1136,378,3.6904761904761907
693,2,3,1,883975537,883975558,21,378,199,4.191489361702128
693,3,2,-1,883975558,883975636,78,199,855,3.590909090909091
693,2,4,2,883975636,883975697,61,855,25,3.3185840707964602
693,4,5,1,883975697,885703726,1728029,25,313,4.323076923076923
693,5,3,-2,885703726,885703740,14,313,298,3.779220779220779
693,3,3,0,885703740,889167954,3464214,298,291,3.2
688,4,5,1,884153505,884153606,101,307,326,3.262295081967213
688,5,5,0,884153606,884153712,106,326,288,3.5214285714285714
688,5,2,-3,884153712,884153728,16,288,336,2.4
697,5,2,-3,882621460,882621523,63,302,682,3.0476190476190474
697,2,4,2,882621523,882621569,46,682,294,3.1052631578947367
697,4,3,-1,882621569,882621595,26,294,876,3.0
697,3,3,0,882621595,882621651,56,876,260,2.4716981132075473
697,3,4,1,882621651,882621673,22,260,325,2.625
697,4,2,-2,882621673,882621714,41,325,339,2.7058823529411766
697,2,4,2,882621714,882621913,199,339,181,3.98974358974359
697,4,3,-1,882621913,882621958,45,181,1089,2.1363636363636362
697,3,3,0,882621958,882622044,86,1089,928,3.142857142857143
697,3,4,1,882622044,882622066,22,928,595,2.9166666666666665
697,4,5,1,882622066,882622146,80,595,283,3.901639344262295
697,5,5,0,882622146,882622170,24,283,1067,3.533333333333333
697,5,4,-1,882622170,882622208,38,1067,763,3.347826086956522
697,4,4,0,882622208,882622228,20,763,818,2.769230769230769
697,4,3,-1,882622228,882622287,59,818,456,2.2
697,3,3,0,882622287,882622373,86,456,820,3.0444444444444443
697,3,5,2,882622373,882622414,41,820,237,3.7315436241610738
697,5,3,-2,882622414,882622430,16,237,815,3.135135135135135
697,3,5,2,882622430,882622481,51,815,751,3.3896103896103895
697,5,5,0,882622481,882622505,24,751,276,3.6036036036036037
697,5,1,-4,882622505,882622526,21,276,1245,2.3333333333333335
697,1,3,2,882622526,882622559,33,1245,125,3.5555555555555554
697,3,5,2,882622559,882622581,22,125,284,3.1547619047619047
697,5,3,-2,882622581,882622597,16,284,280,3.103448275862069
697,3,3,0,882622597,882622680,83,280,225,3.0714285714285716
697,3,5,2,882622680,882622798,118,225,7,3.76056338028169
697,5,1,-4,882622798,882622824,26,7,1012,3.2916666666666665
698,3,4,1,886365557,886365606,49,751,330,2.625
698,4,4,0,886365606,886365629,23,330,307,3.6031746031746033
698,4,1,-3,886365629,886365802,173,307,988,2.5555555555555554
698,1,3,2,886365802,886366141,339,988,181,3.98974358974359
698,3,4,1,886366141,886366190,49,181,515,4.202898550724638
698,4,3,-1,886366190,886366213,23,515,255,3.2027027027027026
698,3,4,1,886366213,886366483,270,255,195,3.9072164948453607
698,4,4,0,886366483,886366515,32,195,96,3.9130434782608696
698,4,3,-1,886366515,886366558,43,96,134,4.174603174603175
698,3,2,-1,886366558,886366611,53,134,526,3.909090909090909
698,2,4,2,886366611,886366652,41,526,10,3.85
698,4,3,-1,886366652,886366690,38,10,496,4.094594594594595
698,3,2,-1,886366690,886366731,41,496,423,3.7016129032258065
698,2,4,2,886366731,886366770,39,423,603,4.315789473684211
698,4,3,-1,886366770,886366814,44,603,490,3.5454545454545454
698,3,4,1,886366814,886366848,34,490,433,3.8035714285714284
698,4,4,0,886366848,886366955,107,433,131,3.731707317073171
698,4,3,-1,886366955,886366980,25,131,435,3.8933333333333335
698,3,2,-1,886366980,886367066,86,435,211,3.958904109589041
698,2,2,0,886367066,886367100,34,211,945,3.4
698,2,3,1,886367100,886367133,33,945,483,4.475609756097561
698,3,2,-1,886367133,886367366,233,483,421,3.462962962962963
698,2,3,1,886367366,886367442,76,421,228,3.7246376811594204
698,3,3,0,886367442,886367473,31,228,481,3.8421052631578947
698,3,3,0,886367473,886367474,1,481,419,3.8208955223880596
698,3,2,-1,886367474,886367508,34,419,487,4.043478260869565
698,2,3,1,886367508,886367530,22,487,143,3.56
698,3,2,-1,886367530,886367586,56,143,153,3.7865168539325844
698,2,1,-1,886367586,886367615,29,153,1021,3.8666666666666667
698,1,2,1,886367615,886367693,78,1021,511,4.096153846153846
698,2,3,1,886367693,886367775,82,511,202,3.730337078651685
698,3,3,0,886367775,886367849,74,202,489,4.076923076923077
698,3,3,0,886367849,886367874,25,489,220,3.433333333333333
698,3,2,-1,886367874,886367917,43,220,25,3.3185840707964602
698,2,3,1,886367917,886367956,39,25,9,3.8878504672897196
670,4,5,1,877974549,877974604,55,199,519,4.291666666666667
670,5,3,-2,877974604,877974605,1,519,615,3.8333333333333335
670,3,2,-1,877974605,877974699,94,615,515,4.202898550724638
670,2,4,2,877974699,877974787,88,515,195,3.9072164948453607
670,4,5,1,877974787,877974857,70,195,657,4.341463414634147
670,5,5,0,877974857,877974905,48,657,705,3.7857142857142856
670,5,4,-1,877974905,877974945,40,705,419,3.8208955223880596
670,4,5,1,877974945,877975017,72,419,480,4.283018867924528
670,5,3,-2,877975017,877975070,53,480,474,4.172413793103448
670,3,5,2,877975070,877975200,130,474,483,4.475609756097561
670,5,4,-1,877975200,877975285,85,483,511,4.096153846153846
670,4,5,1,877975285,877975344,59,511,228,3.7246376811594204
670,5,5,0,877975344,877975391,47,228,484,4.116279069767442
670,5,2,-3,877975391,877975392,1,484,161,3.5844155844155843
670,2,2,0,877975392,877975448,56,161,175,3.8354430379746836
670,2,4,2,877975448,877975594,146,175,8,3.903225806451613
670,4,2,-2,877975594,877975731,137,8,98,4.240875912408759
694,5,5,0,875726618,875726708,90,357,530,4.125
694,5,3,-2,875726708,875726759,51,530,1050,3.6153846153846154
694,3,5,2,875726759,875726793,34,1050,1269,4.25
694,5,5,0,875726793,875726886,93,1269,98,4.240875912408759
694,5,4,-1,875726886,875726926,40,98,673,3.393939393939394
694,4,5,1,875726926,875726968,42,673,205,3.717391304347826
694,5,5,0,875726968,875727061,93,205,174,4.253521126760563
694,5,4,-1,875727061,875727099,38,174,178,4.378378378378378
694,4,4,0,875727099,875727144,45,178,470,3.72
694,4,4,0,875727144,875727189,45,470,606,4.294117647058823
694,4,5,1,875727189,875727226,37,606,196,3.9404761904761907
694,5,4,-1,875727226,875727270,44,196,506,3.566666666666667
694,4,4,0,875727270,875727271,1,506,449,2.9069767441860463
694,4,4,0,875727271,875727306,35,449,228,3.7246376811594204
694,4,4,0,875727306,875727399,93,228,604,3.8181818181818183
694,4,4,0,875727399,875727476,77,604,603,4.315789473684211
694,4,4,0,875727476,875727513,37,603,605,3.3333333333333335
694,4,3,-1,875727513,875727550,37,605,1205,4.0
694,3,4,1,875727550,875727581,31,1205,492,4.117647058823529
694,4,4,0,875727581,875727582,1,492,187,4.215189873417722
694,4,5,1,875727582,875727640,58,187,132,3.929411764705882
694,5,4,-1,875727640,875727672,32,132,965,3.7142857142857144
694,4,5,1,875727672,875727715,43,965,131,3.731707317073171
694,5,5,0,875727715,875727749,34,131,191,4.168674698795181
694,5,4,-1,875727749,875727781,32,191,481,3.8421052631578947
694,4,4,0,875727781,875727821,40,481,836,4.142857142857143
694,4,4,0,875727821,875727877,56,836,523,4.159090909090909
694,4,3,-1,875727877,875727926,49,523,23,3.9047619047619047
694,3,5,2,875727926,875728048,122,23,511,4.096153846153846
694,5,4,-1,875728048,875728181,133,511,659,4.027777777777778
694,4,4,0,875728181,875728293,112,659,519,4.291666666666667
694,4,4,0,875728293,875728435,142,519,193,3.883720930232558
694,4,4,0,875728435,875728508,73,193,153,3.7865168539325844
694,4,3,-1,875728508,875728581,73,153,1028,2.857142857142857
694,3,4,1,875728581,875728801,220,1028,229,3.185185185185185
694,4,3,-1,875728801,875728842,41,229,1221,3.4285714285714284
694,3,3,0,875728842,875728912,70,1221,504,4.085714285714285
694,3,4,1,875728912,875728952,40,504,485,3.717948717948718
694,4,3,-1,875728952,875728989,37,485,671,3.4285714285714284
694,3,4,1,875728989,875729107,118,671,72,3.175438596491228
694,4,5,1,875729107,875729146,39,72,176,3.967032967032967
694,5,3,-2,875729146,875729271,125,176,226,3.378787878787879
694,3,4,1,875729271,875729304,33,226,28,3.923076923076923
694,4,5,1,875729304,875729431,127,28,526,3.909090909090909
694,5,4,-1,875729431,875729520,89,526,185,3.9726027397260273
694,4,4,0,875729520,875729667,147,185,52,3.727272727272727
694,4,4,0,875729667,875729830,163,52,216,3.8454545454545452
694,4,4,0,875729830,875729907,77,216,419,3.8208955223880596
694,4,4,0,875729907,875729982,75,419,163,3.53125
694,4,4,0,875729982,875729983,1,163,610,3.1818181818181817
694,4,3,-1,875729983,875730042,59,610,521,3.787878787878788
694,3,4,1,875730042,875730082,40,521,385,3.6129032258064515
694,4,5,1,875730082,875730386,304,385,50,4.306532663316583
694,5,3,-2,875730386,875731050,664,50,491,3.55
680,4,4,0,876816043,876816162,119,294,517,3.625
680,4,4,0,876816162,876816224,62,517,98,4.240875912408759
680,4,5,1,876816224,876816268,44,98,408,4.4772727272727275
680,5,4,-1,876816268,876816310,42,408,137,3.9545454545454546
680,4,5,1,876816310,877075079,258769,137,285,4.181818181818182
680,5,5,0,877075079,877075105,26,285,150,3.803921568627451
680,5,5,0,877075105,877075164,59,150,151,3.6544117647058822
680,5,3,-2,877075164,877075214,50,151,273,3.5238095238095237
680,3,4,1,877075214,877075241,27,273,845,3.661290322580645
680,4,4,0,877075241,877075273,32,845,20,3.375
680,4,3,-1,877075273,877075312,39,20,274,3.5609756097560976
705,5,5,0,883426780,883426944,164,300,117,3.689189189189189
705,5,4,-1,883426944,883427012,68,117,111,3.5106382978723403
705,4,5,1,883427012,883427048,36,111,275,4.087912087912088
705,5,5,0,883427048,883427152,104,275,255,3.2027027027027026
705,5,5,0,883427152,883427216,64,255,282,3.610526315789474
705,5,3,-2,883427216,883427297,81,282,15,3.725663716814159
705,3,5,2,883427297,883427318,21,15,222,3.578125
705,5,4,-1,883427318,883427377,59,222,118,3.2764227642276422
705,4,5,1,883427377,883427479,102,118,121,3.521212121212121
705,5,2,-3,883427479,883427530,51,121,363,3.0
705,2,1,-1,883427530,883427552,22,363,252,2.911392405063291
705,1,4,3,883427552,883427594,42,252,225,3.0714285714285716
705,4,3,-1,883427594,883427663,69,225,419,3.8208955223880596
705,3,4,1,883427663,883427716,53,419,393,3.5125
705,4,4,0,883427716,883427737,21,393,1035,3.03125
705,4,5,1,883427737,883427778,41,1035,399,3.317073170731707
705,5,2,-3,883427778,883427796,18,399,843,2.933333333333333
705,2,3,1,883427796,883427817,21,843,820,3.0444444444444443
705,3,5,2,883427817,883427857,40,820,1043,3.2
705,5,1,-4,883427857,883427875,18,1043,862,1.6666666666666667
705,1,3,2,883427875,883427932,57,862,627,3.3823529411764706
705,3,2,-1,883427932,883427951,19,627,560,3.111111111111111
705,2,2,0,883427951,883427988,37,560,183,3.951219512195122
705,2,3,1,883427988,883428028,40,183,226,3.378787878787879
705,3,2,-1,883428028,883428083,55,226,195,3.9072164948453607
705,2,3,1,883428083,883428084,1,195,684,3.847826086956522
705,3,3,0,883428084,883428109,25,684,228,3.7246376811594204
705,3,4,1,883428109,883428128,19,228,576,3.125
705,4,5,1,883428128,883428154,26,576,265,3.710144927536232
705,5,4,-1,883428154,883428178,24,265,227,3.169811320754717
705,4,3,-1,883428178,883428201,23,227,849,2.5625
705,3,5,2,883428201,883428237,36,849,29,2.5714285714285716
705,5,4,-1,883428237,883428238,1,29,826,2.5555555555555554
705,4,2,-2,883428238,883428258,20,826,1228,2.5
705,2,3,1,883428258,883428276,18,1228,578,3.066666666666667
705,3,5,2,883428276,883518731,90455,578,318,4.5046728971962615
705,5,3,-2,883518731,883518765,34,318,97,3.7282608695652173
705,3,2,-1,883518765,883518783,18,97,427,4.2025316455696204
705,2,2,0,883518783,883518834,51,427,58,3.543859649122807
705,2,3,1,883518834,883518852,18,58,655,3.7857142857142856
705,3,2,-1,883518852,883518871,19,655,215,3.662921348314607
705,2,3,1,883518871,883518903,32,215,193,3.883720930232558
701,4,4,0,891446520,891446521,1,690,313,4.323076923076923
701,4,5,1,891446521,891446559,38,313,272,4.2
701,5,5,0,891446559,891446588,29,272,750,4.027777777777778
701,5,4,-1,891446588,891446618,30,750,303,3.75
701,4,5,1,891446618,891446679,61,303,311,3.761904761904762
701,5,4,-1,891446679,891446707,28,311,326,3.262295081967213
701,4,3,-1,891446707,891446730,23,326,312,3.0
701,3,4,1,891446730,891446754,24,312,292,3.6666666666666665
701,4,4,0,891446754,891446788,34,292,751,3.3896103896103895
701,4,3,-1,891446788,891446822,34,751,689,3.1538461538461537
701,3,4,1,891446822,891446857,35,689,289,2.988888888888889
701,4,3,-1,891446857,891447164,307,289,255,3.2027027027027026
701,3,4,1,891447164,891447197,33,255,257,3.7154471544715446
701,4,5,1,891447197,891447198,1,257,237,3.7315436241610738
701,5,5,0,891447198,891447228,30,237,275,4.087912087912088
699,3,3,0,878881676,878881828,152,294,127,4.162790697674419
699,3,3,0,878881828,878881875,47,127,111,3.5106382978723403
699,3,3,0,878881875,878881952,77,111,14,4.101694915254237
699,3,3,0,878881952,878882002,50,14,151,3.6544117647058822
699,3,3,0,878882002,878882082,80,151,181,3.98974358974359
699,3,3,0,878882082,878882133,51,181,225,3.0714285714285716
699,3,3,0,878882133,878882178,45,225,455,3.1702127659574466
699,3,3,0,878882178,878882226,48,455,933,2.5
699,3,3,0,878882226,878882272,46,933,1,3.902439024390244
699,3,3,0,878882272,878882366,94,1,121,3.521212121212121
699,3,3,0,878882366,878882410,44,121,532,2.7777777777777777
699,3,3,0,878882410,878882411,1,532,477,3.1666666666666665
699,3,3,0,878882411,878882455,44,477,762,3.3962264150943398
699,3,1,-2,878882455,878882511,56,762,15,3.725663716814159
699,1,3,2,878882511,878882608,97,15,405,3.25
699,3,4,1,878882608,878882668,60,405,1009,3.2962962962962963
699,4,3,-1,878882668,878882836,168,1009,1375,3.5
699,3,3,0,878882836,878883112,276,1375,202,3.730337078651685
699,3,4,1,878883112,878883113,1,202,23,3.9047619047619047
699,4,3,-1,878883113,879147032,263919,23,678,2.8181818181818183
699,3,4,1,879147032,879147109,77,678,544,3.185185185185185
699,4,3,-1,879147109,879147169,60,544,1061,2.9166666666666665
699,3,3,0,879147169,879147239,70,1061,760,2.35
699,3,4,1,879147239,879147366,127,760,323,3.0
699,4,3,-1,879147366,879147367,1,323,1060,3.235294117647059
699,3,4,1,879147367,879147497,130,1060,324,3.2291666666666665
699,4,2,-2,879147497,879147550,53,324,977,2.473684210526316
699,2,3,1,879147550,879147597,47,977,471,3.5714285714285716
699,3,3,0,879147597,879147722,125,471,1013,2.388888888888889
699,3,3,0,879147722,879147769,47,1013,546,2.9789473684210526
699,3,3,0,879147769,879147814,45,546,985,2.9
699,3,5,2,879147814,879148050,236,985,325,2.625
699,5,4,-1,879148050,879148051,1,325,458,3.0588235294117645
699,4,3,-1,879148051,879148129,78,458,370,2.8125
699,3,3,0,879148129,879148201,72,370,275,4.087912087912088
699,3,3,0,879148201,879148259,58,275,16,3.411764705882353
699,3,3,0,879148259,879382830,234571,16,991,2.4545454545454546
699,3,4,1,879382830,879382955,125,991,308,3.6153846153846154
699,4,3,-1,879382955,879383009,54,308,321,3.0172413793103448
699,3,3,0,879383009,880695324,1312315,321,271,3.3134328358208953
699,3,4,1,880695324,880695431,107,271,304,3.5306122448979593
699,4,3,-1,880695431,880695597,166,304,683,2.176470588235294
699,3,2,-1,880695597,880696678,1081,683,1028,2.857142857142857
699,2,1,-1,880696678,880696679,1,1028,456,2.2
699,1,4,3,880696679,883278783,2582104,456,246,4.0
699,4,5,1,883278783,883278844,61,246,258,3.7547169811320753
699,5,4,-1,883278844,883279196,352,258,989,3.142857142857143
699,4,3,-1,883279196,884152706,873510,989,413,2.5652173913043477
699,3,3,0,884152706,884152780,74,413,596,3.180327868852459
699,3,3,0,884152780,884152916,136,596,21,2.9210526315789473
699,3,4,1,884152916,884152917,1,21,1033,3.0
699,4,3,-1,884152917,884152976,59,1033,112,2.7
699,3,2,-1,884152976,885775430,1622454,112,220,3.433333333333333
699,2,3,1,885775430,885775479,49,220,276,3.6036036036036037
699,3,3,0,885775479,886568097,792618,276,983,2.5
699,3,3,0,886568097,886568162,65,983,764,3.1176470588235294
699,3,4,1,886568162,893140697,6572535,764,269,4.085106382978723
699,4,3,-1,893140697,893140941,244,269,880,2.8421052631578947
704,2,2,0,891396674,891396904,230,300,259,2.492063492063492
704,2,4,2,891396904,891397015,111,259,347,3.59375
704,4,3,-1,891397015,891397086,71,347,170,4.242424242424242
704,3,4,1,891397086,891397112,26,170,210,3.921259842519685
704,4,3,-1,891397112,891397190,78,210,655,3.7857142857142856
704,3,3,0,891397190,891397262,72,655,191,4.168674698795181
704,3,5,2,891397262,891397305,43,191,89,3.9615384615384617
704,5,5,0,891397305,891397441,136,89,134,4.174603174603175
704,5,3,-2,891397441,891397491,50,134,528,4.241379310344827
704,3,5,2,891397491,891397535,44,528,491,3.55
704,5,5,0,891397535,891397570,35,491,488,4.277777777777778
704,5,4,-1,891397570,891397571,1,488,382,3.764705882352941
704,4,4,0,891397571,891397667,96,382,661,4.133333333333334
704,4,3,-1,891397667,891397712,45,661,175,3.8354430379746836
704,3,3,0,891397712,891397713,1,175,381,3.2758620689655173
704,3,3,0,891397713,891397764,51,381,611,4.384615384615385
704,3,4,1,891397764,891397819,55,611,136,3.764705882352941
704,4,5,1,891397819,891398726,907,136,131,3.731707317073171
707,5,5,0,879438988,879439088,100,286,319,3.0408163265306123
707,5,4,-1,879439088,879439382,294,319,882,3.6666666666666665
707,4,4,0,879439382,879439418,36,882,995,3.0
707,4,3,-1,879439418,880059687,620269,995,1171,2.857142857142857
707,3,5,2,880059687,880059749,62,1171,285,4.181818181818182
707,5,4,-1,880059749,880059774,25,285,287,3.4516129032258065
707,4,5,1,880059774,880059810,36,287,100,4.0162162162162165
707,5,5,0,880059810,880059876,66,100,718,3.8
707,5,1,-4,880059876,880059921,45,718,1142,4.0476190476190474
707,1,5,4,880059921,880059974,53,1142,116,3.6666666666666665
707,5,5,0,880059974,880059995,21,116,93,3.5641025641025643
707,5,5,0,880059995,880060066,71,93,847,3.7333333333333334
707,5,3,-2,880060066,880060118,52,847,14,4.101694915254237
707,3,4,1,880060118,880060180,62,14,1007,4.117647058823529
707,4,4,0,880060180,880060262,82,1007,864,3.2142857142857144
707,4,4,0,880060262,880060420,158,864,111,3.5106382978723403
707,4,3,-1,880060420,880060460,40,111,1008,3.5
707,3,3,0,880060460,880060724,264,1008,952,3.3529411764705883
707,3,4,1,880060724,880060820,96,952,473,2.9166666666666665
707,4,4,0,880060820,880060974,154,473,1120,3.1
707,4,3,-1,880060974,880061111,137,1120,476,3.1216216216216215
707,3,3,0,880061111,880061252,141,476,1255,3.0
707,3,2,-1,880061252,880061287,35,1255,950,2.625
707,2,3,1,880061287,880061346,59,950,1381,3.75
707,3,4,1,880061346,880061405,59,1381,1068,3.2
707,4,3,-1,880061405,880061579,174,1068,166,4.0
707,3,5,2,880061579,880061652,73,166,647,4.142857142857143
707,5,4,-1,880061652,882200872,2139220,647,310,3.6666666666666665
707,4,3,-1,882200872,886285216,4084344,310,903,2.6666666666666665
707,3,5,2,886285216,886285277,61,903,347,3.59375
707,5,4,-1,886285277,886285762,485,347,606,4.294117647058823
707,4,3,-1,886285762,886285791,29,606,1141,3.6666666666666665
707,3,2,-1,886285791,886285792,1,1141,490,3.5454545454545454
707,2,4,2,886285792,886285824,32,490,648,3.9545454545454546
707,4,4,0,886285824,886285851,27,648,705,3.7857142857142856
707,4,4,0,886285851,886285876,25,705,97,3.7282608695652173
707,4,4,0,886285876,886285907,31,97,427,4.2025316455696204
707,4,3,-1,886285907,886285939,32,427,165,3.9130434782608696
707,3,3,0,886285939,886285968,29,165,419,3.8208955223880596
707,3,5,2,886285968,886286004,36,419,483,4.475609756097561
707,5,4,-1,886286004,886286057,53,483,467,4.071428571428571
707,4,5,1,886286057,886286092,35,467,923,4.142857142857143
707,5,3,-2,886286092,886286133,41,923,498,4.290909090909091
707,3,2,-1,886286133,886286134,1,498,172,4.225225225225225
707,2,3,1,886286134,886286170,36,172,4,3.5538461538461537
707,3,3,0,886286170,886286193,23,4,702,2.764705882352941
707,3,4,1,886286193,886286246,53,702,694,4.277777777777778
707,4,5,1,886286246,886286283,37,694,1109,3.4545454545454546
707,5,4,-1,886286283,886286311,28,1109,505,4.0625
707,4,2,-2,886286311,886286360,49,505,487,4.043478260869565
707,2,4,2,886286360,886286361,1,487,921,3.611111111111111
707,4,2,-2,886286361,886286380,19,921,173,4.1441441441441444
707,2,3,1,886286380,886286457,77,173,381,3.2758620689655173
707,3,4,1,886286457,886286491,34,381,488,4.277777777777778
707,4,3,-1,886286491,886286663,172,488,1401,3.0
707,3,2,-1,886286663,886286742,79,1401,506,3.566666666666667
707,2,4,2,886286742,886286792,50,506,212,3.230769230769231
707,4,5,1,886286792,886286819,27,212,507,3.6285714285714286
707,5,4,-1,886286819,886286844,25,507,631,3.581818181818182
707,4,3,-1,886286844,886286926,82,631,603,4.315789473684211
707,3,3,0,886286926,886286954,28,603,715,3.257142857142857
707,3,4,1,886286954,886286979,25,715,663,3.948717948717949
707,4,3,-1,886286979,886286999,20,663,525,4.0
707,3,3,0,886286999,886287051,52,525,766,3.3333333333333335
707,3,3,0,886287051,886287079,28,766,1021,3.8666666666666667
707,3,4,1,886287079,886287107,28,1021,792,3.793103448275862
707,4,4,0,886287107,886287130,23,792,197,4.112676056338028
707,4,4,0,886287130,886287160,30,197,732,3.6266666666666665
707,4,2,-2,886287160,886287191,31,732,140,3.238095238095238
707,2,4,2,886287191,886287236,45,140,703,3.75
707,4,5,1,886287236,886287268,32,703,425,3.7027027027027026
707,5,4,-1,886287268,886287290,22,425,602,3.533333333333333
707,4,4,0,886287290,886287310,20,602,57,4.133333333333334
707,4,3,-1,886287310,886287331,21,57,88,3.433734939759036
707,3,5,2,886287331,886287353,22,88,1628,4.333333333333333
707,5,4,-1,886287353,886287426,73,1628,632,3.9523809523809526
707,4,4,0,886287426,886287450,24,632,499,4.0
707,4,2,-2,886287450,886287471,21,499,640,2.75
707,2,3,1,886287471,886287497,26,640,371,3.0
707,3,4,1,886287497,886287531,34,371,811,4.166666666666667
707,4,3,-1,886287531,886287608,77,811,630,3.25
707,3,3,0,886287608,886287628,20,630,378,3.6904761904761907
707,3,3,0,886287628,886287662,34,378,486,3.9565217391304346
707,3,4,1,886287662,886287733,71,486,387,3.5357142857142856
707,4,5,1,886287733,886287854,121,387,1479,3.5
707,5,2,-3,886287854,886287876,22,1479,614,3.727272727272727
707,2,2,0,886287876,886287919,43,614,739,3.391304347826087
707,2,3,1,886287919,886287990,71,739,1168,3.4166666666666665
707,3,4,1,886287990,886288015,25,1168,953,3.076923076923077
707,4,2,-2,886288015,886288133,118,953,167,2.8181818181818183
707,2,3,1,886288133,886288189,56,167,106,2.8125
707,3,3,0,886288189,886288282,93,106,618,3.5
707,3,3,0,886288282,886288356,74,618,1530,2.5
707,3,3,0,886288356,886288455,99,1530,1018,3.0714285714285716
707,3,3,0,886288455,886288598,143,1018,155,3.0588235294117645
707,3,3,0,886288598,886288624,26,155,712,3.0434782608695654
707,3,2,-1,886288624,886288688,64,712,449,2.9069767441860463
707,2,2,0,886288688,886288754,66,449,313,4.323076923076923
707,2,5,3,886288754,890008121,3719367,313,902,3.9444444444444446
700,4,4,0,884493712,884493862,150,651,174,4.253521126760563
700,4,5,1,884493862,884493899,37,174,50,4.306532663316583
700,5,4,-1,884493899,884493943,44,50,423,3.7016129032258065
700,4,4,0,884493943,884494252,309,423,144,3.9545454545454546
700,4,3,-1,884494252,884494278,26,144,180,3.9473684210526314
700,3,4,1,884494278,884494380,102,180,531,3.7435897435897436
700,4,3,-1,884494380,884494420,40,531,79,3.956989247311828
687,4,3,-1,884651576,884651648,72,288,286,3.442857142857143
687,3,4,1,884651648,884651746,98,286,749,3.2777777777777777
687,4,4,0,884651746,884651818,72,749,321,3.0172413793103448
687,4,2,-2,884651818,884651894,76,321,323,3.0
687,2,5,3,884651894,884652088,194,323,268,3.9838709677419355
687,5,4,-1,884652088,884652089,1,268,300,3.6861313868613137
687,4,2,-2,884652089,884652144,55,300,336,2.4
687,2,3,1,884652144,884652197,53,336,264,2.65
687,3,3,0,884652197,884652276,79,264,748,3.1043478260869564
687,3,4,1,884652276,884652482,206,748,678,2.8181818181818183
695,3,4,1,888805797,888805836,39,305,302,4.133333333333334
695,4,5,1,888805836,888805837,1,302,242,3.5217391304347827
695,5,1,-4,888805837,888805864,27,242,895,3.142857142857143
695,1,3,2,888805864,888805913,49,895,286,3.442857142857143
695,3,2,-1,888805913,888805981,68,286,324,3.2291666666666665
695,2,5,3,888805981,888806056,75,324,319,3.0408163265306123
695,5,4,-1,888806056,888806120,64,319,307,3.6031746031746033
695,4,2,-2,888806120,888806150,30,307,289,2.988888888888889
695,2,3,1,888806150,888806193,43,289,312,3.0
695,3,1,-2,888806193,888806222,29,312,264,2.65
695,1,5,4,888806222,888806270,48,264,358,2.6551724137931036
675,4,5,1,889488487,889488522,35,750,303,3.75
675,5,5,0,889488522,889488575,53,303,896,3.6666666666666665
675,5,2,-3,889488575,889488624,49,896,312,3.0
675,2,4,2,889488624,889488679,55,312,874,3.230769230769231
675,4,2,-2,889488679,889488708,29,874,321,3.0172413793103448
675,2,2,0,889488708,889488779,71,321,891,2.0
675,2,5,3,889488779,889489273,494,891,318,4.5046728971962615
675,5,5,0,889489273,889489465,192,318,509,3.7058823529411766
675,5,4,-1,889489465,889489522,57,509,1007,4.117647058823529
675,4,5,1,889489522,889489691,169,1007,427,4.2025316455696204
675,5,3,-2,889489691,889489775,84,427,244,2.9411764705882355
675,3,5,2,889489775,889489837,62,244,1628,4.333333333333333
675,5,5,0,889489837,889489913,76,1628,1653,5.0
675,5,5,0,889489913,889489971,58,1653,650,3.1363636363636362
675,5,4,-1,889489971,889490029,58,650,1101,3.793103448275862
675,4,1,-3,889490029,889490151,122,1101,223,4.108695652173913
708,5,3,-2,877325186,877325213,27,50,127,4.162790697674419
708,3,4,1,877325213,877325236,23,127,117,3.689189189189189
708,4,5,1,877325236,877325279,43,117,181,3.98974358974359
708,5,3,-2,877325279,877325349,70,181,819,2.6666666666666665
708,3,5,2,877325349,877325375,26,819,1,3.902439024390244
708,5,3,-2,877325375,877325404,29,1,15,3.725663716814159
708,3,5,2,877325404,877325545,141,15,118,3.2764227642276422
708,5,4,-1,877325545,877325570,25,118,111,3.5106382978723403
708,4,4,0,877325570,877325601,31,111,125,3.5555555555555554
708,4,1,-3,877325601,877325656,55,125,473,2.9166666666666665
708,1,5,4,877325656,877325687,31,473,740,3.423076923076923
708,5,3,-2,877325687,877325838,151,740,25,3.3185840707964602
708,3,2,-1,877325838,877325905,67,25,276,3.6036036036036037
708,2,4,2,877325905,877325934,29,276,764,3.1176470588235294
708,4,4,0,877325934,877325956,22,764,278,3.0357142857142856
708,4,4,0,877325956,877326014,58,278,281,3.2
708,4,2,-2,877326014,877326037,23,281,1040,2.2666666666666666
708,2,2,0,877326037,877326062,25,1040,756,2.6885245901639343
708,2,4,2,877326062,877326086,24,756,274,3.5609756097560976
708,4,3,-1,877326086,877326114,28,274,1023,2.5714285714285716
708,3,4,1,877326114,877326158,44,1023,763,3.347826086956522
708,4,2,-2,877326158,877326217,59,763,1028,2.857142857142857
708,2,2,0,877326217,877326345,128,1028,597,3.2771084337349397
708,2,1,-1,877326345,892718596,15392251,597,352,1.8333333333333333
708,1,3,2,892718596,892718637,41,352,347,3.59375
708,3,5,2,892718637,892718687,50,347,313,4.323076923076923
708,5,2,-3,892718687,892718762,75,313,538,3.25
708,2,1,-1,892718762,892718796,34,538,271,3.3134328358208953
708,1,1,0,892718796,892718819,23,271,1280,2.3333333333333335
708,1,2,1,892718819,892718820,1,1280,887,3.5789473684210527
708,2,2,0,892718820,892718846,26,887,336,2.4
708,2,3,1,892718846,892718875,29,336,269,4.085106382978723
708,3,3,0,892718875,892718896,21,269,938,2.5555555555555554
708,3,3,0,892718896,892718919,23,938,880,2.8421052631578947
708,3,4,1,892718919,892718939,20,880,300,3.6861313868613137
708,4,4,0,892718939,892719007,68,300,326,3.262295081967213
708,4,1,-3,892719007,892719101,94,326,871,2.3823529411764706
708,1,5,4,892719101,892719143,42,871,1152,3.4375
708,5,5,0,892719143,892719144,1,1152,237,3.7315436241610738
708,5,4,-1,892719144,892719172,28,237,934,3.0294117647058822
708,4,4,0,892719172,892719193,21,934,1051,3.625
708,4,4,0,892719193,892719246,53,1051,148,3.2131147540983607
708,4,3,-1,892719246,892719304,58,148,981,2.0
708,3,5,2,892719304,892719340,36,981,284,3.1547619047619047
708,5,1,-4,892719340,892719363,23,284,283,3.901639344262295
709,5,3,-2,879846210,879846259,49,318,215,3.662921348314607
709,3,5,2,879846259,879846293,34,215,64,4.373737373737374
709,5,5,0,879846293,879846332,39,64,69,3.8015873015873014
709,5,4,-1,879846332,879846375,43,69,181,3.98974358974359
709,4,3,-1,879846375,879846440,65,181,7,3.76056338028169
709,3,5,2,879846440,879846489,49,7,50,4.306532663316583
709,5,3,-2,879846489,879846561,72,50,633,3.9
709,3,4,1,879846561,879846623,62,633,117,3.689189189189189
709,4,4,0,879846623,879846648,25,117,98,4.240875912408759
709,4,4,0,879846648,879846705,57,98,192,4.090909090909091
709,4,4,0,879846705,879846741,36,192,182,3.842857142857143
709,4,4,0,879846741,879846816,75,182,515,4.202898550724638
709,4,2,-2,879846816,879846868,52,515,65,3.511111111111111
709,2,1,-1,879846868,879846922,54,65,214,3.272727272727273
709,1,3,2,879846922,879847000,78,214,628,3.573529411764706
709,3,3,0,879847000,879847026,26,628,470,3.72
709,3,4,1,879847026,879847082,56,470,939,3.6333333333333333
709,4,4,0,879847082,879847686,604,939,273,3.5238095238095237
709,4,4,0,879847686,879847730,44,273,125,3.5555555555555554
709,4,4,0,879847730,879847879,149,125,293,3.630434782608696
709,4,4,0,879847879,879848053,174,293,200,3.8157894736842106
709,4,4,0,879848053,879848120,67,200,17,3.032258064516129
709,4,2,-2,879848120,879848167,47,17,447,3.46875
709,2,4,2,879848167,879848168,1,447,218,3.5555555555555554
709,4,2,-2,879848168,879848209,41,218,413,2.5652173913043477
709,2,3,1,879848209,879848239,30,413,769,2.2222222222222223
709,3,3,0,879848239,879848272,33,769,53,2.9523809523809526
709,3,3,0,879848272,879848318,46,53,859,2.75
709,3,3,0,879848318,879848319,1,859,145,2.3636363636363638
709,3,5,2,879848319,879848396,77,145,174,4.253521126760563
709,5,5,0,879848396,879848397,1,174,172,4.225225225225225
709,5,4,-1,879848397,879848432,35,172,176,3.967032967032967
709,4,3,-1,879848432,879848475,43,176,550,3.272727272727273
709,3,5,2,879848475,879848511,36,550,161,3.5844155844155843
709,5,3,-2,879848511,879848551,40,161,4,3.5538461538461537
709,3,4,1,879848551,879848590,39,4,849,2.5625
709,4,3,-1,879848590,879848646,56,849,231,2.938775510204082
709,3,4,1,879848646,879848695,49,231,576,3.125
709,4,4,0,879848695,879848744,49,576,554,2.9555555555555557
709,4,4,0,879848744,879848792,48,554,472,2.984375
709,4,4,0,879848792,879848824,32,472,841,2.772727272727273
709,4,3,-1,879848824,879848925,101,841,762,3.3962264150943398
709,3,1,-2,879848925,879848969,44,762,451,3.207792207792208
709,1,3,2,879848969,879849049,80,451,739,3.391304347826087
709,3,3,0,879849049,879849185,136,739,402,3.3076923076923075
709,3,1,-2,879849185,879849330,145,402,738,3.0
709,1,4,3,879849330,879849372,42,738,203,3.826923076923077
711,4,5,1,876185574,876185673,99,181,475,3.956043956043956
711,5,1,-4,876185673,876185726,53,475,121,3.521212121212121
711,1,1,0,876185726,876185767,41,121,763,3.347826086956522
711,1,5,4,876185767,876185812,45,763,676,3.3142857142857145
711,5,4,-1,876185812,876185832,20,676,476,3.1216216216216215
711,4,5,1,876185832,876185855,23,476,275,4.087912087912088
711,5,3,-2,876185855,876185896,41,275,222,3.578125
711,3,5,2,876185896,876185943,47,222,10,3.85
711,5,5,0,876185943,876278804,92861,10,134,4.174603174603175
711,5,4,-1,876278804,876278860,56,134,64,4.373737373737374
711,4,5,1,876278860,879991049,3712189,64,306,4.033333333333333
711,5,4,-1,879991049,879991247,198,306,845,3.661290322580645
711,4,3,-1,879991247,879991283,36,845,713,3.5
711,3,1,-2,879991283,879991364,81,713,288,3.5214285714285714
711,1,2,1,879991364,879991458,94,288,1289,2.0
711,2,5,3,879991458,879991476,18,1289,277,3.6
711,5,1,-4,879991476,879991585,109,277,472,2.984375
711,1,1,0,879991585,879991762,177,472,1152,3.4375
711,1,2,1,879991762,879992038,276,1152,254,2.7419354838709675
711,2,4,2,879992038,879992445,407,254,135,3.7974683544303796
711,4,4,0,879992445,879992870,425,135,432,3.719298245614035
711,4,5,1,879992870,879992929,59,432,169,4.548387096774194
711,5,4,-1,879992929,879993028,99,169,58,3.543859649122807
711,4,4,0,879993028,879993053,25,58,48,4.055555555555555
711,4,5,1,879993053,879993073,20,48,496,4.094594594594595
711,5,4,-1,879993073,879993092,19,496,193,3.883720930232558
711,4,4,0,879993092,879993126,34,193,238,3.888888888888889
711,4,3,-1,879993126,879993150,24,238,692,3.56
711,3,4,1,879993150,879993173,23,692,588,3.8358208955223883
711,4,4,0,879993173,879993194,21,588,202,3.730337078651685
711,4,4,0,879993194,879993278,84,202,485,3.717948717948718
711,4,5,1,879993278,879993318,40,485,921,3.611111111111111
711,5,5,0,879993318,879993579,261,921,707,3.909090909090909
711,5,5,0,879993579,879993605,26,707,582,3.7457627118644066
711,5,5,0,879993605,879993628,23,582,83,4.204081632653061
711,5,4,-1,879993628,879993629,1,83,727,3.5517241379310347
711,4,4,0,879993629,879993650,21,727,704,3.125
711,4,4,0,879993650,879993674,24,704,402,3.3076923076923075
711,4,5,1,879993674,879993728,54,402,699,3.736842105263158
711,5,3,-2,879993728,879993758,30,699,684,3.847826086956522
711,3,3,0,879993758,879993799,41,684,232,3.0789473684210527
711,3,5,2,879993799,879993871,72,232,736,4.083333333333333
711,5,3,-2,879993871,879993890,19,736,173,4.1441441441441444
711,3,3,0,879993890,879993918,28,173,662,3.4583333333333335
711,3,3,0,879993918,879993959,41,662,380,3.4878048780487805
711,3,3,0,879993959,879993997,38,380,1518,3.142857142857143
711,3,5,2,879993997,879994390,393,1518,966,4.7
711,5,4,-1,879994390,879994413,23,966,91,3.6
711,4,4,0,879994413,879994433,20,91,203,3.826923076923077
711,4,4,0,879994433,879994454,21,203,217,3.1538461538461537
711,4,4,0,879994454,879994495,41,217,161,3.5844155844155843
711,4,4,0,879994495,879994513,18,161,403,3.298507462686567
711,4,3,-1,879994513,879994555,42,403,215,3.662921348314607
711,3,3,0,879994555,879994608,53,215,157,3.5714285714285716
711,3,3,0,879994608,879994632,24,157,82,3.6741573033707864
711,3,4,1,879994632,879994633,1,82,1118,3.533333333333333
711,4,4,0,879994633,879994656,23,1118,731,3.4
711,4,4,0,879994656,879994749,93,731,417,3.0588235294117645
711,4,4,0,879994749,879994777,28,417,387,3.5357142857142856
711,4,4,0,879994777,879994778,1,387,393,3.5125
711,4,4,0,879994778,879994801,23,393,66,3.4705882352941178
711,4,5,1,879994801,879994825,24,66,660,3.71875
711,5,5,0,879994825,879994875,50,660,162,3.4651162790697674
711,5,3,-2,879994875,879995053,178,162,230,3.3518518518518516
711,3,3,0,879995053,879995077,24,230,720,3.2
711,3,2,-1,879995077,879995146,69,720,167,2.8181818181818183
711,2,3,1,879995146,879995215,69,167,416,3.3846153846153846
711,3,3,0,879995215,879995238,23,416,1285,3.1
711,3,2,-1,879995238,879995259,21,1285,566,3.543859649122807
711,2,5,3,879995259,879995302,43,566,420,3.5652173913043477
711,5,5,0,879995302,879995322,20,420,959,3.4583333333333335
711,5,3,-2,879995322,879995362,40,959,281,3.2
711,3,4,1,879995362,879995382,20,281,155,3.0588235294117645
711,4,3,-1,879995382,879995405,23,155,401,2.6774193548387095
711,3,5,2,879995405,879995461,56,401,724,3.64
711,5,4,-1,879995461,879995753,292,724,1168,3.4166666666666665
711,4,1,-3,879995753,879995754,1,1168,542,2.888888888888889
711,1,2,1,879995754,879995792,38,542,219,2.735294117647059
711,2,3,1,879995792,879995850,58,219,365,2.95
711,3,4,1,879995850,883589726,3593876,365,1117,3.0
711,4,5,1,883589726,883589763,37,1117,312,3.0
711,5,4,-1,883589763,884485683,895920,312,345,3.4782608695652173
711,4,5,1,884485683,884485704,21,345,1160,4.1
711,5,5,0,884485704,884485798,94,1160,272,4.2
711,5,3,-2,884485798,886030579,1544781,272,1190,3.4285714285714284
711,3,5,2,886030579,886030732,153,1190,248,3.746268656716418
711,5,5,0,886030732,886031006,274,248,16,3.411764705882353
711,5,3,-2,886031006,889910865,3879859,16,354,3.6923076923076925
711,3,4,1,889910865,889911007,142,354,909,4.0
710,3,3,0,882063224,882063254,30,310,874,3.230769230769231
710,3,4,1,882063254,882063276,22,874,268,3.9838709677419355
710,4,3,-1,882063276,882063327,51,268,343,3.0
710,3,4,1,882063327,882063367,40,343,340,3.7419354838709675
710,4,3,-1,882063367,882063528,161,340,886,2.857142857142857
710,3,2,-1,882063528,882063564,36,886,264,2.65
710,2,3,1,882063564,882063612,48,264,299,3.0
710,3,5,2,882063612,882063648,36,299,134,4.174603174603175
710,5,4,-1,882063648,882063649,1,134,357,4.063291139240507
710,4,3,-1,882063649,882063685,36,357,418,3.825
710,3,4,1,882063685,882063710,25,418,318,4.5046728971962615
710,4,4,0,882063710,882063736,26,318,89,3.9615384615384617
710,4,4,0,882063736,882063766,30,89,223,4.108695652173913
710,4,3,-1,882063766,882063793,27,223,202,3.730337078651685
710,3,4,1,882063793,882063824,31,202,204,3.6744186046511627
710,4,4,0,882063824,882063852,28,204,116,3.6666666666666665
710,4,4,0,882063852,882063920,68,116,100,4.0162162162162165
710,4,5,1,882063920,882063921,1,100,192,4.090909090909091
710,5,4,-1,882063921,882063967,46,192,277,3.6
710,4,5,1,882063967,882064021,54,277,56,4.051724137931035
710,5,5,0,882064021,882064120,99,56,479,4.25
710,5,3,-2,882064120,882064160,40,479,181,3.98974358974359
710,3,4,1,882064160,882064200,40,181,197,4.112676056338028
710,4,4,0,882064200,882064283,83,197,210,3.921259842519685
710,4,4,0,882064283,882064321,38,210,234,3.7674418604651163
710,4,4,0,882064321,882064377,56,234,1,3.902439024390244
710,4,3,-1,882064377,882064435,58,1,501,3.289473684210526
710,3,4,1,882064435,882064524,89,501,156,4.017857142857143
710,4,4,0,882064524,882064555,31,156,1019,3.7777777777777777
710,4,4,0,882064555,882860832,796277,1019,313,4.323076923076923
710,4,4,0,882860832,883705436,844604,313,1101,3.793103448275862
710,4,4,0,883705436,883705502,66,1101,346,3.5128205128205128
712,5,4,-1,874729750,874729778,28,731,623,3.0454545454545454
712,4,5,1,874729778,874729816,38,623,97,3.7282608695652173
712,5,4,-1,874729816,874729850,34,97,79,3.956989247311828
712,4,5,1,874729850,874729901,51,79,172,4.225225225225225
712,5,2,-3,874729901,874729935,34,172,234,3.7674418604651163
712,2,3,1,874729935,874729960,25,234,423,3.7016129032258065
712,3,4,1,874729960,874729995,35,423,99,3.8392857142857144
712,4,4,0,874729995,874729996,1,99,812,3.375
712,4,3,-1,874729996,874730031,35,812,61,4.190476190476191
712,3,4,1,874730031,874730056,25,61,432,3.719298245614035
712,4,3,-1,874730056,874730085,29,432,195,3.9072164948453607
712,3,4,1,874730085,874730155,70,195,1055,3.125
712,4,5,1,874730155,874730206,51,1055,785,3.4375
712,5,4,-1,874730206,874730234,28,785,585,2.5384615384615383
712,4,4,0,874730234,874730235,1,585,1503,3.25
712,4,3,-1,874730235,874730261,26,1503,228,3.7246376811594204
712,3,3,0,874730261,874730320,59,228,141,3.4827586206896552
712,3,5,2,874730320,874730370,50,141,732,3.6266666666666665
712,5,4,-1,874730370,874730396,26,732,196,3.9404761904761907
712,4,2,-2,874730396,874730420,24,196,59,4.0
712,2,1,-1,874730420,874730443,23,59,136,3.764705882352941
712,1,3,2,874730443,874730467,24,136,230,3.3518518518518516
712,3,4,1,874730467,874730490,23,230,1053,3.3846153846153846
712,4,3,-1,874730490,874730520,30,1053,506,3.566666666666667
712,3,3,0,874730520,874730552,32,506,747,3.5526315789473686
712,3,4,1,874730552,874730553,1,747,38,2.784313725490196
712,4,4,0,874730553,874956244,225691,38,762,3.3962264150943398
712,4,2,-2,874956244,874956357,113,762,168,4.0476190476190474
712,2,4,2,874956357,874956384,27,168,728,3.05
712,4,3,-1,874956384,874956516,132,728,625,3.25
712,3,4,1,874956516,874956543,27,625,542,2.888888888888889
712,4,5,1,874956543,874956560,17,542,768,3.238095238095238
712,5,5,0,874956560,874956586,26,768,699,3.736842105263158
712,5,4,-1,874956586,874956641,55,699,1221,3.4285714285714284
712,4,5,1,874956641,874956713,72,1221,366,3.4285714285714284
712,5,3,-2,874956713,874956788,75,366,1043,3.2
712,3,4,1,874956788,874956810,22,1043,204,3.6744186046511627
712,4,4,0,874956810,874956841,31,204,738,3.0
712,4,3,-1,874956841,874956872,31,738,49,3.3
712,3,3,0,874956872,874956903,31,49,433,3.8035714285714284
712,3,4,1,874956903,874956931,28,433,790,2.8518518518518516
712,4,3,-1,874956931,874956981,50,790,783,2.388888888888889
712,3,4,1,874956981,874957005,24,783,94,2.8823529411764706
712,4,3,-1,874957005,874957027,22,94,401,2.6774193548387095
712,3,3,0,874957027,874957053,26,401,388,2.5833333333333335
712,3,3,0,874957053,874957140,87,388,501,3.289473684210526
712,3,4,1,874957140,874957161,21,501,415,2.6666666666666665
712,4,3,-1,874957161,874957179,18,415,400,2.375
712,3,4,1,874957179,874957207,28,400,78,2.3636363636363638
712,4,4,0,874957207,874957243,36,78,794,3.6
712,4,4,0,874957243,874957268,25,794,796,2.923076923076923
712,4,4,0,874957268,874957269,1,796,1119,3.5185185185185186
712,4,3,-1,874957269,874957293,24,1119,51,3.5277777777777777
712,3,3,0,874957293,876251407,1294114,51,652,3.9642857142857144
715,5,4,-1,875961843,875961898,55,1,150,3.803921568627451
715,4,4,0,875961898,875961919,21,150,249,3.3275862068965516
715,4,5,1,875961919,875961998,79,249,50,4.306532663316583
715,5,1,-4,875961998,875962049,51,50,252,2.911392405063291
715,1,4,3,875962049,875962076,27,252,298,3.779220779220779
715,4,3,-1,875962076,875962109,33,298,455,3.1702127659574466
715,3,3,0,875962109,875962173,64,455,111,3.5106382978723403
715,3,4,1,875962173,875962202,29,111,471,3.5714285714285716
715,4,4,0,875962202,875962227,25,471,410,3.0434782608695654
715,4,4,0,875962227,875962280,53,410,248,3.746268656716418
715,4,4,0,875962280,875962315,35,248,108,3.107142857142857
715,4,3,-1,875962315,875962374,59,108,405,3.25
715,3,2,-1,875962374,875962395,21,405,118,3.2764227642276422
715,2,3,1,875962395,875962423,28,118,282,3.610526315789474
715,3,3,0,875962423,875962454,31,282,276,3.6036036036036037
715,3,3,0,875962454,875962500,46,276,1047,2.6923076923076925
715,3,4,1,875962500,875962524,24,1047,121,3.521212121212121
715,4,2,-2,875962524,875962652,128,121,826,2.5555555555555554
715,2,4,2,875962652,875962718,66,826,122,2.282608695652174
715,4,1,-3,875962718,875962762,44,122,1215,2.0714285714285716
715,1,2,1,875962762,875962783,21,1215,412,2.272727272727273
715,2,2,0,875962783,875962806,23,412,250,3.4698795180722892
715,2,5,3,875962806,875962931,125,250,202,3.730337078651685
715,5,3,-2,875962931,875962964,33,202,175,3.8354430379746836
715,3,5,2,875962964,875962991,27,175,144,3.9545454545454546
715,5,4,-1,875962991,875963024,33,144,157,3.5714285714285716
715,4,2,-2,875963024,875963082,58,157,433,3.8035714285714284
715,2,5,3,875963082,875963242,160,433,64,4.373737373737374
715,5,3,-2,875963242,875963273,31,64,231,2.938775510204082
715,3,4,1,875963273,875963306,33,231,11,3.8904109589041096
715,4,4,0,875963306,875963353,47,11,789,3.7777777777777777
715,4,3,-1,875963353,875963354,1,789,71,3.6575342465753424
715,3,5,2,875963354,875963387,33,71,56,4.051724137931035
715,5,2,-3,875963387,875963418,31,56,399,3.317073170731707
715,2,4,2,875963418,875963452,34,399,172,4.225225225225225
715,4,4,0,875963452,875963538,86,172,96,3.9130434782608696
715,4,2,-2,875963538,875963566,28,96,697,2.7777777777777777
715,2,4,2,875963566,875963596,30,697,955,3.2666666666666666
715,4,4,0,875963596,875963621,25,955,95,3.8194444444444446
715,4,4,0,875963621,875963657,36,95,168,4.0476190476190474
715,4,4,0,875963657,875963692,35,168,69,3.8015873015873014
715,4,4,0,875963692,875963693,1,69,658,3.393939393939394
715,4,2,-2,875963693,875963755,62,658,944,2.75
715,2,5,3,875963755,875963792,37,944,98,4.240875912408759
715,5,4,-1,875963792,875963867,75,98,239,3.423076923076923
715,4,2,-2,875963867,875963921,54,239,629,3.3333333333333335
715,2,3,1,875963921,875963946,25,629,143,3.56
715,3,4,1,875963946,875964025,79,143,82,3.6741573033707864
715,4,3,-1,875964025,875964051,26,82,27,3.235294117647059
715,3,2,-1,875964051,875964072,21,27,941,3.5
715,2,5,3,875964072,875964104,32,941,426,3.1
715,5,3,-2,875964104,875964105,1,426,70,3.5833333333333335
715,3,4,1,875964105,875964131,26,70,58,3.543859649122807
715,4,3,-1,875964131,875964179,48,58,732,3.6266666666666665
715,3,4,1,875964179,875964224,45,732,735,3.58
715,4,3,-1,875964224,875964272,48,735,227,3.169811320754717
715,3,3,0,875964272,875964273,1,227,39,3.107142857142857
715,3,3,0,875964273,875964330,57,39,97,3.7282608695652173
715,3,5,2,875964330,875964386,56,97,90,3.0
715,5,4,-1,875964386,875964438,52,90,156,4.017857142857143
715,4,2,-2,875964438,875964468,30,156,576,3.125
715,2,3,1,875964468,875964491,23,576,183,3.951219512195122
715,3,3,0,875964491,875964519,28,183,549,3.4871794871794872
715,3,4,1,875964519,875964545,26,549,939,3.6333333333333333
715,4,5,1,875964545,875964579,34,939,79,3.956989247311828
715,5,4,-1,875964579,875964580,1,79,155,3.0588235294117645
715,4,3,-1,875964580,875964614,34,155,627,3.3823529411764706
715,3,3,0,875964614,875964633,19,627,88,3.433734939759036
715,3,2,-1,875964633,875964681,48,88,739,3.391304347826087
715,2,2,0,875964681,875964704,23,739,755,3.085714285714286
715,2,3,1,875964704,875964751,47,755,33,3.2941176470588234
715,3,2,-1,875964751,875964843,92,33,1188,2.45
715,2,4,2,875964843,875964905,62,1188,232,3.0789473684210527
715,4,3,-1,875964905,875964926,21,232,2,3.0851063829787235
715,3,3,0,875964926,875965009,83,2,761,3.0588235294117645
715,3,3,0,875965009,875965058,49,761,380,3.4878048780487805
715,3,5,2,875965058,875965127,69,380,193,3.883720930232558
713,4,3,-1,888881988,888882133,145,315,1434,2.5
713,3,3,0,888882133,888882179,46,1434,342,2.64
713,3,3,0,888882179,888882224,45,342,1176,4.0
713,3,3,0,888882224,888882225,1,1176,1127,3.0
713,3,3,0,888882225,888882311,86,1127,307,3.6031746031746033
713,3,4,1,888882311,888882337,26,307,347,3.59375
716,3,5,2,879792665,879793192,527,340,1,3.902439024390244
716,5,4,-1,879793192,879793221,29,1,181,3.98974358974359
716,4,4,0,879793221,879793293,72,181,248,3.746268656716418
716,4,3,-1,879793293,879793376,83,248,628,3.573529411764706
716,3,3,0,879793376,879793501,125,628,282,3.610526315789474
716,3,4,1,879793501,879793542,41,282,117,3.689189189189189
716,4,5,1,879793542,879793631,89,117,274,3.5609756097560976
716,5,4,-1,879793631,879793653,22,274,294,3.1052631578947367
716,4,4,0,879793653,879793714,61,294,740,3.423076923076923
716,4,4,0,879793714,879793737,23,740,25,3.3185840707964602
716,4,2,-2,879793737,879793763,26,25,118,3.2764227642276422
716,2,4,2,879793763,879793844,81,118,405,3.25
716,4,1,-3,879793844,879794094,250,405,546,2.9789473684210526
716,1,3,2,879794094,879794116,22,546,284,3.1547619047619047
716,3,2,-1,879794116,879794154,38,284,235,3.106382978723404
716,2,3,1,879794154,879794200,46,235,1047,2.6923076923076925
716,3,2,-1,879794200,879794290,90,1047,108,3.107142857142857
716,2,2,0,879794290,879794410,120,108,826,2.5555555555555554
716,2,3,1,879794410,879794428,18,826,823,2.75
716,3,2,-1,879794428,879794727,299,823,122,2.282608695652174
716,2,5,3,879794727,879794775,48,122,603,4.315789473684211
716,5,3,-2,879794775,879794815,40,603,525,4.0
716,3,5,2,879794815,879794892,77,525,705,3.7857142857142856
716,5,5,0,879794892,879794934,42,705,487,4.043478260869565
716,5,2,-3,879794934,879794935,1,487,177,3.875
716,2,3,1,879794935,879794962,27,177,662,3.4583333333333335
716,3,4,1,879794962,879794996,34,662,97,3.7282608695652173
716,4,4,0,879794996,879795025,29,97,481,3.8421052631578947
716,4,5,1,879795025,879795121,96,481,486,3.9565217391304346
716,5,5,0,879795121,879795122,1,486,498,4.290909090909091
716,5,4,-1,879795122,879795159,37,498,614,3.727272727272727
716,4,5,1,879795159,879795188,29,614,69,3.8015873015873014
716,5,5,0,879795188,879795239,51,69,133,3.7777777777777777
716,5,5,0,879795239,879795269,30,133,432,3.719298245614035
716,5,5,0,879795269,879795314,45,432,134,4.174603174603175
716,5,5,0,879795314,879795336,22,134,98,4.240875912408759
716,5,5,0,879795336,879795375,39,98,732,3.6266666666666665
716,5,3,-2,879795375,879795425,50,732,492,4.117647058823529
716,3,4,1,879795425,879795496,71,492,423,3.7016129032258065
716,4,4,0,879795496,879795542,46,423,172,4.225225225225225
716,4,3,-1,879795542,879795543,1,172,209,3.8275862068965516
716,3,5,2,879795543,879795576,33,209,194,4.029411764705882
716,5,4,-1,879795576,879795606,30,194,200,3.8157894736842106
716,4,4,0,879795606,879795643,37,200,23,3.9047619047619047
716,4,4,0,879795643,879795644,1,23,381,3.2758620689655173
716,4,4,0,879795644,879795735,91,381,478,4.161290322580645
716,4,5,1,879795735,879795762,27,478,357,4.063291139240507
716,5,5,0,879795762,879795790,28,357,483,4.475609756097561
716,5,5,0,879795790,879795813,23,483,527,3.823529411764706
716,5,5,0,879795813,879795906,93,527,213,3.943396226415094
716,5,3,-2,879795906,879796010,104,213,566,3.543859649122807
716,3,1,-2,879796010,879796011,1,566,385,3.6129032258064515
716,1,4,3,879796011,879796046,35,385,70,3.5833333333333335
716,4,4,0,879796046,879796096,50,70,199,4.191489361702128
716,4,5,1,879796096,879796214,118,199,606,4.294117647058823
716,5,3,-2,879796214,879796278,64,606,650,3.1363636363636362
716,3,5,2,879796278,879796279,1,650,425,3.7027027027027026
716,5,5,0,879796279,879796331,52,425,514,4.033333333333333
716,5,4,-1,879796331,879796381,50,514,505,4.0625
716,4,5,1,879796381,879796438,57,505,91,3.6
716,5,4,-1,879796438,879796475,37,91,81,3.2857142857142856
716,4,3,-1,879796475,879796555,80,81,519,4.291666666666667
716,3,5,2,879796555,879796596,41,519,196,3.9404761904761907
716,5,3,-2,879796596,879796651,55,196,161,3.5844155844155843
716,3,4,1,879796651,879796718,67,161,660,3.71875
716,4,3,-1,879796718,879796766,48,660,218,3.5555555555555554
716,3,2,-1,879796766,879796846,80,218,559,3.477272727272727
716,2,2,0,879796846,879796895,49,559,392,3.5555555555555554
716,2,3,1,879796895,879796914,19,392,157,3.5714285714285716
716,3,5,2,879796914,879796942,28,157,168,4.0476190476190474
716,5,4,-1,879796942,879796961,19,168,451,3.207792207792208
716,4,3,-1,879796961,879797152,191,451,622,3.3333333333333335
716,3,3,0,879797152,879797177,25,622,227,3.169811320754717
716,3,3,0,879797177,879797198,21,227,230,3.3518518518518516
716,3,3,0,879797198,879797221,23,230,445,3.727272727272727
716,3,3,0,879797221,879797257,36,445,417,3.0588235294117645
716,3,4,1,879797257,879797286,29,417,49,3.3
716,4,3,-1,879797286,879797287,1,49,620,3.0
716,3,4,1,879797287,879797303,16,620,1050,3.6153846153846154
716,4,4,0,879797303,879797328,25,1050,173,4.1441441441441444
716,4,4,0,879797328,879797372,44,173,549,3.4871794871794872
716,4,4,0,879797372,879797391,19,549,387,3.5357142857142856
716,4,2,-2,879797391,879797504,113,387,965,3.7142857142857144
716,2,4,2,879797504,879797535,31,965,673,3.393939393939394
716,4,4,0,879797535,879797555,20,673,141,3.4827586206896552
681,5,4,-1,885409438,885409515,77,750,898,3.0869565217391304
681,4,3,-1,885409515,885409516,1,898,538,3.25
681,3,4,1,885409516,885409770,254,538,990,2.769230769230769
681,4,3,-1,885409770,885409810,40,990,328,3.4895833333333335
681,3,4,1,885409810,885409883,73,328,292,3.6666666666666665
681,4,5,1,885409883,885409938,55,292,294,3.1052631578947367
681,5,5,0,885409938,885410009,71,294,289,2.988888888888889
678,4,3,-1,879544397,879544449,52,111,15,3.725663716814159
678,3,4,1,879544449,879544450,1,15,50,4.306532663316583
678,4,5,1,879544450,879544782,332,50,127,4.162790697674419
678,5,4,-1,879544782,879544783,1,127,742,3.5555555555555554
678,4,3,-1,879544783,879544815,32,742,14,4.101694915254237
678,3,3,0,879544815,879544882,67,14,277,3.6
678,3,1,-2,879544882,879544915,33,277,1129,3.4444444444444446
678,1,4,3,879544915,879544952,37,1129,7,3.76056338028169
678,4,4,0,879544952,879544989,37,7,117,3.689189189189189
719,4,2,-2,877310932,877311109,177,185,294,3.1052631578947367
719,2,2,0,877311109,877311150,41,294,289,2.988888888888889
719,2,2,0,877311150,877311269,119,289,7,3.76056338028169
719,2,3,1,877311269,879358453,2047184,7,127,4.162790697674419
719,3,4,1,879358453,879358893,440,127,742,3.5555555555555554
719,4,4,0,879358893,879359034,141,742,620,3.0
719,4,5,1,879359034,879360466,1432,620,520,4.136363636363637
719,5,5,0,879360466,879360493,27,520,318,4.5046728971962615
719,5,4,-1,879360493,879360555,62,318,378,3.6904761904761907
719,4,4,0,879360555,879360583,28,378,357,4.063291139240507
719,4,4,0,879360583,879360617,34,357,655,3.7857142857142856
719,4,3,-1,879360617,879360845,228,655,97,3.7282608695652173
719,3,3,0,879360845,879360846,1,97,77,3.3857142857142857
719,3,2,-1,879360846,879360933,87,77,509,3.7058823529411766
719,2,3,1,879360933,879360965,32,509,673,3.393939393939394
719,3,4,1,879360965,879361003,38,673,162,3.4651162790697674
719,4,3,-1,879361003,879361023,20,162,468,3.380952380952381
719,3,1,-2,879361023,883354126,3993103,468,410,3.0434782608695654
719,1,3,2,883354126,884900301,1546175,410,291,3.2
719,3,3,0,884900301,888449274,3548973,291,274,3.5609756097560976
719,3,3,0,888449274,888449606,332,274,532,2.7777777777777777
719,3,3,0,888449606,888454637,5031,532,88,3.433734939759036
719,3,5,2,888454637,888454728,91,88,220,3.433333333333333
702,2,1,-1,885767336,885767392,56,307,690,3.260869565217391
702,1,2,1,885767392,885767414,22,690,1127,3.0
702,2,1,-1,885767414,885767435,21,1127,352,1.8333333333333333
702,1,3,2,885767435,885767461,26,352,300,3.6861313868613137
702,3,1,-2,885767461,885767534,73,300,895,3.142857142857143
702,1,1,0,885767534,885767555,21,895,294,3.1052631578947367
702,1,2,1,885767555,885767556,1,294,748,3.1043478260869564
702,2,1,-1,885767556,885767576,20,748,683,2.176470588235294
702,1,2,1,885767576,885767604,28,683,289,2.988888888888889
702,2,4,2,885767604,885767774,170,289,380,3.4878048780487805
702,4,4,0,885767774,885767775,1,380,227,3.169811320754717
721,4,5,1,877136236,877136303,67,326,328,3.4895833333333335
721,5,4,-1,877136303,877136358,55,328,301,3.2465753424657535
721,4,4,0,877136358,877136891,533,301,322,3.0476190476190474
721,4,3,-1,877136891,877136967,76,322,748,3.1043478260869564
721,3,1,-2,877136967,877137109,142,748,948,2.2962962962962963
721,1,5,4,877137109,877137213,104,948,990,2.769230769230769
721,5,3,-2,877137213,877137214,1,990,1295,3.0
721,3,3,0,877137214,877137285,71,1295,304,3.5306122448979593
721,3,3,0,877137285,877137358,73,304,687,2.1481481481481484
721,3,3,0,877137358,877137447,89,687,995,3.0
721,3,3,0,877137447,877137448,1,995,680,2.8333333333333335
721,3,3,0,877137448,877137527,79,680,989,3.142857142857143
721,3,5,2,877137527,877138024,497,989,194,4.029411764705882
721,5,5,0,877138024,877138200,176,194,393,3.5125
721,5,5,0,877138200,877138395,195,393,720,3.2
721,5,5,0,877138395,877138584,189,720,222,3.578125
721,5,5,0,877138584,877138585,1,222,229,3.185185185185185
721,5,5,0,877138585,877138745,160,229,173,4.1441441441441444
721,5,5,0,877138745,877138816,71,173,161,3.5844155844155843
721,5,5,0,877138816,877138951,135,161,181,3.98974358974359
721,5,5,0,877138951,877139015,64,181,174,4.253521126760563
721,5,2,-3,877139015,877139301,286,174,81,3.2857142857142856
721,2,4,2,877139301,877139384,83,81,435,3.8933333333333335
721,4,4,0,877139384,877139551,167,435,739,3.391304347826087
721,4,3,-1,877139551,877139637,86,739,1221,3.4285714285714284
721,3,4,1,877139637,877139638,1,1221,403,3.298507462686567
721,4,4,0,877139638,877139773,135,403,755,3.085714285714286
721,4,4,0,877139773,877140047,274,755,318,4.5046728971962615
721,4,5,1,877140047,877140137,90,318,28,3.923076923076923
721,5,4,-1,877140137,877140282,145,28,69,3.8015873015873014
721,4,5,1,877140282,877140409,127,69,127,4.162790697674419
721,5,2,-3,877140409,877140490,81,127,655,3.7857142857142856
721,2,4,2,877140490,877140632,142,655,15,3.725663716814159
721,4,4,0,877140632,877140780,148,15,107,3.45
721,4,3,-1,877140780,877140859,79,107,87,3.9
721,3,4,1,877140859,877141038,179,87,51,3.5277777777777777
721,4,4,0,877141038,877141039,1,51,735,3.58
721,4,3,-1,877141039,877141222,183,735,729,3.3793103448275863
721,3,4,1,877141222,877141373,151,729,215,3.662921348314607
721,4,3,-1,877141373,877145403,4030,215,70,3.5833333333333335
721,3,4,1,877145403,877147079,1676,70,732,3.6266666666666665
721,4,3,-1,877147079,877147080,1,732,125,3.5555555555555554
721,3,4,1,877147080,877147140,60,125,942,3.4545454545454546
721,4,5,1,877147140,877147260,120,942,631,3.581818181818182
721,5,5,0,877147260,877147383,123,631,1065,3.1578947368421053
721,5,2,-3,877147383,877147503,120,1065,162,3.4651162790697674
721,2,5,3,877147503,877147616,113,162,660,3.71875
721,5,4,-1,877147616,877147675,59,660,632,3.9523809523809526
721,4,2,-2,877147675,877147726,51,632,715,3.257142857142857
721,2,4,2,877147726,877147795,69,715,1119,3.5185185185185186
721,4,4,0,877147795,877147872,77,1119,317,3.774193548387097
714,3,2,-1,892776410,892777140,730,257,255,3.2027027027027026
714,2,3,1,892777140,892777197,57,255,15,3.725663716814159
714,3,2,-1,892777197,892777242,45,15,276,3.6036036036036037
714,2,3,1,892777242,892777438,196,276,284,3.1547619047619047
714,3,3,0,892777438,892777533,95,284,597,3.2771084337349397
714,3,3,0,892777533,892777581,48,597,369,2.5714285714285716
714,3,3,0,892777581,892777619,38,369,252,2.911392405063291
714,3,3,0,892777619,892777694,75,252,1014,3.1
714,3,2,-1,892777694,892777730,36,1014,472,2.984375
714,2,3,1,892777730,892777812,82,472,151,3.6544117647058822
714,3,5,2,892777812,892777876,64,151,50,4.306532663316583
714,5,5,0,892777876,892777877,1,50,118,3.2764227642276422
714,5,4,-1,892777877,892777903,26,118,282,3.610526315789474
714,4,5,1,892777903,892778035,132,282,300,3.6861313868613137
714,5,3,-2,892778035,892778092,57,300,289,2.988888888888889
717,3,4,1,884641621,884641644,23,326,303,3.75
717,4,3,-1,884641644,884641681,37,303,327,3.5076923076923077
717,3,1,-2,884641681,884641717,36,327,288,3.5214285714285714
717,1,4,3,884641717,884641743,26,288,299,3.0
717,4,5,1,884641743,884641808,65,299,300,3.6861313868613137
717,5,3,-2,884641808,884641842,34,300,324,3.2291666666666665
717,3,1,-2,884641842,884641911,69,324,260,2.4716981132075473
717,1,1,0,884641911,884642001,90,260,890,1.7692307692307692
717,1,5,4,884642001,884642132,131,890,995,3.0
717,5,5,0,884642132,884642133,1,995,322,3.0476190476190474
717,5,4,-1,884642133,884642160,27,322,7,3.76056338028169
717,4,5,1,884642160,884642214,54,7,285,4.181818181818182
717,5,4,-1,884642214,884642215,1,285,222,3.578125
717,4,4,0,884642215,884642268,53,222,100,4.0162162162162165
717,4,2,-2,884642268,884642297,29,100,24,3.3728813559322033
717,2,4,2,884642297,884642339,42,24,846,3.1052631578947367
717,4,5,1,884642339,884642427,88,846,742,3.5555555555555554
717,5,2,-3,884642427,884642479,52,742,455,3.1702127659574466
717,2,2,0,884642479,884642558,79,455,825,2.914285714285714
717,2,5,3,884642558,884642580,22,825,1137,4.25
717,5,4,-1,884642580,884642581,1,1137,685,3.2666666666666666
717,4,3,-1,884642581,884642738,157,685,290,3.108108108108108
717,3,4,1,884642738,884642762,24,290,235,3.106382978723404
717,4,5,1,884642762,884642817,55,235,282,3.610526315789474
717,5,2,-3,884642817,884642843,26,282,975,3.411764705882353
717,2,2,0,884642843,884642868,25,975,826,2.5555555555555554
717,2,3,1,884642868,884642958,90,826,831,2.6097560975609757
717,3,5,2,884642958,884644605,1647,831,628,3.573529411764706
717,5,4,-1,884644605,884715122,70517,628,50,4.306532663316583
717,4,1,-3,884715122,884715146,24,50,250,3.4698795180722892
717,1,3,2,884715146,884715172,26,250,298,3.779220779220779
718,3,4,1,883348391,883348712,321,289,222,3.578125
718,4,4,0,883348712,883348773,61,222,255,3.2027027027027026
718,4,4,0,883348773,883348873,100,255,815,3.135135135135135
718,4,5,1,883348873,883348938,65,815,597,3.2771084337349397
718,5,5,0,883348938,883348962,24,597,15,3.725663716814159
718,5,4,-1,883348962,883349158,196,15,546,2.9789473684210526
718,4,4,0,883349158,883349191,33,546,591,3.7169811320754715
718,4,4,0,883349191,883349214,23,591,717,2.9696969696969697
718,4,2,-2,883349214,883349301,87,717,975,3.411764705882353
718,2,3,1,883349301,883349363,62,975,274,3.5609756097560976
718,3,3,0,883349363,883349442,79,274,1047,2.6923076923076925
718,3,1,-2,883349442,883349467,25,1047,240,3.0350877192982457
718,1,4,3,883349467,883349557,90,240,841,2.772727272727273
718,4,3,-1,883349557,883349598,41,841,1165,1.8
718,3,2,-1,883349598,883349642,44,1165,820,3.0444444444444443
718,2,3,1,883349642,883349663,21,820,831,2.6097560975609757
696,4,3,-1,886403631,886403672,41,1176,313,4.323076923076923
696,3,1,-2,886403672,886404268,596,313,748,3.1043478260869564
696,1,4,3,886404268,886404322,54,748,312,3.0
696,4,5,1,886404322,886404617,295,312,124,4.052631578947368
722,4,4,0,891280046,891280245,199,286,307,3.6031746031746033
722,4,5,1,891280245,891280272,27,307,328,3.4895833333333335
722,5,3,-2,891280272,891280443,171,328,678,2.8181818181818183
722,3,3,0,891280443,891280866,423,678,546,2.9789473684210526
722,3,4,1,891280866,891280894,28,546,628,3.573529411764706
722,4,3,-1,891280894,891280918,24,628,405,3.25
722,3,4,1,891280918,891280955,37,405,458,3.0588235294117645
722,4,4,0,891280955,891280988,33,458,237,3.7315436241610738
722,4,4,0,891280988,891281020,32,237,508,3.6923076923076925
722,4,3,-1,891281020,891281077,57,508,111,3.5106382978723403
722,3,4,1,891281077,891281108,31,111,866,3.3962264150943398
722,4,4,0,891281108,891281132,24,866,117,3.689189189189189
722,4,3,-1,891281132,891281158,26,117,147,3.3142857142857145
722,3,5,2,891281158,891281182,24,147,121,3.521212121212121
722,5,4,-1,891281182,891281349,167,121,118,3.2764227642276422
722,4,3,-1,891281349,891281369,20,118,756,2.6885245901639343
722,3,4,1,891281369,891281635,266,756,476,3.1216216216216215
722,4,2,-2,891281635,891281679,44,476,412,2.272727272727273
722,2,3,1,891281679,891281710,31,412,597,3.2771084337349397
722,3,2,-1,891281710,891281876,166,597,871,2.3823529411764706
724,5,1,-4,883757170,883757259,89,310,343,3.0
724,1,4,3,883757259,883757397,138,343,268,3.9838709677419355
724,4,4,0,883757397,883757597,200,268,288,3.5214285714285714
724,4,4,0,883757597,883757670,73,288,749,3.2777777777777777
724,4,1,-3,883757670,883757703,33,749,682,3.0476190476190474
724,1,3,2,883757703,883757784,81,682,873,2.7586206896551726
724,3,1,-2,883757784,883757834,50,873,877,2.619047619047619
724,1,2,1,883757834,883757874,40,877,245,3.056179775280899
724,2,1,-1,883757874,883758241,367,245,361,2.0
724,1,3,2,883758241,883758267,26,361,1127,3.0
724,3,1,-2,883758267,883758268,1,1127,286,3.442857142857143
727,4,3,-1,883708119,883708208,89,748,751,3.3896103896103895
727,3,3,0,883708208,883708229,21,751,678,2.8181818181818183
727,3,4,1,883708229,883708265,36,678,259,2.492063492063492
727,4,3,-1,883708265,883708462,197,259,680,2.8333333333333335
727,3,1,-2,883708462,883708478,16,680,890,1.7692307692307692
727,1,2,1,883708478,883708523,45,890,539,2.6666666666666665
727,2,3,1,883708523,883708660,137,539,117,3.689189189189189
727,3,3,0,883708660,883708750,90,117,181,3.98974358974359
727,3,2,-1,883708750,883708830,80,181,100,4.0162162162162165
727,2,4,2,883708830,883708895,65,100,408,4.4772727272727275
727,4,2,-2,883708895,883708927,32,408,7,3.76056338028169
727,2,1,-1,883708927,883709009,82,7,933,2.5
727,1,4,3,883709009,883709157,148,933,282,3.610526315789474
727,4,3,-1,883709157,883709188,31,282,815,3.135135135135135
727,3,5,2,883709188,883709207,19,815,248,3.746268656716418
727,5,3,-2,883709207,883709208,1,248,841,2.772727272727273
727,3,5,2,883709208,883709242,34,841,250,3.4698795180722892
727,5,3,-2,883709242,883709266,24,250,111,3.5106382978723403
727,3,2,-1,883709266,883709325,59,111,278,3.0357142857142856
727,2,3,1,883709325,883709350,25,278,222,3.578125
727,3,2,-1,883709350,883709374,24,222,472,2.984375
727,2,3,1,883709374,883709402,28,472,147,3.3142857142857145
727,3,2,-1,883709402,883709438,36,147,252,2.911392405063291
727,2,4,2,883709438,883709518,80,252,121,3.521212121212121
727,4,2,-2,883709518,883709539,21,121,820,3.0444444444444443
727,2,3,1,883709539,883709571,32,820,405,3.25
727,3,2,-1,883709571,883709607,36,405,546,2.9789473684210526
727,2,3,1,883709607,883709671,64,546,455,3.1702127659574466
727,3,2,-1,883709671,883709710,39,455,413,2.5652173913043477
727,2,1,-1,883709710,883709711,1,413,1049,2.5714285714285716
727,1,4,3,883709711,883709729,18,1049,118,3.2764227642276422
727,4,2,-2,883709729,883709750,21,118,1047,2.6923076923076925
727,2,2,0,883709750,883709802,52,1047,122,2.282608695652174
727,2,3,1,883709802,883709839,37,122,831,2.6097560975609757
727,3,2,-1,883709839,883709884,45,831,1088,2.4
727,2,3,1,883709884,883709905,21,1088,411,2.911764705882353
727,3,2,-1,883709905,883709948,43,411,369,2.5714285714285716
727,2,3,1,883709948,883710104,156,369,651,3.8627450980392157
727,3,4,1,883710104,883710152,48,651,98,4.240875912408759
727,4,4,0,883710152,883710186,34,98,174,4.253521126760563
727,4,2,-2,883710186,883710236,50,174,419,3.8208955223880596
727,2,3,1,883710236,883710271,35,419,197,4.112676056338028
727,3,4,1,883710271,883710288,17,197,199,4.191489361702128
727,4,4,0,883710288,883710326,38,199,265,3.710144927536232
727,4,4,0,883710326,883710347,21,265,87,3.9
727,4,4,0,883710347,883710375,28,87,195,3.9072164948453607
727,4,4,0,883710375,883710395,20,195,144,3.9545454545454546
727,4,4,0,883710395,883710396,1,144,91,3.6
727,4,5,1,883710396,883710419,23,91,169,4.548387096774194
727,5,5,0,883710419,883710437,18,169,173,4.1441441441441444
727,5,4,-1,883710437,883710464,27,173,211,3.958904109589041
727,4,4,0,883710464,883710495,31,211,588,3.8358208955223883
727,4,4,0,883710495,883710717,222,588,510,3.823529411764706
727,4,2,-2,883710717,883710806,89,510,92,3.7142857142857144
727,2,3,1,883710806,883710830,24,92,423,3.7016129032258065
727,3,5,2,883710830,883710889,59,423,83,4.204081632653061
727,5,2,-3,883710889,883710910,21,83,238,3.888888888888889
727,2,2,0,883710910,883710948,38,238,507,3.6285714285714286
727,2,4,2,883710948,883710974,26,507,227,3.169811320754717
727,4,1,-3,883710974,883711011,37,227,17,3.032258064516129
727,1,3,2,883711011,883711045,34,17,54,3.3714285714285714
727,3,3,0,883711045,883711069,24,54,71,3.6575342465753424
727,3,4,1,883711069,883711113,44,71,526,3.909090909090909
727,4,3,-1,883711113,883711150,37,526,627,3.3823529411764706
727,3,5,2,883711150,883711181,31,627,421,3.462962962962963
727,5,4,-1,883711181,883711240,59,421,692,3.56
727,4,2,-2,883711240,883711298,58,692,432,3.719298245614035
727,2,4,2,883711298,883711354,56,432,202,3.730337078651685
727,4,5,1,883711354,883711394,40,202,88,3.433734939759036
727,5,3,-2,883711394,883711449,55,88,566,3.543859649122807
727,3,3,0,883711449,883711476,27,566,568,3.5853658536585367
727,3,3,0,883711476,883711527,51,568,82,3.6741573033707864
727,3,4,1,883711527,883711550,23,82,163,3.53125
727,4,3,-1,883711550,883711567,17,163,154,3.6031746031746033
727,3,3,0,883711567,883711589,22,154,180,3.9473684210526314
727,3,3,0,883711589,883711616,27,180,636,3.4146341463414633
727,3,3,0,883711616,883711679,63,636,188,3.625
727,3,2,-1,883711679,883711699,20,188,131,3.731707317073171
727,2,5,3,883711699,883711720,21,131,658,3.393939393939394
727,5,4,-1,883711720,883711735,15,658,739,3.391304347826087
727,4,2,-2,883711735,883711771,36,739,101,3.4827586206896552
727,2,4,2,883711771,883711847,76,101,392,3.5555555555555554
727,4,4,0,883711847,883711874,27,392,2,3.0851063829787235
727,4,3,-1,883711874,883711923,49,2,1119,3.5185185185185186
727,3,2,-1,883711923,883711924,1,1119,441,2.4
727,2,3,1,883711924,883711965,41,441,1217,3.4166666666666665
727,3,2,-1,883711965,883712037,72,1217,720,3.2
727,2,3,1,883712037,883712068,31,720,155,3.0588235294117645
727,3,3,0,883712068,883712123,55,155,1446,3.0
727,3,2,-1,883712123,883712159,36,1446,465,3.75
727,2,3,1,883712159,883712219,60,465,549,3.4871794871794872
727,3,2,-1,883712219,883712245,26,549,1035,3.03125
727,2,2,0,883712245,883712282,37,1035,559,3.477272727272727
727,2,5,3,883712282,883712315,33,559,679,3.2432432432432434
727,5,2,-3,883712315,883712343,28,679,65,3.511111111111111
727,2,3,1,883712343,883712365,22,65,356,3.2
727,3,3,0,883712365,883712397,32,356,393,3.5125
727,3,3,0,883712397,883712430,33,393,367,3.4242424242424243
727,3,3,0,883712430,883712476,46,367,219,2.735294117647059
727,3,4,1,883712476,883712519,43,219,550,3.272727272727273
727,4,3,-1,883712519,883712603,84,550,378,3.6904761904761907
727,3,2,-1,883712603,883712652,49,378,810,2.9473684210526314
727,2,5,3,883712652,883712681,29,810,451,3.207792207792208
727,5,4,-1,883712681,883712716,35,451,161,3.5844155844155843
727,4,3,-1,883712716,883712717,1,161,399,3.317073170731707
727,3,4,1,883712717,883712751,34,399,541,2.9473684210526314
727,4,2,-2,883712751,883712780,29,541,39,3.107142857142857
727,2,2,0,883712780,883712804,24,39,384,2.7941176470588234
727,2,2,0,883712804,883712805,1,384,379,3.35
727,2,2,0,883712805,883712828,23,379,755,3.085714285714286
727,2,3,1,883712828,883712913,85,755,217,3.1538461538461537
727,3,1,-2,883712913,883712993,80,217,38,2.784313725490196
727,1,4,3,883712993,883713048,55,38,73,3.588235294117647
727,4,2,-2,883713048,883713194,146,73,801,2.2
727,2,2,0,883713194,883713257,63,801,585,2.5384615384615383
727,2,2,0,883713257,883713286,29,585,569,2.4285714285714284
727,2,2,0,883713286,883713388,102,569,567,3.272727272727273
727,2,2,0,883713388,883713419,31,567,167,2.8181818181818183
727,2,4,2,883713419,883713454,35,167,80,2.967741935483871
727,4,2,-2,883713454,883713473,19,80,1229,2.4
727,2,2,0,883713473,883713548,75,1229,562,3.2941176470588234
727,2,1,-1,883713548,883713574,26,562,1222,2.6363636363636362
727,1,4,3,883713574,883713632,58,1222,982,3.2
727,4,2,-2,883713632,883713668,36,982,158,2.7027027027027026
727,2,2,0,883713668,883713714,46,158,398,2.1
727,2,2,0,883713714,883713737,23,398,1303,2.857142857142857
727,2,2,0,883713737,883713738,1,1303,826,2.5555555555555554
727,2,1,-1,883713738,883713760,22,826,1250,1.6
725,3,4,1,876103725,876103793,68,288,245,3.056179775280899
725,4,1,-3,876103793,876103811,18,245,264,2.65
725,1,4,3,876103811,876106243,2432,264,9,3.8878504672897196
706,4,3,-1,880997001,880997105,104,258,9,3.8878504672897196
706,3,4,1,880997105,880997195,90,9,117,3.689189189189189
706,4,1,-3,880997195,880997211,16,117,100,4.0162162162162165
706,1,4,3,880997211,880997324,113,100,1,3.902439024390244
706,4,4,0,880997324,880997385,61,1,25,3.3185840707964602
706,4,4,0,880997385,880997444,59,25,410,3.0434782608695654
706,4,4,0,880997444,880997482,38,410,237,3.7315436241610738
720,4,4,0,891262669,891262697,28,268,304,3.5306122448979593
720,4,4,0,891262697,891262762,65,304,272,4.2
720,4,3,-1,891262762,891262780,18,272,872,3.0
720,3,5,2,891262780,891262812,32,872,1062,5.0
720,5,4,-1,891262812,891263387,575,1062,316,4.285714285714286
720,4,4,0,891263387,891263460,73,316,902,3.9444444444444446
729,1,3,2,893286168,893286204,36,346,310,3.6666666666666665
729,3,2,-1,893286204,893286261,57,310,288,3.5214285714285714
729,2,3,1,893286261,893286299,38,288,879,3.2291666666666665
729,3,3,0,893286299,893286338,39,879,751,3.3896103896103895
729,3,2,-1,893286338,893286511,173,751,683,2.176470588235294
729,2,4,2,893286511,893286638,127,683,300,3.6861313868613137
726,5,3,-2,889828701,889831166,2465,294,257,3.7154471544715446
726,3,3,0,889831166,889832358,1192,257,845,3.661290322580645
726,3,1,-2,889832358,889832422,64,845,249,3.3275862068965516
726,1,2,1,889832422,889832592,170,249,1028,2.857142857142857
726,2,3,1,889832592,889832688,96,1028,819,2.6666666666666665
726,3,1,-2,889832688,889832744,56,819,1014,3.1
726,1,5,4,889832744,889832806,62,1014,1059,2.764705882352941
728,3,3,0,879442612,879442685,73,319,323,3.0
728,3,3,0,879442685,879442761,76,323,289,2.988888888888889
728,3,4,1,879442761,879442794,33,289,304,3.5306122448979593
728,4,4,0,879442794,879443291,497,304,116,3.6666666666666665
728,4,4,0,879443291,879443387,96,116,15,3.725663716814159
728,4,4,0,879443387,879443446,59,15,285,4.181818181818182
703,4,3,-1,875242077,875242303,226,300,328,3.4895833333333335
703,3,1,-2,875242303,875242336,33,328,259,2.492063492063492
703,1,3,2,875242336,875242683,347,259,25,3.3185840707964602
703,3,4,1,875242683,875242704,21,25,222,3.578125
703,4,5,1,875242704,875242813,109,222,50,4.306532663316583
703,5,2,-3,875242813,875242814,1,50,9,3.8878504672897196
703,2,4,2,875242814,875242851,37,9,1,3.902439024390244
703,4,4,0,875242851,875242852,1,1,1012,3.2916666666666665
703,4,2,-2,875242852,875242885,33,1012,764,3.1176470588235294
703,2,2,0,875242885,875242912,27,764,864,3.2142857142857144
703,2,3,1,875242912,875242935,23,864,458,3.0588235294117645
703,3,3,0,875242935,875242964,29,458,276,3.6036036036036037
703,3,5,2,875242964,875242990,26,276,257,3.7154471544715446
703,5,4,-1,875242990,875243028,38,257,845,3.661290322580645
703,4,3,-1,875243028,875243049,21,845,147,3.3142857142857145
738,2,3,1,875348571,875348670,99,260,298,3.779220779220779
738,3,4,1,875348670,875348856,186,298,181,3.98974358974359
738,4,4,0,875348856,875349045,189,181,252,2.911392405063291
738,4,2,-2,875349045,875349111,66,252,254,2.7419354838709675
738,2,5,3,875349111,875349584,473,254,408,4.4772727272727275
738,5,4,-1,875349584,875349628,44,408,178,4.378378378378378
738,4,3,-1,875349628,875349713,85,178,22,4.215909090909091
738,3,4,1,875349713,875349775,62,22,474,4.172413793103448
738,4,4,0,875349775,875349807,32,474,919,4.0
738,4,4,0,875349807,875349850,43,919,234,3.7674418604651163
738,4,4,0,875349850,875349895,45,234,238,3.888888888888889
738,4,5,1,875349895,875350012,117,238,173,4.1441441441441444
738,5,4,-1,875350012,875350053,41,173,204,3.6744186046511627
738,4,4,0,875350053,875350122,69,204,97,3.7282608695652173
738,4,4,0,875350122,875350157,35,97,214,3.272727272727273
738,4,4,0,875350157,875350223,66,214,423,3.7016129032258065
738,4,4,0,875350223,875350265,42,423,152,3.6785714285714284
738,4,4,0,875350265,875350418,153,152,208,3.8125
738,4,3,-1,875350418,875350456,38,208,188,3.625
738,3,4,1,875350456,875350551,95,188,455,3.1702127659574466
738,4,4,0,875350551,875350720,169,455,161,3.5844155844155843
738,4,4,0,875350720,875350804,84,161,659,4.027777777777778
738,4,3,-1,875350804,875350913,109,659,755,3.085714285714286
738,3,3,0,875350913,875350944,31,755,636,3.4146341463414633
738,3,3,0,875350944,875350995,51,636,231,2.938775510204082
738,3,3,0,875350995,875351019,24,231,79,3.956989247311828
738,3,3,0,875351019,875351346,327,79,367,3.4242424242424243
738,3,4,1,875351346,875351404,58,367,189,3.88
738,4,3,-1,875351404,875351438,34,189,449,2.9069767441860463
738,3,4,1,875351438,875351462,24,449,91,3.6
738,4,4,0,875351462,875351486,24,91,4,3.5538461538461537
738,4,3,-1,875351486,875351530,44,4,380,3.4878048780487805
738,3,4,1,875351530,875351603,73,380,747,3.5526315789473686
738,4,3,-1,875351603,875351712,109,747,650,3.1363636363636362
738,3,4,1,875351712,875351773,61,650,186,3.905263157894737
738,4,3,-1,875351773,875351837,64,186,225,3.0714285714285716
738,3,4,1,875351837,875351872,35,225,434,3.588235294117647
738,4,4,0,875351872,875351873,1,434,128,3.45
738,4,3,-1,875351873,875351905,32,128,63,3.125
738,3,3,0,875351905,875351906,1,63,229,3.185185185185185
738,3,3,0,875351906,875351956,50,229,930,2.793103448275862
738,3,3,0,875351956,875352771,815,930,141,3.4827586206896552
738,3,4,1,875352771,875353678,907,141,109,3.282608695652174
738,4,4,0,875353678,875353780,102,109,121,3.521212121212121
738,4,3,-1,875353780,875353813,33,121,429,3.742857142857143
738,3,3,0,875353813,875353869,56,429,168,4.0476190476190474
738,3,5,2,875353869,892844111,17490242,168,135,3.7974683544303796
738,5,5,0,892844111,892844112,1,135,193,3.883720930232558
738,5,2,-3,892844112,892938254,94142,193,269,4.085106382978723
738,2,3,1,892938254,892938297,43,269,751,3.3896103896103895
738,3,3,0,892938297,892938330,33,751,343,3.0
738,3,3,0,892938330,892938492,162,343,517,3.625
738,3,4,1,892938492,892938594,102,517,199,4.191489361702128
738,4,4,0,892938594,892957860,19266,199,969,3.8947368421052633
738,4,4,0,892957860,892957967,107,969,265,3.710144927536232
738,4,4,0,892957967,892958051,84,265,177,3.875
738,4,3,-1,892958051,892958137,86,177,203,3.826923076923077
738,3,4,1,892958137,892958170,33,203,136,3.764705882352941
736,3,2,-1,878708579,878708646,67,50,181,3.98974358974359
736,2,3,1,878708646,878708721,75,181,257,3.7154471544715446
736,3,3,0,878708721,878708991,270,257,324,3.2291666666666665
736,3,1,-2,878708991,878709025,34,324,255,3.2027027027027026
736,1,3,2,878709025,878709108,83,255,533,3.6
736,3,1,-2,878709108,878709187,79,533,323,3.0
736,1,1,0,878709187,878709212,25,323,678,2.8181818181818183
736,1,1,0,878709212,878709262,50,678,254,2.7419354838709675
736,1,4,3,878709262,878709365,103,254,127,4.162790697674419
734,4,5,1,891022311,891022648,337,288,318,4.5046728971962615
734,5,5,0,891022648,891022684,36,318,213,3.943396226415094
734,5,4,-1,891022684,891022704,20,213,82,3.6741573033707864
734,4,4,0,891022704,891022733,29,82,83,4.204081632653061
734,4,4,0,891022733,891022752,19,83,699,3.736842105263158
734,4,3,-1,891022752,891022937,185,699,210,3.921259842519685
734,3,4,1,891022937,891022938,1,210,498,4.290909090909091
734,4,5,1,891022938,891022958,20,498,143,3.56
734,5,5,0,891022958,891022976,18,143,485,3.717948717948718
734,5,4,-1,891022976,891022977,1,485,591,3.7169811320754715
734,4,4,0,891022977,891022993,16,591,97,3.7282608695652173
734,4,4,0,891022993,891023019,26,97,275,4.087912087912088
734,4,5,1,891023019,891023066,47,275,607,4.136363636363637
734,5,4,-1,891023066,891023086,20,607,604,3.8181818181818183
734,4,4,0,891023086,891023131,45,604,705,3.7857142857142856
734,4,3,-1,891023131,891025301,2170,705,22,4.215909090909091
734,3,4,1,891025301,891025340,39,22,193,3.883720930232558
734,4,3,-1,891025340,891025393,53,193,165,3.9130434782608696
734,3,4,1,891025393,891025498,105,165,487,4.043478260869565
734,4,5,1,891025498,891025523,25,487,496,4.094594594594595
734,5,3,-2,891025523,891025524,1,496,164,3.6140350877192984
734,3,4,1,891025524,891025541,17,164,479,4.25
734,4,4,0,891025541,891025555,14,479,605,3.3333333333333335
734,4,4,0,891025555,891025573,18,605,95,3.8194444444444446
734,4,2,-2,891025573,891025591,18,95,482,3.9444444444444446
734,2,4,2,891025591,891025943,352,482,274,3.5609756097560976
734,4,4,0,891025943,891025958,15,274,742,3.5555555555555554
734,4,3,-1,891025958,891025993,35,742,111,3.5106382978723403
734,3,4,1,891025993,891026009,16,111,15,3.725663716814159
734,4,4,0,891026009,891026028,19,15,121,3.521212121212121
730,3,4,1,880309892,880309927,35,340,268,3.9838709677419355
730,4,5,1,880309927,880309940,13,268,258,3.7547169811320753
730,5,3,-2,880309940,880309964,24,258,300,3.6861313868613137
730,3,4,1,880309964,880310082,118,300,748,3.1043478260869564
730,4,2,-2,880310082,880310201,119,748,875,2.736842105263158
730,2,3,1,880310201,880310233,32,875,237,3.7315436241610738
730,3,4,1,880310233,880310264,31,237,15,3.725663716814159
730,4,4,0,880310264,880310285,21,15,1,3.902439024390244
730,4,3,-1,880310285,880310300,15,1,117,3.689189189189189
730,3,2,-1,880310300,880310324,24,117,273,3.5238095238095237
730,2,4,2,880310324,880310352,28,273,7,3.76056338028169
730,4,5,1,880310352,880310371,19,7,100,4.0162162162162165
730,5,3,-2,880310371,880310390,19,100,276,3.6036036036036037
730,3,4,1,880310390,880310426,36,276,298,3.779220779220779
730,4,1,-3,880310426,880310440,14,298,410,3.0434782608695654
730,1,2,1,880310440,880310465,25,410,181,3.98974358974359
730,2,3,1,880310465,880310490,25,181,815,3.135135135135135
730,3,4,1,880310490,880310521,31,815,125,3.5555555555555554
730,4,5,1,880310521,880310541,20,125,257,3.7154471544715446
730,5,3,-2,880310541,880310553,12,257,742,3.5555555555555554
730,3,2,-1,880310553,880310569,16,742,685,3.2666666666666666
743,5,3,-2,881277551,881277602,51,311,286,3.442857142857143
743,3,3,0,881277602,881277656,54,286,326,3.262295081967213
743,3,2,-1,881277656,881277690,34,326,321,3.0172413793103448
743,2,3,1,881277690,881277750,60,321,322,3.0476190476190474
743,3,1,-2,881277750,881277800,50,322,338,2.75
743,1,3,2,881277800,881277855,55,338,15,3.725663716814159
743,3,5,2,881277855,881277892,37,15,744,3.5714285714285716
743,5,3,-2,881277892,881277931,39,744,181,3.98974358974359
743,3,4,1,881277931,881277962,31,181,222,3.578125
743,4,3,-1,881277962,881278061,99,222,273,3.5238095238095237
742,3,4,1,881005611,881335461,329850,321,15,3.725663716814159
742,4,4,0,881335461,881335492,31,15,475,3.956043956043956
742,4,4,0,881335492,881335528,36,475,1012,3.2916666666666665
742,4,1,-3,881335528,881335598,70,1012,546,2.9789473684210526
742,1,4,3,881335598,881335960,362,546,237,3.7315436241610738
742,4,3,-1,881335960,881336006,46,237,250,3.4698795180722892
737,4,5,1,884314693,884314694,1,475,137,3.9545454545454546
737,5,4,-1,884314694,884314740,46,137,64,4.373737373737374
737,4,4,0,884314740,884314881,141,64,160,3.4
737,4,3,-1,884314881,884314903,22,160,11,3.8904109589041096
737,3,1,-2,884314903,884314922,19,11,501,3.289473684210526
737,1,3,2,884314922,884314970,48,501,427,4.2025316455696204
737,3,4,1,884314970,884314993,23,427,32,3.7222222222222223
737,4,4,0,884314993,884315066,73,32,428,3.744186046511628
737,4,3,-1,884315066,884315127,61,428,222,3.578125
737,3,5,2,884315127,884315246,119,222,175,3.8354430379746836
733,4,2,-2,879535265,879535299,34,221,129,3.744186046511628
733,2,3,1,879535299,879535338,39,129,1115,3.3846153846153846
733,3,1,-2,879535338,879535502,164,1115,250,3.4698795180722892
733,1,3,2,879535502,879535559,57,250,10,3.85
733,3,2,-1,879535559,879535603,44,10,1163,2.1666666666666665
733,2,4,2,879535603,879535643,40,1163,950,2.625
733,4,4,0,879535643,879535644,1,950,1011,3.1
733,4,4,0,879535644,879535694,50,1011,324,3.2291666666666665
733,4,4,0,879535694,879535723,29,324,744,3.5714285714285716
733,4,4,0,879535723,879535752,29,744,290,3.108108108108108
733,4,2,-2,879535752,879535779,27,290,117,3.689189189189189
733,2,3,1,879535779,879535780,1,117,1171,2.857142857142857
733,3,3,0,879535780,879535814,34,1171,282,3.610526315789474
733,3,4,1,879535814,879535847,33,282,762,3.3962264150943398
733,4,2,-2,879535847,879535848,1,762,846,3.1052631578947367
733,2,4,2,879535848,879535938,90,846,713,3.5
733,4,3,-1,879535938,879535968,30,713,1226,3.5454545454545454
733,3,3,0,879535968,879535969,1,1226,16,3.411764705882353
733,3,4,1,879535969,879536001,32,16,107,3.45
733,4,1,-3,879536001,879536523,522,107,277,3.6
733,1,2,1,879536523,879536567,44,277,281,3.2
733,2,3,1,879536567,879536607,40,281,148,3.2131147540983607
733,3,2,-1,879536607,879536659,52,148,405,3.25
733,2,3,1,879536659,879536723,64,405,121,3.521212121212121
733,3,2,-1,879536723,879544411,7688,121,220,3.433333333333333
733,2,1,-1,879544411,879544466,55,220,546,2.9789473684210526
745,4,1,-3,880122863,880122907,44,515,936,3.727272727272727
745,1,2,1,880122907,880122928,21,936,50,4.306532663316583
745,2,2,0,880122928,880122965,37,50,181,3.98974358974359
745,2,2,0,880122965,880122986,21,181,127,4.162790697674419
745,2,4,2,880122986,880123019,33,127,7,3.76056338028169
745,4,5,1,880123019,880123069,50,7,125,3.5555555555555554
745,5,2,-3,880123069,880123126,57,125,222,3.578125
745,2,3,1,880123126,880123179,53,222,174,4.253521126760563
745,3,2,-1,880123179,880123205,26,174,205,3.717391304347826
745,2,4,2,880123205,880123243,38,205,603,4.315789473684211
745,4,4,0,880123243,880123262,19,603,194,4.029411764705882
745,4,2,-2,880123262,880123314,52,194,182,3.842857142857143
745,2,3,1,880123314,880123335,21,182,204,3.6744186046511627
745,3,4,1,880123335,880123399,64,204,96,3.9130434782608696
745,4,4,0,880123399,880123416,17,96,646,3.9285714285714284
745,4,3,-1,880123416,880123486,70,646,527,3.823529411764706
745,3,4,1,880123486,880123540,54,527,425,3.7027027027027026
745,4,5,1,880123540,880123572,32,425,492,4.117647058823529
745,5,2,-3,880123572,880123609,37,492,207,3.4761904761904763
745,2,4,2,880123609,880123627,18,207,8,3.903225806451613
745,4,4,0,880123627,880123671,44,8,169,4.548387096774194
745,4,3,-1,880123671,880123696,25,169,203,3.826923076923077
745,3,3,0,880123696,880123720,24,203,510,3.823529411764706
745,3,5,2,880123720,880123751,31,510,519,4.291666666666667
745,5,5,0,880123751,880123905,154,519,12,4.358974358974359
740,2,3,1,879522753,879522781,28,271,319,3.0408163265306123
740,3,3,0,879522781,879522814,33,319,328,3.4895833333333335
740,3,3,0,879522814,879522839,25,328,322,3.0476190476190474
740,3,1,-2,879522839,879522906,67,322,938,2.5555555555555554
735,4,4,0,876697610,876697647,37,288,333,3.546666666666667
735,4,4,0,876697647,876698604,957,333,181,3.98974358974359
735,4,5,1,876698604,876698643,39,181,124,4.052631578947368
735,5,2,-3,876698643,876698684,41,124,756,2.6885245901639343
735,2,3,1,876698684,876698714,30,756,106,2.8125
735,3,2,-1,876698714,876698796,82,106,100,4.0162162162162165
735,2,3,1,876698796,876698837,41,100,676,3.3142857142857145
735,3,3,0,876698837,876698866,29,676,123,3.297872340425532
735,3,3,0,876698866,876698897,31,123,117,3.689189189189189
747,5,5,0,888638183,888638242,59,305,262,3.5217391304347827
747,5,5,0,888638242,888638265,23,262,313,4.323076923076923
747,5,4,-1,888638265,888638293,28,313,292,3.6666666666666665
747,4,5,1,888638293,888638335,42,292,887,3.5789473684210527
747,5,4,-1,888638335,888638370,35,887,304,3.5306122448979593
747,4,4,0,888638370,888638425,55,304,327,3.5076923076923077
747,4,3,-1,888638425,888638455,30,327,875,2.736842105263158
747,3,4,1,888638455,888638552,97,875,316,4.285714285714286
747,4,2,-2,888638552,888638876,324,316,664,3.15
747,2,5,3,888638876,888638913,37,664,223,4.108695652173913
747,5,3,-2,888638913,888638957,44,223,1631,3.0
747,3,5,2,888638957,888638958,1,1631,606,4.294117647058823
747,5,5,0,888638958,888639014,56,606,192,4.090909090909091
747,5,4,-1,888639014,888639015,1,192,168,4.0476190476190474
747,4,5,1,888639015,888639060,45,168,480,4.283018867924528
747,5,4,-1,888639060,888639102,42,480,199,4.191489361702128
747,4,5,1,888639102,888639138,36,199,511,4.096153846153846
747,5,4,-1,888639138,888639175,37,511,659,4.027777777777778
747,4,4,0,888639175,888639176,1,659,7,3.76056338028169
747,4,5,1,888639176,888639272,96,7,462,3.7954545454545454
747,5,5,0,888639272,888639318,46,462,498,4.290909090909091
747,5,5,0,888639318,888639362,44,498,603,4.315789473684211
747,5,5,0,888639362,888639397,35,603,644,3.7
747,5,4,-1,888639397,888639437,40,644,478,4.161290322580645
747,4,5,1,888639437,888639480,43,478,98,4.240875912408759
747,5,5,0,888639480,888639525,45,98,481,3.8421052631578947
747,5,5,0,888639525,888639526,1,481,474,4.172413793103448
747,5,2,-3,888639526,888639594,68,474,1427,2.3333333333333335
747,2,5,3,888639594,888639685,91,1427,1203,4.0
747,5,5,0,888639685,888639735,50,1203,23,3.9047619047619047
747,5,4,-1,888639735,888639736,1,23,228,3.7246376811594204
747,4,5,1,888639736,888639780,44,228,179,3.8823529411764706
747,5,5,0,888639780,888639890,110,179,48,4.055555555555555
747,5,5,0,888639890,888639939,49,48,47,3.5869565217391304
747,5,5,0,888639939,888639989,50,47,519,4.291666666666667
747,5,3,-2,888639989,888640046,57,519,428,3.744186046511628
747,3,5,2,888640046,888640099,53,428,234,3.7674418604651163
747,5,5,0,888640099,888640136,37,234,443,3.8421052631578947
747,5,2,-3,888640136,888640180,44,443,675,3.625
747,2,3,1,888640180,888640222,42,675,152,3.6785714285714284
747,3,5,2,888640222,888640348,126,152,615,3.8333333333333335
747,5,5,0,888640348,888640437,89,615,97,3.7282608695652173
747,5,2,-3,888640437,888640475,38,97,282,3.610526315789474
747,2,5,3,888640475,888640524,49,282,488,4.277777777777778
747,5,5,0,888640524,888640567,43,488,521,3.787878787878788
747,5,5,0,888640567,888640605,38,521,504,4.085714285714285
747,5,4,-1,888640605,888640684,79,504,39,3.107142857142857
747,4,2,-2,888640684,888640776,92,39,591,3.7169811320754715
747,2,4,2,888640776,888640915,139,591,28,3.923076923076923
747,4,4,0,888640915,888732571,91656,28,83,4.204081632653061
747,4,5,1,888732571,888732609,38,83,486,3.9565217391304346
747,5,2,-3,888732609,888732640,31,486,985,2.9
747,2,3,1,888732640,888732695,55,985,463,3.6818181818181817
747,3,5,2,888732695,888732719,24,463,479,4.25
747,5,3,-2,888732719,888732747,28,479,1456,3.5
747,3,1,-2,888732747,888732921,174,1456,783,2.388888888888889
747,1,3,2,888732921,888733070,149,783,367,3.4242424242424243
747,3,4,1,888733070,888733111,41,367,163,3.53125
747,4,4,0,888733111,888733182,71,163,287,3.4516129032258065
747,4,4,0,888733182,888733218,36,287,70,3.5833333333333335
747,4,5,1,888733218,888733274,56,70,715,3.257142857142857
747,5,1,-4,888733274,888733313,39,715,1659,1.0
747,1,3,2,888733313,888733314,1,1659,26,3.36
747,3,3,0,888733314,888733348,34,26,13,3.5454545454545454
747,3,3,0,888733348,888733387,39,13,433,3.8035714285714284
747,3,5,2,888733387,888733444,57,433,235,3.106382978723404
747,5,3,-2,888733444,888733480,36,235,997,2.7142857142857144
747,3,4,1,888733480,888733567,87,997,1041,3.3333333333333335
747,4,3,-1,888733567,888733595,28,1041,476,3.1216216216216215
747,3,2,-1,888733595,888733630,35,476,952,3.3529411764705883
747,2,3,1,888733630,888734072,442,952,739,3.391304347826087
747,3,5,2,888734072,888734112,40,739,580,3.625
747,5,3,-2,888734112,888734113,1,580,231,2.938775510204082
723,5,2,-3,880498795,880498816,21,748,289,2.988888888888889
723,2,4,2,880498816,880498889,73,289,50,4.306532663316583
723,4,4,0,880498889,880498890,1,50,172,4.225225225225225
723,4,3,-1,880498890,880498912,22,172,9,3.8878504672897196
723,3,3,0,880498912,880498938,26,9,178,4.378378378378378
723,3,3,0,880498938,880498996,58,178,89,3.9615384615384617
723,3,4,1,880498996,880499019,23,89,164,3.6140350877192984
723,4,3,-1,880499019,880499050,31,164,150,3.803921568627451
739,3,4,1,886825083,886825227,144,751,333,3.546666666666667
739,4,5,1,886825227,886825529,302,333,359,3.8
739,5,5,0,886825529,886958860,133331,359,22,4.215909090909091
739,5,5,0,886958860,886958895,35,22,526,3.909090909090909
739,5,4,-1,886958895,886958938,43,526,172,4.225225225225225
739,4,5,1,886958938,886958939,1,172,195,3.9072164948453607
739,5,4,-1,886958939,886959069,130,195,603,4.315789473684211
749,4,3,-1,878846365,878846384,19,326,748,3.1043478260869564
749,3,2,-1,878846384,878846423,39,748,678,2.8181818181818183
749,2,4,2,878846423,878846449,26,678,879,3.2291666666666665
749,4,4,0,878846449,878846697,248,879,25,3.3185840707964602
749,4,5,1,878846697,878846783,86,25,151,3.6544117647058822
749,5,5,0,878846783,878846841,58,151,15,3.725663716814159
749,5,3,-2,878846841,878846903,62,15,9,3.8878504672897196
749,3,3,0,878846903,878846957,54,9,257,3.7154471544715446
749,3,5,2,878846957,878846958,1,257,1016,3.559322033898305
749,5,5,0,878846958,878846998,40,1016,181,3.98974358974359
749,5,4,-1,878846998,878847076,78,181,1615,3.5
749,4,3,-1,878847076,878847101,25,1615,1244,2.7777777777777777
749,3,4,1,878847101,878847172,71,1244,215,3.662921348314607
749,4,5,1,878847172,878847209,37,215,174,4.253521126760563
749,5,5,0,878847209,878847239,30,174,172,4.225225225225225
749,5,5,0,878847239,878847328,89,172,480,4.283018867924528
749,5,3,-2,878847328,878847364,36,480,157,3.5714285714285716
749,3,4,1,878847364,878847404,40,157,510,3.823529411764706
749,4,4,0,878847404,878847461,57,510,429,3.742857142857143
749,4,5,1,878847461,878847498,37,429,418,3.825
749,5,4,-1,878847498,878847540,42,418,483,4.475609756097561
749,4,4,0,878847540,878847576,36,483,71,3.6575342465753424
749,4,5,1,878847576,878847611,35,71,659,4.027777777777778
749,5,4,-1,878847611,878847612,1,659,495,3.65
749,4,3,-1,878847612,878847645,33,495,121,3.521212121212121
749,3,5,2,878847645,878847673,28,121,404,3.6578947368421053
749,5,3,-2,878847673,878847716,43,404,740,3.423076923076923
749,3,5,2,878847716,878847740,24,740,173,4.1441441441441444
749,5,5,0,878847740,878847804,64,173,99,3.8392857142857144
749,5,4,-1,878847804,878847863,59,99,4,3.5538461538461537
749,4,4,0,878847863,878847888,25,4,435,3.8933333333333335
749,4,4,0,878847888,878847954,66,435,443,3.8421052631578947
749,4,3,-1,878847954,878847988,34,443,58,3.543859649122807
749,3,3,0,878847988,878848015,27,58,48,4.055555555555555
749,3,4,1,878848015,878848098,83,48,568,3.5853658536585367
749,4,4,0,878848098,878848137,39,568,49,3.3
749,4,3,-1,878848137,878848189,52,49,650,3.1363636363636362
749,3,4,1,878848189,878848243,54,650,273,3.5238095238095237
749,4,3,-1,878848243,878848272,29,273,230,3.3518518518518516
749,3,4,1,878848272,878848302,30,230,200,3.8157894736842106
749,4,3,-1,878848302,878848333,31,200,95,3.8194444444444446
749,3,4,1,878848333,878848369,36,95,975,3.411764705882353
749,4,3,-1,878848369,878848405,36,975,477,3.1666666666666665
749,3,3,0,878848405,878848430,25,477,625,3.25
749,3,4,1,878848430,878848452,22,625,732,3.6266666666666665
749,4,4,0,878848452,878848483,31,732,180,3.9473684210526314
749,4,4,0,878848483,878848533,50,180,226,3.378787878787879
749,4,5,1,878848533,878848587,54,226,837,4.0
749,5,3,-2,878848587,878848612,25,837,616,3.1052631578947367
749,3,4,1,878848612,878848639,27,616,203,3.826923076923077
749,4,2,-2,878848639,878848673,34,203,405,3.25
749,2,4,2,878848673,878848700,27,405,101,3.4827586206896552
749,4,2,-2,878848700,878848701,1,101,167,2.8181818181818183
749,2,5,3,878848701,878848764,63,167,125,3.5555555555555554
749,5,3,-2,878848764,878848795,31,125,621,2.75
749,3,3,0,878848795,878848998,203,621,843,2.933333333333333
749,3,3,0,878848998,878849052,54,843,100,4.0162162162162165
749,3,4,1,878849052,878849149,97,100,1028,2.857142857142857
749,4,3,-1,878849149,878849176,27,1028,23,3.9047619047619047
749,3,3,0,878849176,878849177,1,23,214,3.272727272727273
749,3,4,1,878849177,878849286,109,214,239,3.423076923076923
749,4,4,0,878849286,878849375,89,239,742,3.5555555555555554
749,4,3,-1,878849375,878849433,58,742,66,3.4705882352941178
749,3,4,1,878849433,878849534,101,66,88,3.433734939759036
749,4,3,-1,878849534,878849558,24,88,930,2.793103448275862
749,3,4,1,878849558,878849586,28,930,73,3.588235294117647
749,4,4,0,878849586,878849660,74,73,231,2.938775510204082
749,4,4,0,878849660,878849682,22,231,420,3.5652173913043477
749,4,3,-1,878849682,878849740,58,420,1047,2.6923076923076925
749,3,4,1,878849740,878849829,89,1047,402,3.3076923076923075
749,4,3,-1,878849829,878849857,28,402,546,2.9789473684210526
749,3,5,2,878849857,878849877,20,546,941,3.5
749,5,4,-1,878849877,878849903,26,941,366,3.4285714285714284
749,4,4,0,878849903,878849929,26,366,636,3.4146341463414633
749,4,3,-1,878849929,878850038,109,636,398,2.1
749,3,3,0,878850038,878850060,22,398,823,2.75
749,3,3,0,878850060,878850084,24,823,1139,2.611111111111111
749,3,3,0,878850084,878850186,102,1139,968,3.75
749,3,3,0,878850186,878850212,26,968,148,3.2131147540983607
749,3,4,1,878850212,878850429,217,148,686,3.9
749,4,4,0,878850429,878850456,27,686,142,3.1481481481481484
749,4,3,-1,878850456,878850533,77,142,576,3.125
749,3,2,-1,878850533,878850565,32,576,833,2.9444444444444446
749,2,1,-1,878850565,878850588,23,833,67,3.106382978723404
749,1,3,2,878850588,878850610,22,67,449,2.9069767441860463
749,3,3,0,878850610,878850632,22,449,78,2.3636363636363638
749,3,2,-1,878850632,878850656,24,78,1034,2.6
749,2,4,2,878850656,878850657,1,1034,586,2.875
749,4,1,-3,878850657,878850703,46,586,635,2.5
749,1,3,2,878850703,878850724,21,635,38,2.784313725490196
749,3,4,1,878850724,878850748,24,38,1228,2.5
749,4,3,-1,878850748,878850768,20,1228,841,2.772727272727273
749,3,3,0,878850768,878850789,21,841,802,3.076923076923077
749,3,3,0,878850789,878850825,36,802,541,2.9473684210526314
749,3,4,1,878850825,879788916,938091,541,298,3.779220779220779
749,4,3,-1,879788916,881073009,1284093,298,984,2.6666666666666665
749,3,5,2,881073009,881073043,34,984,484,4.116279069767442
749,5,1,-4,881073043,881073081,38,484,1013,2.388888888888889
749,1,3,2,881073081,881073104,23,1013,1023,2.5714285714285716
749,3,2,-1,881073104,881602596,529492,1023,1088,2.4
749,2,3,1,881602596,881602635,39,1088,295,3.769230769230769
749,3,4,1,881602635,881602704,69,295,223,4.108695652173913
749,4,3,-1,881602704,882804586,1201882,223,1089,2.1363636363636362
749,3,3,0,882804586,882804605,19,1089,1337,3.0
748,3,4,1,879454171,879454208,37,326,323,3.0
748,4,2,-2,879454208,879454233,25,323,678,2.8181818181818183
748,2,5,3,879454233,879454383,150,678,250,3.4698795180722892
748,5,4,-1,879454383,879454405,22,250,427,4.2025316455696204
748,4,4,0,879454405,879454428,23,427,633,3.9
748,4,5,1,879454428,879454455,27,633,603,4.315789473684211
748,5,4,-1,879454455,879454475,20,603,234,3.7674418604651163
748,4,2,-2,879454475,879454476,1,234,402,3.3076923076923075
748,2,4,2,879454476,879454497,21,402,813,4.055555555555555
748,4,5,1,879454497,879454498,1,813,186,3.905263157894737
748,5,3,-2,879454498,879454522,24,186,200,3.8157894736842106
748,3,3,0,879454522,879454546,24,200,71,3.6575342465753424
748,3,1,-2,879454546,879454573,27,71,650,3.1363636363636362
748,1,3,2,879454573,879454584,11,650,210,3.921259842519685
748,3,3,0,879454584,879454602,18,210,154,3.6031746031746033
748,3,4,1,879454602,879454630,28,154,182,3.842857142857143
748,4,3,-1,879454630,879454662,32,182,204,3.6744186046511627
748,3,3,0,879454662,879454687,25,204,228,3.7246376811594204
748,3,4,1,879454687,879454707,20,228,64,4.373737373737374
748,4,4,0,879454707,879454749,42,64,514,4.033333333333333
748,4,4,0,879454749,879454773,24,514,194,4.029411764705882
748,4,3,-1,879454773,879454789,16,194,193,3.883720930232558
748,3,4,1,879454789,879454810,21,193,172,4.225225225225225
748,4,4,0,879454810,879454831,21,172,498,4.290909090909091
748,4,4,0,879454831,879454848,17,498,169,4.548387096774194
748,4,4,0,879454848,879454849,1,169,69,3.8015873015873014
748,4,3,-1,879454849,879454879,30,69,655,3.7857142857142856
748,3,4,1,879454879,879454880,1,655,237,3.7315436241610738
748,4,4,0,879454880,879454912,32,237,4,3.5538461538461537
748,4,3,-1,879454912,879454930,18,4,168,4.0476190476190474
748,3,4,1,879454930,879454958,28,168,187,4.215189873417722
748,4,4,0,879454958,879454998,40,187,79,3.956989247311828
748,4,5,1,879454998,879455019,21,79,175,3.8354430379746836
748,5,4,-1,879455019,879455040,21,175,483,4.475609756097561
748,4,4,0,879455040,879455083,43,483,56,4.051724137931035
748,4,4,0,879455083,879455126,43,56,8,3.903225806451613
748,4,4,0,879455126,879455167,41,8,188,3.625
748,4,1,-3,879455167,879455186,19,188,451,3.207792207792208
748,1,4,3,879455186,879455221,35,451,657,4.341463414634147
748,4,3,-1,879455221,879455410,189,657,710,3.41025641025641
748,3,3,0,879455410,879455454,44,710,699,3.736842105263158
746,5,2,-3,885075166,885075243,77,181,127,4.162790697674419
746,2,4,2,885075243,885075267,24,127,184,3.393939393939394
746,4,4,0,885075267,885075304,37,184,597,3.2771084337349397
746,4,4,0,885075304,885075367,63,597,550,3.272727272727273
746,4,4,0,885075367,885075399,32,550,233,3.323529411764706
746,4,3,-1,885075399,885075434,35,233,62,3.048780487804878
746,3,2,-1,885075434,885075476,42,62,405,3.25
746,2,3,1,885075476,885075497,21,405,523,4.159090909090909
746,3,5,2,885075497,885075539,42,523,204,3.6744186046511627
746,5,4,-1,885075539,885075590,51,204,157,3.5714285714285716
746,4,4,0,885075590,885075612,22,157,196,3.9404761904761907
746,4,4,0,885075612,885075714,102,196,1,3.902439024390244
746,4,4,0,885075714,885075756,42,1,132,3.929411764705882
746,4,4,0,885075756,885075790,34,132,64,4.373737373737374
746,4,3,-1,885075790,885075824,34,64,506,3.566666666666667
731,2,3,1,886179161,886179289,128,56,484,4.116279069767442
731,3,4,1,886179289,886179415,126,484,127,4.162790697674419
731,4,5,1,886179415,886182457,3042,127,192,4.090909090909091
731,5,5,0,886182457,886182555,98,192,215,3.662921348314607
731,5,4,-1,886182555,886182556,1,215,486,3.9565217391304346
731,4,5,1,886182556,886182631,75,486,603,4.315789473684211
731,5,4,-1,886182631,886182826,195,603,136,3.764705882352941
731,4,3,-1,886182826,886183209,383,136,504,4.085714285714285
731,3,5,2,886183209,886183681,472,504,97,3.7282608695652173
731,5,4,-1,886183681,886184577,896,97,66,3.4705882352941178
731,4,2,-2,886184577,886184681,104,66,8,3.903225806451613
731,2,4,2,886184681,886184682,1,8,487,4.043478260869565
731,4,3,-1,886184682,886184683,1,487,611,4.384615384615385
731,3,3,0,886184683,886184770,87,611,482,3.9444444444444446
731,3,3,0,886184770,886184771,1,482,720,3.2
731,3,1,-2,886184771,886184852,81,720,133,3.7777777777777777
731,1,1,0,886184852,886185744,892,133,168,4.0476190476190474
731,1,2,1,886185744,886186568,824,168,613,4.1
731,2,1,-1,886186568,886186940,372,613,1275,3.0
731,1,5,4,886186940,886187538,598,1275,357,4.063291139240507
731,5,4,-1,886187538,886187652,114,357,480,4.283018867924528
750,4,1,-3,879445808,879445877,69,288,1280,2.3333333333333335
750,1,4,3,879445877,879445961,84,1280,294,3.1052631578947367
750,4,3,-1,879445961,879446013,52,294,748,3.1043478260869564
750,3,2,-1,879446013,879446014,1,748,876,3.0
750,2,4,2,879446014,879446114,100,876,331,3.5517241379310347
750,4,3,-1,879446114,879446215,101,331,245,3.056179775280899
750,3,3,0,879446215,879446216,1,245,358,2.6551724137931036
741,3,5,2,891018152,891018221,69,475,427,4.2025316455696204
741,5,3,-2,891018221,891018266,45,427,66,3.4705882352941178
741,3,5,2,891018266,891018339,73,66,50,4.306532663316583
741,5,2,-3,891018339,891018366,27,50,173,4.1441441441441444
741,2,2,0,891018366,891018400,34,173,95,3.8194444444444446
741,2,5,3,891018400,891018435,35,95,178,4.378378378378378
741,5,5,0,891018435,891018460,25,178,196,3.9404761904761907
741,5,5,0,891018460,891018507,47,196,357,4.063291139240507
741,5,4,-1,891018507,891018550,43,357,48,4.055555555555555
741,4,4,0,891018550,891019625,1075,48,241,3.5625
741,4,3,-1,891019625,891040362,20737,241,660,3.71875
741,3,2,-1,891040362,891040490,128,660,393,3.5125
741,2,5,3,891040490,891455317,414827,393,186,3.905263157894737
741,5,4,-1,891455317,891455353,36,186,435,3.8933333333333335
741,4,5,1,891455353,891455381,28,435,134,4.174603174603175
741,5,5,0,891455381,891455516,135,134,98,4.240875912408759
741,5,4,-1,891455516,891455610,94,98,79,3.956989247311828
741,4,3,-1,891455610,891455671,61,79,77,3.3857142857142857
741,3,5,2,891455671,891455735,64,77,265,3.710144927536232
741,5,2,-3,891455735,891455792,57,265,281,3.2
741,2,2,0,891455792,891455832,40,281,38,2.784313725490196
741,2,1,-1,891455832,891455855,23,38,118,3.2764227642276422
741,1,3,2,891455855,891455901,46,118,696,3.138888888888889
741,3,3,0,891455901,891455960,59,696,682,3.0476190476190474
741,3,2,-1,891455960,891456040,80,682,239,3.423076923076923
741,2,5,3,891456040,891456083,43,239,403,3.298507462686567
741,5,3,-2,891456083,891456156,73,403,582,3.7457627118644066
741,3,4,1,891456156,891456615,459,582,215,3.662921348314607
741,4,5,1,891456615,891456718,103,215,496,4.094594594594595
741,5,5,0,891456718,891456741,23,496,478,4.161290322580645
741,5,4,-1,891456741,891456776,35,478,131,3.731707317073171
741,4,5,1,891456776,891456827,51,131,945,3.4
741,5,2,-3,891456827,891457280,453,945,367,3.4242424242424243
741,2,4,2,891457280,891457342,62,367,216,3.8454545454545452
741,4,3,-1,891457342,891457371,29,216,785,3.4375
741,3,3,0,891457371,891457456,85,785,790,2.8518518518518516
741,3,3,0,891457456,891457528,72,790,722,2.9642857142857144
741,3,3,0,891457528,891457633,105,722,783,2.388888888888889
741,3,3,0,891457633,891457956,323,783,290,3.108108108108108
741,3,3,0,891457956,891458066,110,290,273,3.5238095238095237
741,3,3,0,891458066,891458098,32,273,255,3.2027027027027026
741,3,3,0,891458098,891458249,151,255,1016,3.559322033898305
741,3,4,1,891458249,891458250,1,1016,283,3.901639344262295
741,4,3,-1,891458250,891458403,153,283,280,3.103448275862069
741,3,3,0,891458403,891458428,25,280,25,3.3185840707964602
741,3,3,0,891458428,891458597,169,25,1152,3.4375
741,3,3,0,891458597,891458647,50,1152,815,3.135135135135135
751,2,3,1,887134622,887134816,194,300,310,3.6666666666666665
751,3,3,0,887134816,887134842,26,310,332,3.6511627906976742
751,3,1,-2,887134842,888871598,1736756,332,323,3.0
751,1,2,1,888871598,888871738,140,323,689,3.1538461538461537
751,2,5,3,888871738,888871900,162,689,269,4.085106382978723
751,5,4,-1,888871900,889132222,260322,269,1007,4.117647058823529
751,4,3,-1,889132222,889132251,29,1007,7,3.76056338028169
751,3,2,-1,889132251,889132301,50,7,237,3.7315436241610738
751,2,3,1,889132301,889132347,46,237,742,3.5555555555555554
751,3,1,-2,889132347,889132375,28,742,591,3.7169811320754715
751,1,5,4,889132375,889132397,22,591,181,3.98974358974359
751,5,5,0,889132397,889132413,16,181,248,3.746268656716418
751,5,4,-1,889132413,889132542,129,248,257,3.7154471544715446
751,4,4,0,889132542,889132599,57,257,1011,3.1
751,4,3,-1,889132599,889132657,58,1011,111,3.5106382978723403
751,3,4,1,889132657,889132775,118,111,56,4.051724137931035
751,4,5,1,889132775,889132808,33,56,213,3.943396226415094
751,5,5,0,889132808,889132849,41,213,483,4.475609756097561
751,5,5,0,889132849,889132896,47,483,178,4.378378378378378
751,5,4,-1,889132896,889132929,33,178,709,4.171428571428572
751,4,4,0,889132929,889133012,83,709,174,4.253521126760563
751,4,4,0,889133012,889133039,27,174,196,3.9404761904761907
751,4,5,1,889133039,889133064,25,196,28,3.923076923076923
751,5,3,-2,889133064,889133106,42,28,658,3.393939393939394
751,3,4,1,889133106,889133129,23,658,480,4.283018867924528
751,4,4,0,889133129,889133154,25,480,96,3.9130434782608696
751,4,1,-3,889133154,889133177,23,96,11,3.8904109589041096
751,1,4,3,889133177,889133219,42,11,144,3.9545454545454546
751,4,4,0,889133219,889133240,21,144,153,3.7865168539325844
751,4,4,0,889133240,889133334,94,153,82,3.6741573033707864
751,4,3,-1,889133334,889133377,43,82,655,3.7857142857142856
751,3,2,-1,889133377,889133429,52,655,704,3.125
751,2,4,2,889133429,889133556,127,704,494,3.8333333333333335
751,4,4,0,889133556,889133602,46,494,216,3.8454545454545452
751,4,4,0,889133602,889133684,82,216,481,3.8421052631578947
751,4,3,-1,889133684,889133737,53,481,486,3.9565217391304346
751,3,3,0,889133737,889133852,115,486,945,3.4
751,3,4,1,889133852,889133950,98,945,367,3.4242424242424243
751,4,4,0,889133950,889133951,1,367,652,3.9642857142857144
751,4,3,-1,889133951,889134186,235,652,433,3.8035714285714284
751,3,4,1,889134186,889134332,146,433,735,3.58
751,4,4,0,889134332,889134393,61,735,173,4.1441441441441444
751,4,1,-3,889134393,889134419,26,173,381,3.2758620689655173
751,1,4,3,889134419,889134420,1,381,432,3.719298245614035
751,4,4,0,889134420,889134483,63,432,485,3.717948717948718
751,4,5,1,889134483,889134533,50,485,736,4.083333333333333
751,5,5,0,889134533,889134705,172,736,83,4.204081632653061
751,5,4,-1,889134705,889135244,539,83,385,3.6129032258064515
751,4,4,0,889135244,889135401,157,385,121,3.521212121212121
751,4,4,0,889135401,889297239,161838,121,428,3.744186046511628
751,4,4,0,889297239,889297640,401,428,394,3.5714285714285716
751,4,4,0,889297640,889297670,30,394,434,3.588235294117647
751,4,5,1,889297670,889297693,23,434,194,4.029411764705882
751,5,5,0,889297693,889297711,18,194,631,3.581818181818182
751,5,3,-2,889297711,889297767,56,631,85,3.3157894736842106
751,3,4,1,889297767,889297870,103,85,70,3.5833333333333335
751,4,5,1,889297870,889297927,57,70,87,3.9
751,5,2,-3,889297927,889297948,21,87,52,3.727272727272727
751,2,4,2,889297948,889297990,42,52,660,3.71875
751,4,4,0,889297990,889298010,20,660,785,3.4375
751,4,3,-1,889298010,889298051,41,785,710,3.41025641025641
751,3,5,2,889298051,889298093,42,710,21,2.9210526315789473
751,5,4,-1,889298093,889298116,23,21,755,3.085714285714286
751,4,4,0,889298116,889298140,24,755,708,3.3157894736842106
751,4,3,-1,889298140,889298216,76,708,558,3.75
751,3,1,-2,889298216,889298379,163,558,1101,3.793103448275862
751,1,3,2,889298379,889298463,84,1101,382,3.764705882352941
751,3,3,0,889298463,889298528,65,382,405,3.25
751,3,3,0,889298528,889298548,20,405,380,3.4878048780487805
751,3,2,-1,889298548,889298585,37,380,1035,3.03125
751,2,4,2,889298585,889298660,75,1035,88,3.433734939759036
751,4,4,0,889298660,889298694,34,88,274,3.5609756097560976
751,4,4,0,889298694,889298892,198,274,227,3.169811320754717
751,4,4,0,889298892,889298945,53,227,737,3.12
751,4,3,-1,889298945,889298964,19,737,94,2.8823529411764706
751,3,2,-1,889298964,889299043,79,94,472,2.984375
751,2,3,1,889299043,889299078,35,472,386,2.769230769230769
751,3,2,-1,889299078,889299133,55,386,849,2.5625
751,2,3,1,889299133,889299155,22,849,291,3.2
751,3,2,-1,889299155,889299249,94,291,756,2.6885245901639343
751,2,2,0,889299249,889299290,41,756,597,3.2771084337349397
751,2,1,-1,889299290,889299429,139,597,1661,1.0
751,1,2,1,889299429,889299503,74,1661,1140,2.1666666666666665
751,2,4,2,889299503,889299733,230,1140,738,3.0
756,3,4,1,874826565,874826629,64,173,1,3.902439024390244
756,4,3,-1,874826629,874827103,474,1,275,4.087912087912088
756,3,4,1,874827103,874827247,144,275,1009,3.2962962962962963
756,4,4,0,874827247,874827283,36,1009,30,3.8181818181818183
756,4,4,0,874827283,874827614,331,30,367,3.4242424242424243
756,4,4,0,874827614,874827755,141,367,8,3.903225806451613
756,4,2,-2,874827755,874827884,129,8,135,3.7974683544303796
756,2,3,1,874827884,874827920,36,135,731,3.4
756,3,3,0,874827920,874828027,107,731,92,3.7142857142857144
756,3,1,-2,874828027,874828198,171,92,1652,1.0
756,1,3,2,874828198,874828242,44,1652,527,3.823529411764706
756,3,2,-1,874828242,874828278,36,527,1274,1.8
756,2,4,2,874828278,874828349,71,1274,1119,3.5185185185185186
756,4,2,-2,874828349,874828453,104,1119,9,3.8878504672897196
756,2,4,2,874828453,874828592,139,9,50,4.306532663316583
756,4,4,0,874828592,874828769,177,50,89,3.9615384615384617
756,4,2,-2,874828769,874828826,57,89,403,3.298507462686567
756,2,3,1,874828826,874828903,77,403,568,3.5853658536585367
756,3,3,0,874828903,874829010,107,568,230,3.3518518518518516
756,3,2,-1,874829010,874829152,142,230,550,3.272727272727273
756,2,1,-1,874829152,874829174,22,550,3,3.0625
756,1,4,3,874829174,874829637,463,3,421,3.462962962962963
756,4,4,0,874829637,874829670,33,421,111,3.5106382978723403
756,4,4,0,874829670,874829705,35,111,66,3.4705882352941178
756,4,1,-3,874829705,874829743,38,66,88,3.433734939759036
756,1,3,2,874829743,874830026,283,88,742,3.5555555555555554
756,3,1,-2,874830026,874830068,42,742,860,1.8
756,1,3,2,874830068,874830103,35,860,226,3.378787878787879
756,3,2,-1,874830103,874830305,202,226,983,2.5
756,2,3,1,874830305,874830432,127,983,53,2.9523809523809526
756,3,3,0,874830432,874830513,81,53,419,3.8208955223880596
756,3,4,1,874830513,874830550,37,419,151,3.6544117647058822
756,4,3,-1,874830550,874830598,48,151,755,3.085714285714286
756,3,3,0,874830598,874830675,77,755,423,3.7016129032258065
756,3,3,0,874830675,874830748,73,423,82,3.6741573033707864
756,3,2,-1,874830748,874830819,71,82,1031,2.6
756,2,2,0,874830819,874830864,45,1031,138,2.6
756,2,3,1,874830864,874830908,44,138,404,3.6578947368421053
756,3,3,0,874830908,874830954,46,404,91,3.6
756,3,2,-1,874830954,874830998,44,91,409,2.9615384615384617
756,2,3,1,874830998,874831194,196,409,161,3.5844155844155843
756,3,3,0,874831194,874831227,33,161,141,3.4827586206896552
756,3,4,1,874831227,874831383,156,141,1074,2.857142857142857
756,4,5,1,874831383,875129318,297935,1074,55,4.051282051282051
757,3,4,1,888443398,888443483,85,751,895,3.142857142857143
757,4,3,-1,888443483,888443555,72,895,343,3.0
757,3,3,0,888443555,888443570,15,343,358,2.6551724137931036
757,3,5,2,888443570,888444007,437,358,515,4.202898550724638
757,5,4,-1,888444007,888444181,174,515,276,3.6036036036036037
757,4,4,0,888444181,888444208,27,276,298,3.779220779220779
757,4,4,0,888444208,888444209,1,298,248,3.746268656716418
757,4,3,-1,888444209,888444314,105,248,181,3.98974358974359
757,3,4,1,888444314,888444400,86,181,257,3.7154471544715446
757,4,4,0,888444400,888444563,163,257,742,3.5555555555555554
757,4,4,0,888444563,888444583,20,742,405,3.25
757,4,2,-2,888444583,888444635,52,405,121,3.521212121212121
757,2,4,2,888444635,888444738,103,121,471,3.5714285714285716
757,4,4,0,888444738,888444826,88,471,7,3.76056338028169
757,4,3,-1,888444826,888444865,39,7,825,2.914285714285714
757,3,3,0,888444865,888444881,16,825,546,2.9789473684210526
757,3,3,0,888444881,888444920,39,546,118,3.2764227642276422
757,3,3,0,888444920,888444935,15,118,235,3.106382978723404
757,3,4,1,888444935,888444948,13,235,148,3.2131147540983607
757,4,3,-1,888444948,888445035,87,148,455,3.1702127659574466
757,3,3,0,888445035,888445086,51,455,472,2.984375
757,3,2,-1,888445086,888445150,64,472,931,2.2758620689655173
757,2,1,-1,888445150,888445218,68,931,122,2.282608695652174
757,1,5,4,888445218,888445298,80,122,64,4.373737373737374
757,5,3,-2,888445298,888445551,253,64,156,4.017857142857143
757,3,4,1,888445551,888445587,36,156,172,4.225225225225225
757,4,4,0,888445587,888445604,17,172,173,4.1441441441441444
757,4,5,1,888445604,888445637,33,173,174,4.253521126760563
757,5,4,-1,888445637,888445683,46,174,206,3.0
757,4,4,0,888445683,888445714,31,206,97,3.7282608695652173
757,4,4,0,888445714,888445730,16,97,202,3.730337078651685
757,4,4,0,888445730,888445750,20,202,79,3.956989247311828
757,4,4,0,888445750,888445767,17,79,98,4.240875912408759
757,4,3,-1,888445767,888445768,1,98,69,3.8015873015873014
757,3,4,1,888445768,888445802,34,69,195,3.9072164948453607
757,4,3,-1,888445802,888445820,18,195,550,3.272727272727273
757,3,4,1,888445820,888445864,44,550,684,3.847826086956522
757,4,3,-1,888445864,888466435,20571,684,232,3.0789473684210527
757,3,4,1,888466435,888466490,55,232,82,3.6741573033707864
757,4,4,0,888466490,888466583,93,82,11,3.8904109589041096
757,4,4,0,888466583,888466584,1,11,431,3.422222222222222
757,4,3,-1,888466584,888466614,30,431,265,3.710144927536232
757,3,3,0,888466614,888466651,37,265,1188,2.45
757,3,3,0,888466651,888466652,1,1188,229,3.185185185185185
757,3,3,0,888466652,888466683,31,229,570,3.526315789473684
757,3,4,1,888466683,888466758,75,570,809,2.7058823529411766
757,4,3,-1,888466758,888466782,24,809,399,3.317073170731707
757,3,3,0,888466782,888466863,81,399,241,3.5625
757,3,4,1,888466863,888466983,120,241,1073,3.6315789473684212
757,4,3,-1,888466983,888467016,33,1073,470,3.72
757,3,3,0,888467016,888467038,22,470,38,2.784313725490196
757,3,2,-1,888467038,888467160,122,38,771,2.5714285714285716
757,2,2,0,888467160,888467187,27,771,1090,2.3529411764705883
757,2,2,0,888467187,888467205,18,1090,450,2.2758620689655173
757,2,3,1,888467205,888467269,64,450,432,3.719298245614035
757,3,3,0,888467269,888467270,1,432,426,3.1
757,3,3,0,888467270,888467286,16,426,588,3.8358208955223883
757,3,4,1,888467286,888467309,23,588,91,3.6
757,4,2,-2,888467309,888467380,71,91,561,3.1515151515151514
757,2,3,1,888467380,888467381,1,561,217,3.1538461538461537
757,3,3,0,888467381,888467400,19,217,569,2.4285714285714284
757,3,3,0,888467400,888467442,42,569,145,2.3636363636363638
757,3,4,1,888467442,888467498,56,145,693,3.6285714285714286
757,4,3,-1,888467498,888467592,94,693,58,3.543859649122807
757,3,2,-1,888467592,888467666,74,58,125,3.5555555555555554
757,2,2,0,888467666,888467765,99,125,658,3.393939393939394
757,2,3,1,888467765,888467794,29,658,28,3.923076923076923
757,3,3,0,888467794,888467829,35,28,732,3.6266666666666665
757,3,4,1,888467829,888467855,26,732,179,3.8823529411764706
757,4,5,1,888467855,888468540,685,179,549,3.4871794871794872
757,5,4,-1,888468540,888468577,37,549,204,3.6744186046511627
757,4,3,-1,888468577,888468596,19,204,385,3.6129032258064515
757,3,2,-1,888468596,888468632,36,385,207,3.4761904761904763
757,2,4,2,888468632,888468756,124,207,168,4.0476190476190474
757,4,3,-1,888468756,888468871,115,168,638,3.923076923076923
757,3,3,0,888468871,888468909,38,638,161,3.5844155844155843
757,3,3,0,888468909,888468995,86,161,153,3.7865168539325844
757,3,3,0,888468995,888469012,17,153,576,3.125
757,3,2,-1,888469012,888469113,101,576,1035,3.03125
757,2,3,1,888469113,888469286,173,1035,328,3.4895833333333335
752,4,4,0,891207845,891207898,53,904,272,4.2
752,4,4,0,891207898,891207939,41,272,1243,3.6666666666666665
752,4,1,-3,891207939,891207940,1,1243,286,3.442857142857143
752,1,4,3,891207940,891207983,43,286,346,3.5128205128205128
752,4,2,-2,891207983,891208036,53,346,268,3.9838709677419355
752,2,4,2,891208036,891208077,41,268,270,3.7804878048780486
752,4,3,-1,891208077,891208126,49,270,300,3.6861313868613137
752,3,4,1,891208126,891208170,44,300,332,3.6511627906976742
752,4,4,0,891208170,891208212,42,332,751,3.3896103896103895
752,4,4,0,891208212,891208213,1,751,348,3.2
752,4,1,-3,891208213,891208261,48,348,322,3.0476190476190474
752,1,1,0,891208261,891208299,38,322,326,3.262295081967213
752,1,3,2,891208299,891208329,30,326,316,4.285714285714286
752,3,4,1,891208329,891208357,28,316,350,3.2
752,4,4,0,891208357,891208392,35,350,748,3.1043478260869564
752,4,5,1,891208392,891208451,59,748,306,4.033333333333333
752,5,5,0,891208451,891208452,1,306,271,3.3134328358208953
752,5,1,-4,891208452,891208491,39,271,621,2.75
758,5,3,-2,880672257,880672345,88,262,340,3.7419354838709675
758,3,3,0,880672345,880672402,57,340,310,3.6666666666666665
758,3,3,0,880672402,880672427,25,310,301,3.2465753424657535
758,3,5,2,880672427,880672523,96,301,294,3.1052631578947367
758,5,3,-2,880672523,880672552,29,294,890,1.7692307692307692
758,3,5,2,880672552,880672637,85,890,127,4.162790697674419
758,5,5,0,880672637,880672700,63,127,257,3.7154471544715446
758,5,3,-2,880672700,880672727,27,257,293,3.630434782608696
758,3,2,-1,880672727,880672747,20,293,536,3.3333333333333335
758,2,5,3,880672747,880672766,19,536,1142,4.0476190476190474
758,5,4,-1,880672766,880672782,16,1142,249,3.3275862068965516
758,4,3,-1,880672782,880672830,48,249,252,2.911392405063291
758,3,4,1,880672830,880672876,46,252,1283,2.9
758,4,1,-3,880672876,881295176,622300,1283,689,3.1538461538461537
758,1,4,3,881295176,881974742,679566,689,427,4.2025316455696204
758,4,5,1,881974742,881974823,81,427,177,3.875
758,5,4,-1,881974823,881974880,57,177,172,4.225225225225225
758,4,2,-2,881974880,881974931,51,172,39,3.107142857142857
758,2,5,3,881974931,881975005,74,39,174,4.253521126760563
758,5,4,-1,881975005,881975061,56,174,654,4.119047619047619
758,4,5,1,881975061,881975118,57,654,209,3.8275862068965516
758,5,5,0,881975118,881975119,1,209,223,4.108695652173913
758,5,5,0,881975119,881975213,94,223,657,4.341463414634147
758,5,3,-2,881975213,881975243,30,657,131,3.731707317073171
758,3,5,2,881975243,881975267,24,131,154,3.6031746031746033
758,5,3,-2,881975267,881975289,22,154,11,3.8904109589041096
758,3,5,2,881975289,881975314,25,11,143,3.56
758,5,5,0,881975314,881975472,158,143,547,3.6666666666666665
758,5,5,0,881975472,881975503,31,547,1085,4.0
758,5,5,0,881975503,881975538,35,1085,238,3.888888888888889
758,5,5,0,881975538,881975539,1,238,137,3.9545454545454546
758,5,5,0,881975539,881975577,38,137,483,4.475609756097561
758,5,4,-1,881975577,881975687,110,483,462,3.7954545454545454
758,4,4,0,881975687,881975736,49,462,211,3.958904109589041
758,4,4,0,881975736,881975787,51,211,204,3.6744186046511627
758,4,4,0,881975787,881975814,27,204,421,3.462962962962963
758,4,5,1,881975814,881975815,1,421,81,3.2857142857142856
758,5,5,0,881975815,881975853,38,81,152,3.6785714285714284
758,5,5,0,881975853,881975922,69,152,482,3.9444444444444446
758,5,4,-1,881975922,881975962,40,482,129,3.744186046511628
758,4,4,0,881975962,881975990,28,129,28,3.923076923076923
758,4,3,-1,881975990,881976031,41,28,496,4.094594594594595
758,3,5,2,881976031,881976032,1,496,607,4.136363636363637
758,5,5,0,881976032,881976089,57,607,474,4.172413793103448
758,5,4,-1,881976089,881976168,79,474,742,3.5555555555555554
758,4,4,0,881976168,881976203,35,742,117,3.689189189189189
758,4,3,-1,881976203,881976233,30,117,434,3.588235294117647
758,3,5,2,881976233,881976289,56,434,98,4.240875912408759
758,5,3,-2,881976289,881976335,46,98,221,3.6923076923076925
758,3,4,1,881976335,881976377,42,221,837,4.0
758,4,3,-1,881976377,881976574,197,837,239,3.423076923076923
758,3,4,1,881976574,881976745,171,239,428,3.744186046511628
758,4,5,1,881976745,881976746,1,428,968,3.75
758,5,5,0,881976746,881976820,74,968,433,3.8035714285714284
758,5,5,0,881976820,881976821,1,433,202,3.730337078651685
758,5,5,0,881976821,881976855,34,202,735,3.58
758,5,4,-1,881976855,881976919,64,735,212,3.230769230769231
758,4,5,1,881976919,881976985,66,212,96,3.9130434782608696
758,5,4,-1,881976985,881977057,72,96,732,3.6266666666666665
758,4,4,0,881977057,881977108,51,732,26,3.36
758,4,3,-1,881977108,881977109,1,26,241,3.5625
758,3,3,0,881977109,881977169,60,241,66,3.4705882352941178
758,3,4,1,881977169,881977205,36,66,619,3.4782608695652173
758,4,4,0,881977205,881977229,24,619,196,3.9404761904761907
758,4,4,0,881977229,881977309,80,196,455,3.1702127659574466
758,4,4,0,881977309,881977375,66,455,1111,4.0
758,4,3,-1,881977375,881977408,33,1111,159,3.3902439024390243
758,3,4,1,881977408,881977488,80,159,566,3.543859649122807
758,4,3,-1,881977488,881977533,45,566,713,3.5
758,3,4,1,881977533,881977669,136,713,568,3.5853658536585367
758,4,4,0,881977669,881977747,78,568,541,2.9473684210526314
758,4,5,1,881977747,881978016,269,541,203,3.826923076923077
758,5,4,-1,881978016,881978115,99,203,550,3.272727272727273
758,4,4,0,881978115,881978148,33,550,208,3.8125
758,4,3,-1,881978148,881978258,110,208,1501,3.0
758,3,3,0,881978258,881978259,1,1501,386,2.769230769230769
758,3,5,2,881978259,881978274,15,386,235,3.106382978723404
758,5,2,-3,881978274,881978326,52,235,118,3.2764227642276422
758,2,2,0,881978326,881978495,169,118,542,2.888888888888889
758,2,3,1,881978495,881978572,77,542,802,3.076923076923077
758,3,4,1,881978572,881978635,63,802,405,3.25
758,4,4,0,881978635,881978805,170,405,448,3.466666666666667
758,4,3,-1,881978805,881978864,59,448,737,3.12
758,3,5,2,881978864,881979012,148,737,505,4.0625
758,5,4,-1,881979012,881979609,597,505,529,4.142857142857143
758,4,5,1,881979609,881979788,179,529,384,2.7941176470588234
758,5,4,-1,881979788,881979891,103,384,24,3.3728813559322033
758,4,4,0,881979891,881979969,78,24,997,2.7142857142857144
758,4,5,1,881979969,881979987,18,997,685,3.2666666666666666
758,5,5,0,881979987,881980034,47,685,922,4.0
758,5,3,-2,881980034,881980195,161,922,810,2.9473684210526314
758,3,2,-1,881980195,881980315,120,810,765,3.0
758,2,3,1,881980315,881980386,71,765,391,2.4285714285714284
758,3,3,0,881980386,882053499,73113,391,420,3.5652173913043477
758,3,4,1,882053499,882053613,114,420,53,2.9523809523809526
758,4,4,0,882053613,882053726,113,53,864,3.2142857142857144
758,4,4,0,882053726,882053834,108,864,139,2.7222222222222223
758,4,3,-1,882053834,882054049,215,139,77,3.3857142857142857
758,3,1,-2,882054049,882054226,177,77,155,3.0588235294117645
758,1,3,2,882054226,882054250,24,155,1047,2.6923076923076925
758,3,1,-2,882054250,882054297,47,1047,1074,2.857142857142857
758,1,4,3,882054297,882054415,118,1074,831,2.6097560975609757
758,4,3,-1,882054415,882054468,53,831,452,2.6129032258064515
758,3,1,-2,882054468,882054519,51,452,764,3.1176470588235294
758,1,3,2,882054519,882054797,278,764,441,2.4
758,3,3,0,882054797,882054854,57,441,826,2.5555555555555554
758,3,4,1,882054854,882054936,82,826,571,2.5
758,4,3,-1,882054936,882055007,71,571,554,2.9555555555555557
758,3,4,1,882055007,882055054,47,554,576,3.125
758,4,3,-1,882055054,882055193,139,576,841,2.772727272727273
758,3,5,2,882055193,882055227,34,841,1001,2.6666666666666665
758,5,3,-2,882055227,882055289,62,1001,388,2.5833333333333335
758,3,2,-1,882055289,882055347,58,388,977,2.473684210526316
758,2,5,3,882055347,882055497,150,977,1052,2.4545454545454546
758,5,2,-3,882055497,882055987,490,1052,343,3.0
758,2,2,0,882055987,882055988,1,343,665,2.72972972972973
758,2,4,2,882055988,882056007,19,665,288,3.5214285714285714
758,4,4,0,882056007,882322862,266855,288,331,3.5517241379310347
758,4,3,-1,882322862,883190351,867489,331,312,3.0
758,3,5,2,883190351,888020827,4830476,312,316,4.285714285714286
732,5,5,0,882589593,882589626,33,286,690,3.260869565217391
732,5,5,0,882589626,882589792,166,690,304,3.5306122448979593
732,5,5,0,882589792,882589819,27,304,882,3.6666666666666665
732,5,5,0,882589819,882589845,26,882,873,2.7586206896551726
732,5,5,0,882589845,882589879,34,873,243,2.357142857142857
732,5,4,-1,882589879,882589967,88,243,937,3.5
732,4,3,-1,882589967,882590201,234,937,289,2.988888888888889
762,4,1,-3,878718855,878719186,331,270,116,3.6666666666666665
762,1,5,4,878719186,878719219,33,116,475,3.956043956043956
762,5,1,-4,878719219,878719324,105,475,1662,1.0
762,1,4,3,878719324,878719371,47,1662,274,3.5609756097560976
762,4,3,-1,878719371,878719448,77,274,256,3.5
762,3,5,2,878719448,878719533,85,256,173,4.1441441441441444
762,5,5,0,878719533,878719551,18,173,955,3.2666666666666666
762,5,3,-2,878719551,878719594,43,955,709,4.171428571428572
744,4,4,0,881170452,881170528,76,156,428,3.744186046511628
744,4,5,1,881170528,881170575,47,428,657,4.341463414634147
744,5,5,0,881170575,881170576,1,657,963,3.9285714285714284
744,5,4,-1,881170576,881171421,845,963,174,4.253521126760563
744,4,4,0,881171421,881171452,31,174,483,4.475609756097561
744,4,5,1,881171452,881171481,29,483,127,4.162790697674419
744,5,3,-2,881171481,881171482,1,127,1134,2.888888888888889
744,3,4,1,881171482,881171839,357,1134,307,3.6031746031746033
744,4,3,-1,881171839,881171857,18,307,301,3.2465753424657535
744,3,4,1,881171857,881171907,50,301,276,3.6036036036036037
744,4,4,0,881171907,881171926,19,276,1,3.902439024390244
754,3,2,-1,879450984,879451010,26,328,340,3.7419354838709675
754,2,4,2,879451010,879451061,51,340,937,3.5
754,4,1,-3,879451061,879451163,102,937,243,2.357142857142857
754,1,3,2,879451163,879451191,28,243,307,3.6031746031746033
754,3,3,0,879451191,879451299,108,307,359,3.8
754,3,4,1,879451299,879451420,121,359,127,4.162790697674419
754,4,4,0,879451420,879451466,46,127,293,3.630434782608696
754,4,3,-1,879451466,879451516,50,293,273,3.5238095238095237
754,3,4,1,879451516,879451517,1,273,619,3.4782608695652173
754,4,3,-1,879451517,879451585,68,619,255,3.2027027027027026
754,3,4,1,879451585,879451626,41,255,295,3.769230769230769
754,4,4,0,879451626,879451742,116,295,476,3.1216216216216215
754,4,5,1,879451742,879451743,1,476,15,3.725663716814159
754,5,5,0,879451743,879451775,32,15,477,3.1666666666666665
754,5,4,-1,879451775,879451804,29,477,282,3.610526315789474
754,4,3,-1,879451804,879451805,1,282,237,3.7315436241610738
754,3,3,0,879451805,879451841,36,237,1197,3.625
754,3,3,0,879451841,879451958,117,1197,292,3.6666666666666665
754,3,3,0,879451958,879451991,33,292,742,3.5555555555555554
754,3,3,0,879451991,879452116,125,742,819,2.6666666666666665
753,3,5,2,891399477,891399737,260,286,294,3.1052631578947367
753,5,4,-1,891399737,891399903,166,294,316,4.285714285714286
753,4,5,1,891399903,891401366,1463,316,98,4.240875912408759
753,5,3,-2,891401366,891401410,44,98,185,3.9726027397260273
753,3,4,1,891401410,891401457,47,185,510,3.823529411764706
753,4,4,0,891401457,891401510,53,510,462,3.7954545454545454
753,4,5,1,891401510,891401712,202,462,515,4.202898550724638
753,5,5,0,891401712,891401757,45,515,484,4.116279069767442
753,5,1,-4,891401757,891401851,94,484,195,3.9072164948453607
753,1,4,3,891401851,891401901,50,195,357,4.063291139240507
753,4,4,0,891401901,891401902,1,357,50,4.306532663316583
753,4,5,1,891401902,891402272,370,50,215,3.662921348314607
753,5,4,-1,891402272,891402379,107,215,64,4.373737373737374
763,4,4,0,878914968,878915015,47,98,200,3.8157894736842106
763,4,4,0,878915015,878915063,48,200,191,4.168674698795181
763,4,5,1,878915063,878915628,565,191,61,4.190476190476191
763,5,3,-2,878915628,878915692,64,61,47,3.5869565217391304
763,3,4,1,878915692,878915722,30,47,475,3.956043956043956
763,4,3,-1,878915722,878915765,43,475,28,3.923076923076923
763,3,2,-1,878915765,878915766,1,28,819,2.6666666666666665
763,2,4,2,878915766,878915958,192,819,960,3.0
763,4,2,-2,878915958,878917433,1475,960,955,3.2666666666666666
763,2,4,2,878917433,878918360,927,955,39,3.107142857142857
763,4,5,1,878918360,878918406,46,39,222,3.578125
763,5,4,-1,878918406,878918908,502,222,1129,3.4444444444444446
763,4,4,0,878918908,878918933,25,1129,507,3.6285714285714286
763,4,4,0,878918933,878918960,27,507,85,3.3157894736842106
763,4,4,0,878918960,878919019,59,85,174,4.253521126760563
763,4,3,-1,878919019,878919083,64,174,1098,3.533333333333333
763,3,5,2,878919083,878919116,33,1098,56,4.051724137931035
763,5,3,-2,878919116,878919153,37,56,97,3.7282608695652173
763,3,4,1,878919153,878919180,27,97,518,3.5833333333333335
763,4,4,0,878919180,878919206,26,518,505,4.0625
763,4,4,0,878919206,878921530,2324,505,418,3.825
763,4,4,0,878921530,878921584,54,418,742,3.5555555555555554
763,4,2,-2,878921584,878922982,1398,742,738,3.0
763,2,3,1,878922982,878923322,340,738,125,3.5555555555555554
763,3,4,1,878923322,878923433,111,125,162,3.4651162790697674
763,4,5,1,878923433,878923456,23,162,730,3.8
763,5,4,-1,878923456,878923513,57,730,1039,3.9583333333333335
763,4,3,-1,878923513,878923609,96,1039,133,3.7777777777777777
764,1,4,3,876233034,876242851,9817,321,275,4.087912087912088
764,4,4,0,876242851,876242912,61,275,151,3.6544117647058822
764,4,4,0,876242912,876242972,60,151,845,3.661290322580645
764,4,2,-2,876242972,876243015,43,845,25,3.3185840707964602
764,2,3,1,876243015,876243046,31,25,596,3.180327868852459
764,3,4,1,876243046,876243159,113,596,7,3.76056338028169
764,4,4,0,876243159,876243291,132,7,282,3.610526315789474
764,4,4,0,876243291,876243343,52,282,278,3.0357142857142856
764,4,3,-1,876243343,876243410,67,278,742,3.5555555555555554
764,3,4,1,876243410,876243440,30,742,237,3.7315436241610738
764,4,3,-1,876243440,876243465,25,237,696,3.138888888888889
764,3,4,1,876243465,876243595,130,696,111,3.5106382978723403
764,4,4,0,876243595,876243703,108,111,595,2.9166666666666665
764,4,4,0,876243703,876243772,69,595,405,3.25
764,4,2,-2,876243772,876243794,22,405,21,2.9210526315789473
764,2,4,2,876243794,876243795,1,21,125,3.5555555555555554
764,4,3,-1,876243795,876243854,59,125,281,3.2
764,3,3,0,876243854,876243925,71,281,472,2.984375
764,3,3,0,876243925,876243953,28,472,820,3.0444444444444443
764,3,2,-1,876243953,876243990,37,820,106,2.8125
764,2,3,1,876243990,876244023,33,106,252,2.911392405063291
764,3,4,1,876244023,876244181,158,252,1028,2.857142857142857
764,4,4,0,876244181,876244559,378,1028,70,3.5833333333333335
764,4,3,-1,876244559,876244688,129,70,191,4.168674698795181
764,3,3,0,876244688,876244856,168,191,2,3.0851063829787235
764,3,4,1,876244856,876244895,39,2,200,3.8157894736842106
764,4,5,1,876244895,876244991,96,200,117,3.689189189189189
764,5,4,-1,876244991,876245069,78,117,28,3.923076923076923
764,4,3,-1,876245069,876245383,314,28,173,4.1441441441441444
764,3,5,2,876245383,876245421,38,173,432,3.719298245614035
764,5,5,0,876245421,876245475,54,432,174,4.253521126760563
764,5,4,-1,876245475,876245520,45,174,216,3.8454545454545452
764,4,4,0,876245520,876245880,360,216,939,3.6333333333333333
764,4,3,-1,876245880,876245940,60,939,140,3.238095238095238
764,3,4,1,876245940,876246312,372,140,202,3.730337078651685
764,4,4,0,876246312,876246358,46,202,692,3.56
764,4,3,-1,876246358,876246436,78,692,371,3.0
764,3,3,0,876246436,876246475,39,371,732,3.6266666666666665
764,3,4,1,876246475,876246504,29,732,673,3.393939393939394
764,4,4,0,876246504,876246555,51,673,946,3.1153846153846154
764,4,4,0,876246555,876246687,132,946,77,3.3857142857142857
764,4,3,-1,876246687,876752289,505602,77,276,3.6036036036036037
767,5,4,-1,891462560,891462614,54,98,22,4.215909090909091
767,4,4,0,891462614,891462658,44,22,724,3.64
767,4,4,0,891462658,891462759,101,724,28,3.923076923076923
767,4,4,0,891462759,891462870,111,28,141,3.4827586206896552
767,4,4,0,891462870,891462917,47,141,657,4.341463414634147
767,4,4,0,891462917,891463095,178,657,615,3.8333333333333335
769,2,4,2,885422821,885423720,899,748,1,3.902439024390244
769,4,4,0,885423720,885423865,145,1,121,3.521212121212121
769,4,3,-1,885423865,885423954,89,121,237,3.7315436241610738
769,3,3,0,885423954,885424186,232,237,1028,2.857142857142857
769,3,2,-1,885424186,885424214,28,1028,405,3.25
769,2,4,2,885424214,885424242,28,405,546,2.9789473684210526
769,4,3,-1,885424242,885424305,63,546,685,3.2666666666666666
769,3,3,0,885424305,885424337,32,685,473,2.9166666666666665
769,3,1,-2,885424337,885424401,64,473,120,2.3421052631578947
769,1,4,3,885424401,885424462,61,120,934,3.0294117647058822
769,4,2,-2,885424462,885424511,49,934,824,2.590909090909091
769,2,1,-1,885424511,885424534,23,824,831,2.6097560975609757
769,1,2,1,885424534,885424730,196,831,1322,2.5
769,2,2,0,885424730,885424776,46,1322,1312,2.8333333333333335
755,1,1,0,882569732,882569844,112,881,872,3.0
755,1,3,2,882569844,882569845,1,872,887,3.5789473684210527
755,3,4,1,882569845,882569881,36,887,328,3.4895833333333335
755,4,1,-3,882569881,882569912,31,328,289,2.988888888888889
755,1,1,0,882569912,882570023,111,289,875,2.736842105263158
755,1,4,3,882570023,882570077,54,875,323,3.0
755,4,3,-1,882570077,882570140,63,323,259,2.492063492063492
771,5,5,0,880659302,880659303,1,408,15,3.725663716814159
771,5,5,0,880659303,880659323,20,15,258,3.7547169811320753
771,5,4,-1,880659323,880659347,24,258,50,4.306532663316583
771,4,5,1,880659347,880659392,45,50,275,4.087912087912088
771,5,5,0,880659392,880659449,57,275,1,3.902439024390244
771,5,1,-4,880659449,880659482,33,1,203,3.826923076923077
771,1,4,3,880659482,880659507,25,203,652,3.9642857142857144
771,4,5,1,880659507,880659539,32,652,86,3.869565217391304
771,5,5,0,880659539,880659583,44,86,8,3.903225806451613
771,5,5,0,880659583,880659606,23,8,69,3.8015873015873014
771,5,4,-1,880659606,880659653,47,69,181,3.98974358974359
771,4,2,-2,880659653,880659686,33,181,82,3.6741573033707864
771,2,1,-1,880659686,880659729,43,82,79,3.956989247311828
771,1,1,0,880659729,880659748,19,79,4,3.5538461538461537
771,1,4,3,880659748,880659769,21,4,403,3.298507462686567
771,4,1,-3,880659769,880659791,22,403,241,3.5625
771,1,4,3,880659791,880659815,24,241,596,3.180327868852459
771,4,4,0,880659815,880659834,19,596,542,2.888888888888889
771,4,4,0,880659834,880659867,33,542,768,3.238095238095238
771,4,5,1,880659867,880659894,27,768,709,4.171428571428572
771,5,4,-1,880659894,880659941,47,709,274,3.5609756097560976
771,4,1,-3,880659941,880659990,49,274,98,4.240875912408759
771,1,2,1,880659990,880660025,35,98,164,3.6140350877192984
771,2,5,3,880660025,880660106,81,164,1129,3.4444444444444446
771,5,4,-1,880660106,880660199,93,1129,993,3.4838709677419355
771,4,3,-1,880660199,886635816,5975617,993,873,2.7586206896551726
771,3,5,2,886635816,886640606,4790,873,892,2.9615384615384617
771,5,3,-2,886640606,886640629,23,892,243,2.357142857142857
768,2,3,1,880135923,880135943,20,151,16,3.411764705882353
768,3,3,0,880135943,880135963,20,16,815,3.135135135135135
768,3,4,1,880135963,880135987,24,815,282,3.610526315789474
768,4,4,0,880135987,880136012,25,282,257,3.7154471544715446
768,4,3,-1,880136012,880136033,21,257,742,3.5555555555555554
768,3,3,0,880136033,880136139,106,742,111,3.5106382978723403
768,3,4,1,880136139,880136157,18,111,25,3.3185840707964602
768,4,3,-1,880136157,880136174,17,25,628,3.573529411764706
768,3,3,0,880136174,880136201,27,628,274,3.5609756097560976
768,3,3,0,880136201,880136317,116,274,252,2.911392405063291
768,3,2,-1,880136317,880136410,93,252,620,3.0
768,2,3,1,880136410,883834776,3698366,620,682,3.0476190476190474
768,3,2,-1,883834776,883834814,38,682,1016,3.559322033898305
768,2,4,2,883834814,883834883,69,1016,405,3.25
768,4,5,1,883834883,883835025,142,405,1,3.902439024390244
768,5,5,0,883835025,883835026,1,1,14,4.101694915254237
768,5,5,0,883835026,883835053,27,14,173,4.1441441441441444
768,5,2,-3,883835053,883835210,157,173,475,3.956043956043956
773,2,4,2,888538175,888538249,74,887,268,3.9838709677419355
773,4,3,-1,888538249,888538269,20,268,324,3.2291666666666665
773,3,2,-1,888538269,888538348,79,324,260,2.4716981132075473
773,2,2,0,888538348,888538417,69,260,895,3.142857142857143
773,2,2,0,888538417,888538438,21,895,948,2.2962962962962963
773,2,3,1,888538438,888538533,95,948,475,3.956043956043956
773,3,3,0,888538533,888538573,40,475,251,3.8333333333333335
773,3,4,1,888538573,888538643,70,251,547,3.6666666666666665
773,4,3,-1,888538643,888538677,34,547,24,3.3728813559322033
773,3,2,-1,888538677,888538726,49,24,855,3.590909090909091
773,2,4,2,888538726,888538776,50,855,45,4.130434782608695
773,4,5,1,888538776,888538810,34,45,179,3.8823529411764706
773,5,3,-2,888538810,888538829,19,179,382,3.764705882352941
773,3,4,1,888538829,888538908,79,382,958,4.2
773,4,5,1,888538908,888538931,23,958,60,4.105263157894737
773,5,3,-2,888538931,888538950,19,60,652,3.9642857142857144
773,3,4,1,888538950,888538995,45,652,509,3.7058823529411766
773,4,5,1,888538995,888539011,16,509,1021,3.8666666666666667
773,5,4,-1,888539011,888539027,16,1021,1475,4.0
773,4,3,-1,888539027,888539064,37,1475,737,3.12
773,3,3,0,888539064,888539095,31,737,1018,3.0714285714285716
773,3,5,2,888539095,888539120,25,1018,1529,3.0
773,5,5,0,888539120,888539232,112,1529,408,4.4772727272727275
773,5,3,-2,888539232,888539256,24,408,1240,3.5454545454545454
773,3,2,-1,888539256,888539273,17,1240,240,3.0350877192982457
773,2,4,2,888539273,888539328,55,240,109,3.282608695652174
773,4,4,0,888539328,888539347,19,109,238,3.888888888888889
773,4,3,-1,888539347,888539366,19,238,93,3.5641025641025643
773,3,5,2,888539366,888539425,59,93,168,4.0476190476190474
773,5,4,-1,888539425,888539471,46,168,13,3.5454545454545454
773,4,3,-1,888539471,888539492,21,13,732,3.6266666666666665
773,3,4,1,888539492,888539512,20,732,239,3.423076923076923
773,4,3,-1,888539512,888539531,19,239,72,3.175438596491228
773,3,2,-1,888539531,888539576,45,72,367,3.4242424242424243
773,2,4,2,888539576,888539608,32,367,959,3.4583333333333335
773,4,2,-2,888539608,888539662,54,959,1071,3.0
773,2,4,2,888539662,888539677,15,1071,235,3.106382978723404
773,4,3,-1,888539677,888539711,34,235,1170,3.1666666666666665
773,3,2,-1,888539711,888539766,55,1170,384,2.7941176470588234
773,2,3,1,888539766,888539825,59,384,790,2.8518518518518516
773,3,2,-1,888539825,888539842,17,790,1188,2.45
773,2,4,2,888539842,888539875,33,1188,364,2.8095238095238093
773,4,3,-1,888539875,888539907,32,364,1036,3.0
773,3,3,0,888539907,888539962,55,1036,174,4.253521126760563
773,3,2,-1,888539962,888539963,1,174,11,3.8904109589041096
773,2,2,0,888539963,888539992,29,11,7,3.76056338028169
773,2,4,2,888539992,888540020,28,7,89,3.9615384615384617
773,4,2,-2,888540020,888540041,21,89,184,3.393939393939394
773,2,2,0,888540041,888540063,22,184,96,3.9130434782608696
773,2,3,1,888540063,888540146,83,96,232,3.0789473684210527
773,3,3,0,888540146,888540147,1,232,53,2.9523809523809526
773,3,2,-1,888540147,888540163,16,53,121,3.521212121212121
773,2,2,0,888540163,888540186,23,121,231,2.938775510204082
773,2,2,0,888540186,888540187,1,231,665,2.72972972972973
773,2,4,2,888540187,888540279,92,665,200,3.8157894736842106
773,4,2,-2,888540279,888540295,16,200,218,3.5555555555555554
773,2,2,0,888540295,888540314,19,218,559,3.477272727272727
773,2,1,-1,888540314,888540390,76,559,769,2.2222222222222223
773,1,4,3,888540390,888540467,77,769,32,3.7222222222222223
773,4,3,-1,888540467,888540484,17,32,427,4.2025316455696204
773,3,4,1,888540484,888540507,23,427,64,4.373737373737374
773,4,5,1,888540507,888540617,110,64,59,4.0
773,5,4,-1,888540617,888540618,1,59,1555,3.5
765,4,2,-2,880346282,880346340,58,283,222,3.578125
765,2,4,2,880346340,880346418,78,222,25,3.3185840707964602
765,4,4,0,880346418,880346466,48,25,847,3.7333333333333334
765,4,2,-2,880346466,880346491,25,847,15,3.725663716814159
765,2,5,3,880346491,880346606,115,15,1009,3.2962962962962963
765,5,5,0,880346606,880346694,88,1009,285,4.181818181818182
765,5,5,0,880346694,880346722,28,285,127,4.162790697674419
765,5,4,-1,880346722,880346768,46,127,275,4.087912087912088
765,4,3,-1,880346768,880346797,29,275,237,3.7315436241610738
765,3,5,2,880346797,880346854,57,237,170,4.242424242424242
765,5,4,-1,880346854,880346911,57,170,971,4.0
765,4,5,1,880346911,880346951,40,971,522,3.8461538461538463
765,5,5,0,880346951,880347034,83,522,507,3.6285714285714286
772,5,4,-1,876250551,877533546,1282995,328,678,2.8181818181818183
772,4,4,0,877533546,877533625,79,678,294,3.1052631578947367
772,4,4,0,877533625,877533731,106,294,300,3.6861313868613137
772,4,4,0,877533731,877533873,142,300,327,3.5076923076923077
772,4,2,-2,877533873,877533957,84,327,259,2.492063492063492
772,2,4,2,877533957,889028692,11494735,259,354,3.6923076923076925
772,4,4,0,889028692,889028773,81,354,307,3.6031746031746033
772,4,3,-1,889028773,889028941,168,307,898,3.0869565217391304
766,2,4,2,891307007,891308968,1961,294,519,4.291666666666667
766,4,3,-1,891308968,891309052,84,519,172,4.225225225225225
766,3,4,1,891309052,891309053,1,172,50,4.306532663316583
766,4,3,-1,891309053,891309117,64,50,482,3.9444444444444446
766,3,3,0,891309117,891309118,1,482,175,3.8354430379746836
766,3,4,1,891309118,891309146,28,175,520,4.136363636363637
766,4,4,0,891309146,891309177,31,520,23,3.9047619047619047
766,4,3,-1,891309177,891309250,73,23,215,3.662921348314607
766,3,4,1,891309250,891309261,11,215,173,4.1441441441441444
766,4,4,0,891309261,891309329,68,173,604,3.8181818181818183
766,4,3,-1,891309329,891309357,28,604,265,3.710144927536232
766,3,4,1,891309357,891309391,34,265,192,4.090909090909091
766,4,3,-1,891309391,891309421,30,192,1203,4.0
766,3,4,1,891309421,891309450,29,1203,238,3.888888888888889
766,4,4,0,891309450,891309484,34,238,183,3.951219512195122
766,4,4,0,891309484,891309558,74,183,234,3.7674418604651163
766,4,2,-2,891309558,891309589,31,234,664,3.15
766,2,2,0,891309589,891309667,78,664,214,3.272727272727273
766,2,4,2,891309667,891309668,1,214,69,3.8015873015873014
766,4,4,0,891309668,891309703,35,69,530,4.125
766,4,3,-1,891309703,891309736,33,530,497,3.35
766,3,3,0,891309736,891309810,74,497,99,3.8392857142857144
766,3,3,0,891309810,891309844,34,99,423,3.7016129032258065
766,3,3,0,891309844,891309878,34,423,518,3.5833333333333335
766,3,3,0,891309878,891309913,35,518,71,3.6575342465753424
766,3,4,1,891309913,891309947,34,71,633,3.9
766,4,5,1,891309947,891309975,28,633,205,3.717391304347826
766,5,4,-1,891309975,891310067,92,205,429,3.742857142857143
766,4,3,-1,891310067,891310125,58,429,499,4.0
766,3,3,0,891310125,891310150,25,499,226,3.378787878787879
766,3,4,1,891310150,891310210,60,226,198,4.04
766,4,3,-1,891310210,891310241,31,198,219,2.735294117647059
766,3,3,0,891310241,891310281,40,219,662,3.4583333333333335
766,3,2,-1,891310281,891310313,32,662,568,3.5853658536585367
766,2,3,1,891310313,891310337,24,568,679,3.2432432432432434
766,3,3,0,891310337,891310444,107,679,230,3.3518518518518516
766,3,2,-1,891310444,891310475,31,230,380,3.4878048780487805
766,2,2,0,891310475,891310508,33,380,1444,2.3333333333333335
766,2,4,2,891310508,891310540,32,1444,378,3.6904761904761907
766,4,3,-1,891310540,891310565,25,378,402,3.3076923076923075
766,3,2,-1,891310565,891310620,55,402,810,2.9473684210526314
766,2,4,2,891310620,891310650,30,810,217,3.1538461538461537
766,4,2,-2,891310650,891310704,54,217,72,3.175438596491228
766,2,3,1,891310704,891310772,68,72,630,3.25
766,3,2,-1,891310772,891310824,52,630,451,3.207792207792208
766,2,3,1,891310824,891310851,27,451,40,2.7037037037037037
766,3,3,0,891310851,891310875,24,40,366,3.4285714285714284
774,3,1,-2,888555829,888555864,35,1305,545,1.7142857142857142
774,1,3,2,888555864,888555897,33,545,175,3.8354430379746836
774,3,2,-1,888555897,888555928,31,175,56,4.051724137931035
774,2,1,-1,888555928,888555964,36,56,168,4.0476190476190474
774,1,3,2,888555964,888555998,34,168,194,4.029411764705882
774,3,5,2,888555998,888556046,48,194,778,3.5925925925925926
774,5,2,-3,888556046,888556047,1,778,367,3.4242424242424243
774,2,1,-1,888556047,888556090,43,367,428,3.744186046511628
774,1,1,0,888556090,888556121,31,428,692,3.56
774,1,1,0,888556121,888556169,48,692,712,3.0434782608695654
774,1,2,1,888556169,888556225,56,712,386,2.769230769230769
774,2,2,0,888556225,888556248,23,386,94,2.8823529411764706
774,2,1,-1,888556248,888556278,30,94,1182,2.4285714285714284
774,1,3,2,888556278,888556316,38,1182,204,3.6744186046511627
774,3,2,-1,888556316,888556398,82,204,515,4.202898550724638
774,2,5,3,888556398,888556434,36,515,519,4.291666666666667
774,5,3,-2,888556434,888556483,49,519,187,4.215189873417722
774,3,2,-1,888556483,888556484,1,187,510,3.823529411764706
774,2,3,1,888556484,888556517,33,510,215,3.662921348314607
774,3,4,1,888556517,888556544,27,215,69,3.8015873015873014
774,4,2,-2,888556544,888556545,1,69,673,3.393939393939394
774,2,3,1,888556545,888556600,55,673,135,3.7974683544303796
774,3,3,0,888556600,888556634,34,135,23,3.9047619047619047
774,3,3,0,888556634,888556659,25,23,52,3.727272727272727
774,3,1,-2,888556659,888556698,39,52,429,3.742857142857143
774,1,3,2,888556698,888556746,48,429,196,3.9404761904761907
774,3,2,-1,888556746,888556814,68,196,403,3.298507462686567
774,2,2,0,888556814,888556867,53,403,553,3.5
774,2,2,0,888556867,888556893,26,553,537,3.5
774,2,2,0,888556893,888556938,45,537,402,3.3076923076923075
774,2,2,0,888556938,888556968,30,402,468,3.380952380952381
774,2,2,0,888556968,888556989,21,468,365,2.95
774,2,4,2,888556989,888557198,209,365,176,3.967032967032967
774,4,4,0,888557198,888557237,39,176,228,3.7246376811594204
774,4,2,-2,888557237,888557276,39,228,96,3.9130434782608696
774,2,4,2,888557276,888557277,1,96,177,3.875
774,4,2,-2,888557277,888557329,52,177,568,3.5853658536585367
774,2,2,0,888557329,888557330,1,568,226,3.378787878787879
774,2,2,0,888557330,888557409,79,226,161,3.5844155844155843
774,2,1,-1,888557409,888557451,42,161,808,2.4444444444444446
774,1,1,0,888557451,888557482,31,808,449,2.9069767441860463
774,1,1,0,888557482,888557519,37,449,1110,2.85
774,1,2,1,888557519,888557520,1,1110,62,3.048780487804878
774,2,1,-1,888557520,888557556,36,62,554,2.9555555555555557
774,1,2,1,888557556,888557557,1,554,450,2.2758620689655173
774,2,4,2,888557557,888557682,125,450,98,4.240875912408759
774,4,2,-2,888557682,888557715,33,98,200,3.8157894736842106
774,2,4,2,888557715,888557739,24,200,219,2.735294117647059
774,4,1,-3,888557739,888557772,33,219,672,2.7222222222222223
774,1,2,1,888557772,888557804,32,672,573,2.909090909090909
774,2,1,-1,888557804,888557805,1,573,452,2.6129032258064515
774,1,2,1,888557805,888557857,52,452,569,2.4285714285714284
774,2,1,-1,888557857,888557883,26,569,563,2.0
774,1,2,1,888557883,888557987,104,563,189,3.88
774,2,1,-1,888557987,888558018,31,189,91,3.6
774,1,1,0,888558018,888558019,1,91,501,3.289473684210526
774,1,1,0,888558019,888558041,22,501,548,2.0
774,1,1,0,888558041,888558128,87,548,421,3.462962962962963
774,1,2,1,888558128,888558187,59,421,739,3.391304347826087
774,2,2,0,888558187,888558305,118,739,525,4.0
774,2,1,-1,888558305,888558343,38,525,44,3.1333333333333333
774,1,1,0,888558343,888558419,76,44,1090,2.3529411764705883
774,1,2,1,888558419,888558447,28,1090,203,3.826923076923077
774,2,2,0,888558447,888558539,92,203,7,3.76056338028169
774,2,1,-1,888558539,888558565,26,7,121,3.521212121212121
774,1,2,1,888558565,888558646,81,121,117,3.689189189189189
774,2,1,-1,888558646,888558762,116,117,741,3.3043478260869565
774,1,1,0,888558762,888558806,44,741,235,3.106382978723404
774,1,2,1,888558806,888558829,23,235,1028,2.857142857142857
774,2,1,-1,888558829,888558853,24,1028,866,3.3962264150943398
774,1,1,0,888558853,888558876,23,866,871,2.3823529411764706
774,1,1,0,888558876,888558897,21,871,1079,2.1923076923076925
774,1,3,2,888558897,888558924,27,1079,412,2.272727272727273
774,3,1,-2,888558924,888558946,22,412,926,2.7857142857142856
774,1,1,0,888558946,888559013,67,926,834,2.0
774,1,1,0,888559013,888559036,23,834,758,2.2857142857142856
774,1,3,2,888559036,888559123,87,758,250,3.4698795180722892
774,3,2,-1,888559123,888559297,174,250,920,3.0
774,2,3,1,888559297,888559437,140,920,12,4.358974358974359
760,1,5,4,875666064,875666110,46,819,845,3.661290322580645
760,5,3,-2,875666110,875666179,69,845,237,3.7315436241610738
760,3,2,-1,875666179,875666317,138,237,25,3.3185840707964602
760,2,3,1,875666317,875666375,58,25,255,3.2027027027027026
760,3,5,2,875666375,875667247,872,255,776,4.0
760,5,3,-2,875667247,875667294,47,776,172,4.225225225225225
760,3,2,-1,875667294,875667366,72,172,183,3.951219512195122
760,2,2,0,875667366,875667450,84,183,185,3.9726027397260273
760,2,3,1,875667450,875667834,384,185,202,3.730337078651685
760,3,4,1,875667834,875668219,385,202,604,3.8181818181818183
760,4,3,-1,875668219,875668418,199,604,162,3.4651162790697674
760,3,4,1,875668418,875668535,117,162,195,3.9072164948453607
760,4,5,1,875668535,875668781,246,195,451,3.207792207792208
760,5,4,-1,875668781,875668888,107,451,739,3.391304347826087
760,4,2,-2,875668888,875668932,44,739,66,3.4705882352941178
760,2,4,2,875668932,875668968,36,66,1135,3.0526315789473686
760,4,2,-2,875668968,875669011,43,1135,723,3.5384615384615383
760,2,1,-1,875669011,875669077,66,723,120,2.3421052631578947
760,1,4,3,875669077,875669114,37,120,375,2.076923076923077
761,4,3,-1,876189614,876189689,75,288,358,2.6551724137931036
761,3,5,2,876189689,876189775,86,358,1157,3.142857142857143
761,5,5,0,876189775,876189795,20,1157,50,4.306532663316583
761,5,1,-4,876189795,876189871,76,50,261,2.7333333333333334
761,1,2,1,876189871,876189913,42,261,688,2.111111111111111
761,2,2,0,876189913,876189931,18,688,877,2.619047619047619
761,2,3,1,876189931,876190025,94,877,127,4.162790697674419
761,3,5,2,876190025,876190072,47,127,181,3.98974358974359
761,5,1,-4,876190072,876190094,22,181,1,3.902439024390244
761,1,4,3,876190094,876190130,36,1,295,3.769230769230769
761,4,4,0,876190130,876190160,30,295,283,3.901639344262295
761,4,3,-1,876190160,876190182,22,283,235,3.106382978723404
761,3,4,1,876190182,876190206,24,235,7,3.76056338028169
761,4,1,-3,876190206,876190235,29,7,477,3.1666666666666665
761,1,1,0,876190235,876190256,21,477,1014,3.1
761,1,5,4,876190256,876190314,58,1014,117,3.689189189189189
761,5,3,-2,876190314,876190336,22,117,471,3.5714285714285716
761,3,2,-1,876190336,876190370,34,471,742,3.5555555555555554
761,2,2,0,876190370,876190394,24,742,151,3.6544117647058822
761,2,5,3,876190394,876190417,23,151,237,3.7315436241610738
761,5,2,-3,876190417,876190439,22,237,455,3.1702127659574466
761,2,5,3,876190439,876190468,29,455,546,2.9789473684210526
761,5,1,-4,876190468,876190510,42,546,214,3.272727272727273
761,1,1,0,876190510,876190511,1,214,1558,3.0
761,1,2,1,876190511,876190623,112,1558,1152,3.4375
761,2,4,2,876190623,876190689,66,1152,628,3.573529411764706
761,4,4,0,876190689,876190752,63,628,282,3.610526315789474
761,4,4,0,876190752,876190753,1,282,840,3.090909090909091
761,4,3,-1,876190753,876190770,17,840,291,3.2
761,3,4,1,876190770,876190798,28,291,125,3.5555555555555554
777,4,5,1,875979201,875979241,40,288,245,3.056179775280899
777,5,1,-4,875979241,875979380,139,245,100,4.0162162162162165
777,1,2,1,875979380,875979431,51,100,1079,2.1923076923076925
777,2,5,3,875979431,875980306,875,1079,180,3.9473684210526314
777,5,5,0,875980306,875980348,42,180,212,3.230769230769231
777,5,1,-4,875980348,875980391,43,212,127,4.162790697674419
777,1,4,3,875980391,875980449,58,127,509,3.7058823529411766
777,4,5,1,875980449,875980492,43,509,168,4.0476190476190474
777,5,4,-1,875980492,875980541,49,168,238,3.888888888888889
777,4,5,1,875980541,875980669,128,238,522,3.8461538461538463
777,5,5,0,875980669,875980670,1,522,56,4.051724137931035
759,5,5,0,875227708,875227798,90,294,742,3.5555555555555554
759,5,5,0,875227798,875227904,106,742,220,3.433333333333333
759,5,4,-1,875227904,875227922,18,220,756,2.6885245901639343
759,4,5,1,875227922,875227954,32,756,118,3.2764227642276422
759,5,5,0,875227954,881476590,6248636,118,328,3.4895833333333335
759,5,3,-2,881476590,881476616,26,328,245,3.056179775280899
759,3,2,-1,881476616,881476642,26,245,984,2.6666666666666665
759,2,4,2,881476642,881476756,114,984,937,3.5
759,4,4,0,881476756,881476824,68,937,257,3.7154471544715446
759,4,5,1,881476824,881476922,98,257,222,3.578125
759,5,4,-1,881476922,881476969,47,222,405,3.25
759,4,4,0,881476969,881476991,22,405,281,3.2
776,4,5,1,891628632,891628656,24,187,168,4.0476190476190474
776,5,4,-1,891628656,891628708,52,168,679,3.2432432432432434
776,4,5,1,891628708,891628731,23,679,483,4.475609756097561
776,5,4,-1,891628731,891628752,21,483,91,3.6
776,4,3,-1,891628752,891628773,21,91,196,3.9404761904761907
776,3,5,2,891628773,891628837,64,196,191,4.168674698795181
776,5,3,-2,891628837,891628895,58,191,193,3.883720930232558
776,3,5,2,891628895,891628916,21,193,514,4.033333333333333
776,5,4,-1,891628916,891628937,21,514,523,4.159090909090909
776,4,5,1,891628937,891628977,40,523,50,4.306532663316583
776,5,5,0,891628977,891629157,180,50,174,4.253521126760563
776,5,4,-1,891629157,892210460,581303,174,134,4.174603174603175
776,4,4,0,892210460,892210576,116,134,109,3.282608695652174
776,4,3,-1,892210576,892210668,92,109,355,2.75
776,3,4,1,892210668,892210723,55,355,588,3.8358208955223883
776,4,4,0,892210723,892313295,102572,588,276,3.6036036036036037
776,4,3,-1,892313295,892313317,22,276,21,2.9210526315789473
776,3,1,-2,892313317,892313489,172,21,241,3.5625
776,1,4,3,892313489,892920290,606801,241,185,3.9726027397260273
776,4,4,0,892920290,892920320,30,185,5,3.1481481481481484
776,4,3,-1,892920320,892920321,1,5,674,2.6875
776,3,4,1,892920321,892920350,29,674,436,3.5
776,4,4,0,892920350,892920351,1,436,559,3.477272727272727
776,4,4,0,892920351,892920381,30,559,200,3.8157894736842106
776,4,2,-2,892920381,892920403,22,200,441,2.4
776,2,2,0,892920403,892920423,20,441,444,2.6842105263157894
776,2,3,1,892920423,892920446,23,444,564,2.0
776,3,3,0,892920446,892920480,34,564,706,2.3333333333333335
776,3,2,-1,892920480,892920506,26,706,438,2.0
776,2,5,3,892920506,893077159,156653,438,661,4.133333333333334
780,3,4,1,891362937,891363073,136,300,339,2.7058823529411766
780,4,3,-1,891363073,891363259,186,339,294,3.1052631578947367
780,3,5,2,891363259,891363618,359,294,423,3.7016129032258065
780,5,5,0,891363618,891363651,33,423,204,3.6744186046511627
780,5,5,0,891363651,891363685,34,204,50,4.306532663316583
780,5,3,-2,891363685,891363723,38,50,657,4.341463414634147
780,3,5,2,891363723,891363783,60,657,174,4.253521126760563
780,5,4,-1,891363783,891363904,121,174,510,3.823529411764706
780,4,3,-1,891363904,891363933,29,510,604,3.8181818181818183
780,3,3,0,891363933,891363969,36,604,660,3.71875
780,3,4,1,891363969,891363996,27,660,164,3.6140350877192984
780,4,5,1,891363996,891364086,90,164,133,3.7777777777777777
780,5,5,0,891364086,891364124,38,133,318,4.5046728971962615
780,5,5,0,891364124,891364125,1,318,526,3.909090909090909
779,4,5,1,875501402,875501734,332,243,181,3.98974358974359
779,5,4,-1,875501734,875501782,48,181,15,3.725663716814159
779,4,4,0,875501782,875992442,490660,15,926,2.7857142857142856
779,4,4,0,875992442,875993201,759,926,257,3.7154471544715446
779,4,3,-1,875993201,875994401,1200,257,284,3.1547619047619047
779,3,4,1,875994401,875996932,2531,284,1028,2.857142857142857
778,5,4,-1,890670560,890670638,78,154,550,3.272727272727273
778,4,3,-1,890670638,890725776,55138,550,79,3.956989247311828
778,3,3,0,890725776,890725804,28,79,238,3.888888888888889
778,3,4,1,890725804,890725886,82,238,7,3.76056338028169
778,4,4,0,890725886,890725951,65,7,98,4.240875912408759
778,4,4,0,890725951,890726003,52,98,265,3.710144927536232
778,4,3,-1,890726003,890726190,187,265,568,3.5853658536585367
778,3,3,0,890726190,890726264,74,568,216,3.8454545454545452
778,3,4,1,890726264,890726303,39,216,239,3.423076923076923
778,4,4,0,890726303,890726618,315,239,28,3.923076923076923
778,4,3,-1,890726618,890727011,393,28,117,3.689189189189189
778,3,3,0,890727011,890727091,80,117,405,3.25
778,3,3,0,890727091,890727129,38,405,219,2.735294117647059
778,3,3,0,890727129,890727175,46,219,161,3.5844155844155843
778,3,4,1,890727175,890769370,42195,161,195,3.9072164948453607
778,4,2,-2,890769370,890769633,263,195,196,3.9404761904761907
778,2,4,2,890769633,890802724,33091,196,186,3.905263157894737
778,4,2,-2,890802724,890802784,60,186,629,3.3333333333333335
778,2,5,3,890802784,890802895,111,629,367,3.4242424242424243
778,5,3,-2,890802895,890803176,281,367,712,3.0434782608695654
778,3,3,0,890803176,890803561,385,712,121,3.521212121212121
778,3,1,-2,890803561,890803860,299,121,423,3.7016129032258065
778,1,2,1,890803860,890804025,165,423,230,3.3518518518518516
778,2,2,0,890804025,890804547,522,230,755,3.085714285714286
778,2,1,-1,890804547,890804607,60,755,1035,3.03125
778,1,1,0,890804607,890804625,18,1035,623,3.0454545454545454
778,1,1,0,890804625,891234406,429781,623,496,4.094594594594595
782,3,4,1,891497698,891497793,95,269,690,3.260869565217391
782,4,3,-1,891497793,891497854,61,690,344,4.0
782,3,3,0,891497854,891497963,109,344,900,4.2
782,3,4,1,891497963,891497964,1,900,895,3.142857142857143
782,4,3,-1,891497964,891498030,66,895,938,2.5555555555555554
782,3,2,-1,891498030,891498031,1,938,894,2.0
782,2,4,2,891498031,891498079,48,894,288,3.5214285714285714
782,4,3,-1,891498079,891498139,60,288,361,2.0
782,3,2,-1,891498139,891498213,74,361,271,3.3134328358208953
782,2,1,-1,891498213,891498267,54,271,259,2.492063492063492
782,1,3,2,891498267,891498322,55,259,908,2.5714285714285716
782,3,3,0,891498322,891498436,114,908,681,2.25
782,3,3,0,891498436,891498558,122,681,1191,3.0
782,3,3,0,891498558,891498720,162,1191,898,3.0869565217391304
782,3,3,0,891498720,891498766,46,898,885,2.3333333333333335
782,3,3,0,891498766,891498767,1,885,678,2.8181818181818183
782,3,4,1,891498767,891498791,24,678,905,3.357142857142857
782,4,2,-2,891498791,891498821,30,905,984,2.6666666666666665
782,2,1,-1,891498821,891498865,44,984,680,2.8333333333333335
782,1,2,1,891498865,891498918,53,680,688,2.111111111111111
782,2,3,1,891498918,891499243,325,688,1142,4.0476190476190474
782,3,4,1,891499243,891499278,35,1142,298,3.779220779220779
782,4,4,0,891499278,891499321,43,298,248,3.746268656716418
782,4,2,-2,891499321,891499344,23,248,1012,3.2916666666666665
782,2,3,1,891499344,891499399,55,1012,1608,2.25
782,3,1,-2,891499399,891499439,40,1608,1609,1.0
782,1,4,3,891499439,891499440,1,1609,250,3.4698795180722892
782,4,3,-1,891499440,891499469,29,250,535,3.380952380952381
782,3,2,-1,891499469,891499494,25,535,1378,2.5
782,2,2,0,891499494,891499556,62,1378,1598,2.0
782,2,2,0,891499556,891499577,21,1598,1528,2.0
782,2,3,1,891499577,891499611,34,1528,990,2.769230769230769
782,3,2,-1,891499611,891499660,49,990,1089,2.1363636363636362
782,2,2,0,891499660,891499700,40,1089,1663,2.0
782,2,3,1,891499700,891499829,129,1663,1254,2.4
782,3,3,0,891499829,891500028,199,1254,1251,3.5
782,3,3,0,891500028,891500066,38,1251,1252,3.0
782,3,3,0,891500066,891500067,1,1252,1668,3.0
782,3,3,0,891500067,891500109,42,1668,296,3.0
782,3,3,0,891500109,891500110,1,296,936,3.727272727272727
782,3,2,-1,891500110,891500150,40,936,256,3.5
782,2,2,0,891500150,891500151,1,256,533,3.6
782,2,2,0,891500151,891500193,42,533,1417,2.0
782,2,2,0,891500193,891500194,1,1417,1143,3.3333333333333335
782,2,1,-1,891500194,891500230,36,1143,1652,1.0
786,4,4,0,882841667,882841692,25,100,127,4.162790697674419
786,4,4,0,882841692,882841745,53,127,125,3.5555555555555554
786,4,4,0,882841745,882841772,27,125,275,4.087912087912088
786,4,4,0,882841772,882841828,56,275,1,3.902439024390244
786,4,3,-1,882841828,882841855,27,1,15,3.725663716814159
786,3,1,-2,882841855,882841875,20,15,276,3.6036036036036037
786,1,4,3,882841875,882841906,31,276,283,3.901639344262295
786,4,5,1,882841906,882841955,49,283,9,3.8878504672897196
786,5,4,-1,882841955,882841996,41,9,117,3.689189189189189
786,4,4,0,882841996,882842044,48,117,222,3.578125
786,4,3,-1,882842044,882842149,105,222,696,3.138888888888889
786,3,3,0,882842149,882842173,24,696,866,3.3962264150943398
786,3,5,2,882842173,882842195,22,866,237,3.7315436241610738
786,5,4,-1,882842195,882842311,116,237,405,3.25
786,4,2,-2,882842311,882842416,105,405,121,3.521212121212121
786,2,3,1,882842416,882842463,47,121,322,3.0476190476190474
786,3,4,1,882842463,882842946,483,322,497,3.35
786,4,4,0,882842946,882843006,60,497,86,3.869565217391304
786,4,4,0,882843006,882843039,33,86,143,3.56
786,4,4,0,882843039,882843112,73,143,187,4.215189873417722
786,4,5,1,882843112,882843150,38,187,423,3.7016129032258065
786,5,4,-1,882843150,882843190,40,423,692,3.56
786,4,4,0,882843190,882843237,47,692,633,3.9
786,4,4,0,882843237,882843272,35,633,191,4.168674698795181
786,4,4,0,882843272,882843352,80,191,418,3.825
786,4,5,1,882843352,882843397,45,418,95,3.8194444444444446
786,5,4,-1,882843397,882843398,1,95,484,4.116279069767442
786,4,3,-1,882843398,882843431,33,484,197,4.112676056338028
786,3,4,1,882843431,882843500,69,197,404,3.6578947368421053
786,4,3,-1,882843500,882843753,253,404,234,3.7674418604651163
786,3,5,2,882843753,882843786,33,234,71,3.6575342465753424
786,5,4,-1,882843786,882843812,26,71,202,3.730337078651685
786,4,4,0,882843812,882843925,113,202,204,3.6744186046511627
786,4,4,0,882843925,882844010,85,204,88,3.433734939759036
786,4,2,-2,882844010,882844052,42,88,849,2.5625
786,2,2,0,882844052,882844096,44,849,449,2.9069767441860463
786,2,2,0,882844096,882844127,31,449,231,2.938775510204082
786,2,2,0,882844127,882844171,44,231,451,3.207792207792208
786,2,4,2,882844171,882844294,123,451,174,4.253521126760563
786,4,4,0,882844294,882844295,1,174,228,3.7246376811594204
786,4,4,0,882844295,882844336,41,228,289,2.988888888888889
784,5,3,-2,891387155,891387249,94,269,321,3.0172413793103448
784,3,4,1,891387249,891387315,66,321,327,3.5076923076923077
784,4,4,0,891387315,891387316,1,327,751,3.3896103896103895
784,4,3,-1,891387316,891387501,185,751,268,3.9838709677419355
784,3,4,1,891387501,891387622,121,268,877,2.619047619047619
784,4,3,-1,891387622,891387623,1,877,312,3.0
784,3,4,1,891387623,891387895,272,312,678,2.8181818181818183
770,5,3,-2,875971612,875971655,43,300,358,2.6551724137931036
770,3,4,1,875971655,875971703,48,358,325,2.625
770,4,3,-1,875971703,875971736,33,325,328,3.4895833333333335
770,3,5,2,875971736,875971813,77,328,246,4.0
770,5,5,0,875971813,875971949,136,246,253,3.5
770,5,5,0,875971949,875971989,40,253,117,3.689189189189189
770,5,5,0,875971989,875972024,35,117,14,4.101694915254237
770,5,5,0,875972024,875972059,35,14,111,3.5106382978723403
770,5,4,-1,875972059,875972099,40,111,255,3.2027027027027026
770,4,3,-1,875972099,875972100,1,255,123,3.297872340425532
770,3,5,2,875972100,875972185,85,123,7,3.76056338028169
770,5,5,0,875972185,875972219,34,7,1,3.902439024390244
770,5,4,-1,875972219,875972259,40,1,477,3.1666666666666665
770,4,4,0,875972259,875972290,31,477,295,3.769230769230769
770,4,5,1,875972290,875972322,32,295,508,3.6923076923076925
770,5,5,0,875972322,875972352,30,508,129,3.744186046511628
770,5,5,0,875972352,875972381,29,129,475,3.956043956043956
770,5,5,0,875972381,875972612,231,475,473,2.9166666666666665
770,5,4,-1,875972612,875972699,87,473,546,2.9789473684210526
770,4,5,1,875972699,875972730,31,546,1012,3.2916666666666665
770,5,4,-1,875972730,875972988,258,1012,596,3.180327868852459
770,4,4,0,875972988,875973047,59,596,244,2.9411764705882355
770,4,4,0,875973047,875973080,33,244,118,3.2764227642276422
770,4,4,0,875973080,876598016,624936,118,326,3.262295081967213
788,5,4,-1,880867372,880867422,50,286,322,3.0476190476190474
788,4,5,1,880867422,880867477,55,322,300,3.6861313868613137
788,5,4,-1,880867477,880867565,88,300,289,2.988888888888889
788,4,2,-2,880867565,880867890,325,289,665,2.72972972972973
788,2,4,2,880867890,880867933,43,665,187,4.215189873417722
788,4,4,0,880867933,880867970,37,187,504,4.085714285714285
788,4,5,1,880867970,880868005,35,504,589,4.384615384615385
788,5,3,-2,880868005,880868042,37,589,470,3.72
788,3,4,1,880868042,880868068,26,470,205,3.717391304347826
788,4,4,0,880868068,880868144,76,205,69,3.8015873015873014
788,4,4,0,880868144,880868181,37,69,223,4.108695652173913
788,4,3,-1,880868181,880868277,96,223,23,3.9047619047619047
788,3,2,-1,880868277,880868316,39,23,427,4.2025316455696204
788,2,5,3,880868316,880868355,39,427,318,4.5046728971962615
788,5,4,-1,880868355,880868401,46,318,211,3.958904109589041
788,4,3,-1,880868401,880868473,72,211,480,4.283018867924528
788,3,3,0,880868473,880868513,40,480,646,3.9285714285714284
788,3,4,1,880868513,880868559,46,646,79,3.956989247311828
788,4,4,0,880868559,880868599,40,79,144,3.9545454545454546
788,4,3,-1,880868599,880868644,45,144,655,3.7857142857142856
788,3,5,2,880868644,880868673,29,655,199,4.191489361702128
788,5,2,-3,880868673,880868705,32,199,693,3.6285714285714286
788,2,5,3,880868705,880868743,38,693,183,3.951219512195122
788,5,4,-1,880868743,880868803,60,183,614,3.727272727272727
788,4,4,0,880868803,880868838,35,614,651,3.8627450980392157
788,4,4,0,880868838,880868876,38,651,601,3.857142857142857
788,4,5,1,880868876,880868919,43,601,12,4.358974358974359
788,5,4,-1,880868919,880868974,55,12,405,3.25
788,4,3,-1,880868974,880869014,40,405,135,3.7974683544303796
788,3,5,2,880869014,880869075,61,135,241,3.5625
788,5,3,-2,880869075,880869106,31,241,692,3.56
788,3,3,0,880869106,880869135,29,692,159,3.3902439024390243
788,3,4,1,880869135,880869174,39,159,54,3.3714285714285714
788,4,3,-1,880869174,880869215,41,54,380,3.4878048780487805
788,3,3,0,880869215,880869278,63,380,435,3.8933333333333335
788,3,1,-2,880869278,880869323,45,435,432,3.719298245614035
788,1,2,1,880869323,880869396,73,432,130,1.8461538461538463
788,2,3,1,880869396,880869434,38,130,385,3.6129032258064515
788,3,4,1,880869434,880869508,74,385,9,3.8878504672897196
788,4,5,1,880869508,880869548,40,9,89,3.9615384615384617
788,5,4,-1,880869548,880869584,36,89,237,3.7315436241610738
788,4,2,-2,880869584,880869621,37,237,433,3.8035714285714284
788,2,3,1,880869621,880869649,28,433,649,3.625
788,3,3,0,880869649,880869687,38,649,553,3.5
788,3,4,1,880869687,880869718,31,553,445,3.727272727272727
788,4,4,0,880869718,880869753,35,445,549,3.4871794871794872
788,4,3,-1,880869753,880869754,1,549,518,3.5833333333333335
788,3,4,1,880869754,880869787,33,518,482,3.9444444444444446
788,4,3,-1,880869787,880869819,32,482,68,3.5714285714285716
788,3,3,0,880869819,880869862,43,68,568,3.5853658536585367
788,3,4,1,880869862,880869908,46,568,70,3.5833333333333335
788,4,3,-1,880869908,880870018,110,70,46,3.6666666666666665
788,3,4,1,880870018,880870052,34,46,194,4.029411764705882
788,4,3,-1,880870052,880870115,63,194,164,3.6140350877192984
788,3,3,0,880870115,880870116,1,164,82,3.6741573033707864
788,3,1,-2,880870116,880870149,33,82,629,3.3333333333333335
788,1,3,2,880870149,880870207,58,629,723,3.5384615384615383
788,3,3,0,880870207,880870257,50,723,554,2.9555555555555557
788,3,3,0,880870257,880870299,42,554,43,3.1
788,3,3,0,880870299,880870401,102,43,809,2.7058823529411766
788,3,3,0,880870401,880870428,27,809,1112,2.9
788,3,3,0,880870428,880870482,54,1112,720,3.2
788,3,2,-1,880870482,880870516,34,720,637,2.888888888888889
788,2,3,1,880870516,880870582,66,637,167,2.8181818181818183
788,3,3,0,880870582,880870583,1,167,636,3.4146341463414633
788,3,3,0,880870583,880870626,43,636,561,3.1515151515151514
788,3,4,1,880870626,880870654,28,561,627,3.3823529411764706
788,4,4,0,880870654,880870710,56,627,226,3.378787878787879
788,4,3,-1,880870710,880870773,63,226,1107,2.9
788,3,4,1,880870773,880870827,54,1107,356,3.2
788,4,3,-1,880870827,880870881,54,356,755,3.085714285714286
788,3,4,1,880870881,880870905,24,755,291,3.2
788,4,3,-1,880870905,880870935,30,291,670,2.9375
788,3,3,0,880870935,880870936,1,670,623,3.0454545454545454
788,3,3,0,880870936,880870996,60,623,685,3.2666666666666666
788,3,3,0,880870996,880871026,30,685,621,2.75
788,3,2,-1,880871026,880871057,31,621,679,3.2432432432432434
788,2,3,1,880871057,880871088,31,679,620,3.0
788,3,3,0,880871088,880871128,40,620,399,3.317073170731707
788,3,3,0,880871128,880871173,45,399,112,2.7
788,3,3,0,880871173,880871205,32,112,781,3.4166666666666665
788,3,4,1,880871205,880871240,35,781,451,3.207792207792208
788,4,3,-1,880871240,880871267,27,451,231,2.938775510204082
788,3,3,0,880871267,880871294,27,231,823,2.75
788,3,3,0,880871294,880871359,65,823,38,2.784313725490196
788,3,3,0,880871359,880871394,35,38,1518,3.142857142857143
788,3,3,0,880871394,880871429,35,1518,546,2.9789473684210526
788,3,2,-1,880871429,880871460,31,546,1135,3.0526315789473686
788,2,2,0,880871460,880871490,30,1135,586,2.875
788,2,2,0,880871490,880871520,30,586,120,2.3421052631578947
788,2,3,1,880871520,880871577,57,120,1303,2.857142857142857
788,3,1,-2,880871577,880871717,140,1303,53,2.9523809523809526
788,1,2,1,880871717,880871746,29,53,391,2.4285714285714284
788,2,3,1,880871746,880871771,25,391,1273,2.5714285714285716
788,3,3,0,880871771,880871804,33,1273,712,3.0434782608695654
788,3,2,-1,880871804,880871857,53,712,1459,3.6
789,5,4,-1,880332039,880332063,24,127,93,3.5641025641025643
789,4,3,-1,880332063,880332089,26,93,1,3.902439024390244
789,3,5,2,880332089,880332148,59,1,741,3.3043478260869565
789,5,4,-1,880332148,880332169,21,741,508,3.6923076923076925
789,4,2,-2,880332169,880332189,20,508,137,3.9545454545454546
789,2,3,1,880332189,880332215,26,137,628,3.573529411764706
789,3,3,0,880332215,880332232,17,628,762,3.3962264150943398
789,3,3,0,880332232,880332259,27,762,284,3.1547619047619047
789,3,3,0,880332259,880332275,16,284,294,3.1052631578947367
789,3,3,0,880332275,880332316,41,294,1017,3.0
789,3,4,1,880332316,880332365,49,1017,1008,3.5
789,4,3,-1,880332365,880332400,35,1008,111,3.5106382978723403
789,3,4,1,880332400,880332437,37,111,181,3.98974358974359
790,4,2,-2,884460942,884461023,81,288,259,2.492063492063492
790,2,1,-1,884461023,884461073,50,259,748,3.1043478260869564
790,1,1,0,884461073,884461162,89,748,687,2.1481481481481484
790,1,1,0,884461162,884461188,26,687,1025,2.95
790,1,4,3,884461188,884461283,95,1025,246,4.0
790,4,3,-1,884461283,884461306,23,246,1,3.902439024390244
790,3,2,-1,884461306,884461334,28,1,100,4.0162162162162165
790,2,4,2,884461334,884461387,53,100,50,4.306532663316583
790,4,5,1,884461387,884461413,26,50,15,3.725663716814159
790,5,3,-2,884461413,884461441,28,15,222,3.578125
790,3,2,-1,884461441,884461517,76,222,283,3.901639344262295
790,2,4,2,884461517,884461541,24,283,237,3.7315436241610738
790,4,1,-3,884461541,884461590,49,237,546,2.9789473684210526
790,1,3,2,884461590,884461657,67,546,121,3.521212121212121
790,3,4,1,884461657,884461796,139,121,7,3.76056338028169
790,4,3,-1,884461796,884461820,24,7,13,3.5454545454545454
790,3,4,1,884461820,884461888,68,13,284,3.1547619047619047
790,4,2,-2,884461888,884461925,37,284,1016,3.559322033898305
790,2,4,2,884461925,884461988,63,1016,685,3.2666666666666666
790,4,3,-1,884461988,884462047,59,685,597,3.2771084337349397
790,3,2,-1,884462047,884462105,58,597,931,2.2758620689655173
790,2,3,1,884462105,884462415,310,931,108,3.107142857142857
790,3,5,2,884462415,884462551,136,108,1282,3.3333333333333335
790,5,4,-1,884462551,884462647,96,1282,864,3.2142857142857144
790,4,3,-1,884462647,884462692,45,864,240,3.0350877192982457
790,3,1,-2,884462692,884462714,22,240,826,2.5555555555555554
790,1,1,0,884462714,884462737,23,826,1215,2.0714285714285716
790,1,2,1,884462737,884462890,153,1215,1165,1.8
790,2,2,0,884462890,884462954,64,1165,1040,2.2666666666666666
790,2,3,1,884462954,885155034,692080,1040,83,4.204081632653061
790,3,3,0,885155034,885155077,43,83,153,3.7865168539325844
790,3,3,0,885155077,885155119,42,153,776,4.0
790,3,4,1,885155119,885155150,31,776,56,4.051724137931035
790,4,4,0,885155150,885155172,22,56,427,4.2025316455696204
790,4,3,-1,885155172,885155209,37,427,191,4.168674698795181
790,3,4,1,885155209,885155230,21,191,168,4.0476190476190474
790,4,3,-1,885155230,885155490,260,168,1039,3.9583333333333335
790,3,4,1,885155490,885155540,50,1039,172,4.225225225225225
790,4,4,0,885155540,885155572,32,172,174,4.253521126760563
790,4,2,-2,885155572,885155603,31,174,792,3.793103448275862
790,2,3,1,885155603,885155648,45,792,96,3.9130434782608696
790,3,4,1,885155648,885155846,198,96,65,3.511111111111111
790,4,4,0,885155846,885155949,103,65,317,3.774193548387097
790,4,3,-1,885155949,885156014,65,317,208,3.8125
790,3,3,0,885156014,885156046,32,208,1118,3.533333333333333
790,3,2,-1,885156046,885156290,244,1118,393,3.5125
790,2,3,1,885156290,885156336,46,393,213,3.943396226415094
790,3,5,2,885156336,885156375,39,213,98,4.240875912408759
790,5,3,-2,885156375,885156396,21,98,226,3.378787878787879
790,3,5,2,885156396,885156435,39,226,216,3.8454545454545452
790,5,5,0,885156435,885156478,43,216,1063,3.642857142857143
790,5,3,-2,885156478,885156500,22,1063,196,3.9404761904761907
790,3,3,0,885156500,885156560,60,196,66,3.4705882352941178
790,3,4,1,885156560,885156618,58,66,550,3.272727272727273
790,4,3,-1,885156618,885156619,1,550,1077,3.3333333333333335
790,3,3,0,885156619,885156647,28,1077,227,3.169811320754717
790,3,3,0,885156647,885156686,39,227,709,4.171428571428572
790,3,3,0,885156686,885156709,23,709,485,3.717948717948718
790,3,4,1,885156709,885156732,23,485,1119,3.5185185185185186
790,4,3,-1,885156732,885156773,41,1119,559,3.477272727272727
790,3,4,1,885156773,885156825,52,559,949,3.392857142857143
790,4,3,-1,885156825,885156852,27,949,49,3.3
790,3,3,0,885156852,885156904,52,49,660,3.71875
790,3,3,0,885156904,885156934,30,660,378,3.6904761904761907
790,3,3,0,885156934,885156958,24,378,184,3.393939393939394
790,3,3,0,885156958,885156988,30,184,2,3.0851063829787235
790,3,3,0,885156988,885157017,29,2,721,3.4583333333333335
790,3,3,0,885157017,885157061,44,721,941,3.5
790,3,3,0,885157061,885157087,26,941,568,3.5853658536585367
790,3,4,1,885157087,885157107,20,568,781,3.4166666666666665
790,4,3,-1,885157107,885157159,52,781,431,3.422222222222222
790,3,4,1,885157159,885157181,22,431,161,3.5844155844155843
790,4,4,0,885157181,885157205,24,161,849,2.5625
790,4,1,-3,885157205,885157299,94,849,944,2.75
790,1,4,3,885157299,885157399,100,944,188,3.625
790,4,4,0,885157399,885157419,20,188,380,3.4878048780487805
790,4,3,-1,885157419,885157440,21,380,68,3.5714285714285716
790,3,4,1,885157440,885157465,25,68,365,2.95
790,4,4,0,885157465,885157489,24,365,73,3.588235294117647
790,4,2,-2,885157489,885157575,86,73,80,2.967741935483871
790,2,2,0,885157575,885157594,19,80,449,2.9069767441860463
790,2,2,0,885157594,885157661,67,449,72,3.175438596491228
790,2,3,1,885157661,885157686,25,72,722,2.9642857142857144
790,3,1,-2,885157686,885157728,42,722,1091,2.5384615384615383
790,1,2,1,885157728,885157748,20,1091,139,2.7222222222222223
790,2,2,0,885157748,885157797,49,139,215,3.662921348314607
790,2,2,0,885157797,885157837,40,215,63,3.125
790,2,3,1,885157837,885157862,25,63,91,3.6
790,3,3,0,885157862,885157928,66,91,755,3.085714285714286
790,3,2,-1,885157928,885157929,1,755,38,2.784313725490196
790,2,2,0,885157929,885157984,55,38,552,2.8095238095238093
790,2,3,1,885157984,885158007,23,552,67,3.106382978723404
790,3,4,1,885158007,885158033,26,67,716,3.1904761904761907
790,4,4,0,885158033,885158057,24,716,231,2.938775510204082
790,4,2,-2,885158057,885158082,25,231,29,2.5714285714285716
790,2,2,0,885158082,885158122,40,29,577,1.7058823529411764
790,2,2,0,885158122,885158161,39,577,364,2.8095238095238093
790,2,4,2,885158161,885158185,24,364,1044,3.2777777777777777
790,4,2,-2,885158185,885158208,23,1044,386,2.769230769230769
790,2,3,1,885158208,885158235,27,386,41,3.0625
790,3,2,-1,885158235,885158257,22,41,1185,2.111111111111111
790,2,2,0,885158257,885158299,42,1185,391,2.4285714285714284
790,2,3,1,885158299,885158396,97,391,738,3.0
790,3,4,1,885158396,885158459,63,738,217,3.1538461538461537
790,4,3,-1,885158459,885158495,36,217,665,2.72972972972973
790,3,4,1,885158495,885158547,52,665,470,3.72
790,4,5,1,885158547,885158562,15,470,250,3.4698795180722892
787,3,5,2,888979074,888979075,1,937,750,4.027777777777778
787,5,4,-1,888979075,888979123,48,750,691,4.0
787,4,3,-1,888979123,888979181,58,691,308,3.6153846153846154
787,3,3,0,888979181,888979182,1,308,904,4.125
787,3,1,-2,888979182,888979236,54,904,288,3.5214285714285714
787,1,3,2,888979236,888979657,421,288,681,2.25
787,3,3,0,888979657,888979721,64,681,319,3.0408163265306123
783,4,4,0,884326382,884326383,1,292,333,3.546666666666667
783,4,5,1,884326383,884326424,41,333,346,3.5128205128205128
783,5,3,-2,884326424,884326461,37,346,334,3.4210526315789473
783,3,3,0,884326461,884326506,45,334,294,3.1052631578947367
783,3,4,1,884326506,884326545,39,294,328,3.4895833333333335
783,4,4,0,884326545,884326584,39,328,881,2.769230769230769
783,4,4,0,884326584,884326690,106,881,260,2.4716981132075473
783,4,1,-3,884326690,884326755,65,260,330,2.625
783,1,4,3,884326755,884326787,32,330,895,3.142857142857143
785,4,3,-1,879438565,879438705,140,301,748,3.1043478260869564
785,3,3,0,879438705,879438736,31,748,995,3.0
785,3,2,-1,879438736,879438810,74,995,137,3.9545454545454546
785,2,2,0,879438810,879438957,147,137,423,3.7016129032258065
785,2,4,2,879438957,879438984,27,423,79,3.956989247311828
785,4,5,1,879438984,879439021,37,79,50,4.306532663316583
785,5,3,-2,879439021,879439043,22,50,209,3.8275862068965516
794,4,4,0,891034284,891034792,508,887,275,4.087912087912088
794,4,4,0,891034792,891034956,164,275,150,3.803921568627451
794,4,4,0,891034956,891034986,30,150,455,3.1702127659574466
794,4,5,1,891034986,891035063,77,455,100,4.0162162162162165
794,5,5,0,891035063,891035117,54,100,127,4.162790697674419
794,5,5,0,891035117,891035135,18,127,238,3.888888888888889
794,5,5,0,891035135,891035219,84,238,936,3.727272727272727
794,5,5,0,891035219,891035307,88,936,50,4.306532663316583
794,5,5,0,891035307,891035355,48,50,285,4.181818181818182
794,5,2,-3,891035355,891035413,58,285,118,3.2764227642276422
794,2,4,2,891035413,891035582,169,118,13,3.5454545454545454
794,4,5,1,891035582,891035604,22,13,514,4.033333333333333
794,5,4,-1,891035604,891035662,58,514,420,3.5652173913043477
794,4,5,1,891035662,891035822,160,420,475,3.956043956043956
794,5,4,-1,891035822,891035941,119,475,109,3.282608695652174
794,4,4,0,891035941,891036008,67,109,557,3.090909090909091
794,4,4,0,891036008,891036111,103,557,19,3.9615384615384617
794,4,4,0,891036111,891036222,111,19,221,3.6923076923076925
794,4,4,0,891036222,891036265,43,221,257,3.7154471544715446
781,4,4,0,879633862,879633895,33,324,180,3.9473684210526314
781,4,3,-1,879633895,879633919,24,180,56,4.051724137931035
781,3,4,1,879633919,879633942,23,56,195,3.9072164948453607
781,4,5,1,879633942,879634017,75,195,179,3.8823529411764706
781,5,5,0,879634017,879634038,21,179,523,4.159090909090909
781,5,5,0,879634038,879634096,58,523,1500,5.0
781,5,3,-2,879634096,879634124,28,1500,215,3.662921348314607
781,3,3,0,879634124,879634147,23,215,69,3.8015873015873014
781,3,5,2,879634147,879634175,28,69,100,4.0162162162162165
781,5,5,0,879634175,879634256,81,100,134,4.174603174603175
781,5,4,-1,879634256,879634295,39,134,210,3.921259842519685
781,4,5,1,879634295,879634318,23,210,181,3.98974358974359
781,5,4,-1,879634318,879634340,22,181,87,3.9
781,4,5,1,879634340,879634362,22,87,50,4.306532663316583
781,5,4,-1,879634362,879634387,25,50,64,4.373737373737374
796,2,4,2,892610876,892611799,923,286,307,3.6031746031746033
796,4,4,0,892611799,892611903,104,307,300,3.6861313868613137
796,4,3,-1,892611903,892611953,50,300,322,3.0476190476190474
796,3,3,0,892611953,892611979,26,322,294,3.1052631578947367
796,3,3,0,892611979,892612031,52,294,245,3.056179775280899
796,3,4,1,892612031,892612032,1,245,326,3.262295081967213
796,4,5,1,892612032,892612057,25,326,328,3.4895833333333335
796,5,5,0,892612057,892660177,48120,328,181,3.98974358974359
796,5,4,-1,892660177,892660211,34,181,275,4.087912087912088
796,4,5,1,892660211,892660283,72,275,117,3.689189189189189
796,5,4,-1,892660283,892660323,40,117,278,3.0357142857142856
796,4,3,-1,892660323,892660364,41,278,1163,2.1666666666666665
796,3,3,0,892660364,892660465,101,1163,248,3.746268656716418
796,3,3,0,892660465,892660505,40,248,742,3.5555555555555554
796,3,3,0,892660505,892660955,450,742,1511,3.3333333333333335
796,3,1,-2,892660955,892661011,56,1511,249,3.3275862068965516
796,1,5,4,892661011,892661043,32,249,121,3.521212121212121
796,5,4,-1,892661043,892662152,1109,121,603,4.315789473684211
796,4,4,0,892662152,892662222,70,603,132,3.929411764705882
796,4,3,-1,892662222,892662223,1,132,520,4.136363636363637
796,3,4,1,892662223,892662400,177,520,64,4.373737373737374
796,4,5,1,892662400,892662441,41,64,183,3.951219512195122
796,5,3,-2,892662441,892662482,41,183,659,4.027777777777778
796,3,5,2,892662482,892662483,1,659,69,3.8015873015873014
796,5,5,0,892662483,892662523,40,69,176,3.967032967032967
796,5,5,0,892662523,892662524,1,176,144,3.9545454545454546
796,5,4,-1,892662524,892662826,302,144,194,4.029411764705882
796,4,4,0,892662826,892662871,45,194,198,4.04
796,4,5,1,892662871,892662904,33,198,187,4.215189873417722
796,5,4,-1,892662904,892662964,60,187,607,4.136363636363637
796,4,5,1,892662964,892663009,45,607,56,4.051724137931035
796,5,3,-2,892663009,892663090,81,56,48,4.055555555555555
796,3,3,0,892663090,892663154,64,48,707,3.909090909090909
796,3,4,1,892663154,892663155,1,707,480,4.283018867924528
796,4,5,1,892663155,892675528,12373,480,484,4.116279069767442
796,5,2,-3,892675528,892675606,78,484,180,3.9473684210526314
796,2,3,1,892675606,892675654,48,180,467,4.071428571428571
796,3,5,2,892675654,892675693,39,467,196,3.9404761904761907
796,5,2,-3,892675693,892675694,1,196,433,3.8035714285714284
796,2,5,3,892675694,892676072,378,433,486,3.9565217391304346
796,5,3,-2,892676072,892676231,159,486,197,4.112676056338028
796,3,3,0,892676231,892690101,13870,197,152,3.6785714285714284
796,3,4,1,892690101,892690102,1,152,429,3.742857142857143
796,4,2,-2,892690102,892690173,71,429,234,3.7674418604651163
796,2,4,2,892690173,892690262,89,234,423,3.7016129032258065
796,4,4,0,892690262,892690263,1,423,705,3.7857142857142856
796,4,4,0,892690263,892690382,119,705,191,4.168674698795181
796,4,3,-1,892690382,892761504,71122,191,939,3.6333333333333333
796,3,5,2,892761504,892761543,39,939,216,3.8454545454545452
796,5,3,-2,892761543,892761578,35,216,510,3.823529411764706
796,3,5,2,892761578,892761629,51,510,228,3.7246376811594204
796,5,2,-3,892761629,892874859,113230,228,339,2.7058823529411766
796,2,4,2,892874859,893047126,172267,339,821,3.076923076923077
796,4,5,1,893047126,893047207,81,821,739,3.391304347826087
796,5,3,-2,893047207,893047208,1,739,381,3.2758620689655173
796,3,5,2,893047208,893047241,33,381,155,3.0588235294117645
796,5,5,0,893047241,893047287,46,155,1041,3.3333333333333335
796,5,2,-3,893047287,893047288,1,1041,1048,2.857142857142857
796,2,3,1,893047288,893047320,32,1048,731,3.4
796,3,3,0,893047320,893047460,140,731,722,2.9642857142857144
796,3,2,-1,893047460,893047504,44,722,1297,3.0
796,2,1,-1,893047504,893047691,187,1297,1074,2.857142857142857
796,1,3,2,893047691,893048024,333,1074,934,3.0294117647058822
796,3,3,0,893048024,893048115,91,934,746,3.7560975609756095
796,3,5,2,893048115,893048150,35,746,4,3.5538461538461537
796,5,4,-1,893048150,893048342,192,4,182,3.842857142857143
796,4,4,0,893048342,893048343,1,182,566,3.543859649122807
796,4,4,0,893048343,893048471,128,566,227,3.169811320754717
796,4,2,-2,893048471,893048622,151,227,665,2.72972972972973
796,2,3,1,893048622,893048672,50,665,29,2.5714285714285716
796,3,3,0,893048672,893048911,239,29,232,3.0789473684210527
796,3,2,-1,893048911,893049303,392,232,831,2.6097560975609757
796,2,3,1,893049303,893049362,59,831,1407,2.375
796,3,3,0,893049362,893049399,37,1407,450,2.2758620689655173
796,3,4,1,893049399,893188486,139087,450,43,3.1
796,4,4,0,893188486,893188576,90,43,699,3.736842105263158
796,4,3,-1,893188576,893188577,1,699,1055,3.125
796,3,4,1,893188577,893188622,45,1055,1285,3.1
796,4,3,-1,893188622,893188650,28,1285,693,3.6285714285714286
796,3,4,1,893188650,893194548,5898,693,185,3.9726027397260273
796,4,5,1,893194548,893194646,98,185,77,3.3857142857142857
796,5,3,-2,893194646,893194685,39,77,159,3.3902439024390243
796,3,3,0,893194685,893194740,55,159,974,3.125
796,3,3,0,893194740,893194862,122,974,717,2.9696969696969697
796,3,2,-1,893194862,893194895,33,717,106,2.8125
796,2,4,2,893194895,893194929,34,106,281,3.2
796,4,4,0,893194929,893194992,63,281,1090,2.3529411764705883
796,4,3,-1,893194992,893218453,23461,1090,559,3.477272727272727
796,3,3,0,893218453,893218485,32,559,672,2.7222222222222223
796,3,4,1,893218485,893218521,36,672,573,2.909090909090909
796,4,4,0,893218521,893218556,35,573,217,3.1538461538461537
796,4,2,-2,893218556,893218621,65,217,396,2.84
796,2,4,2,893218621,893218622,1,396,769,2.2222222222222223
796,4,5,1,893218622,893218728,106,769,588,3.8358208955223883
796,5,3,-2,893218728,893218764,36,588,99,3.8392857142857144
796,3,5,2,893218764,893218765,1,99,151,3.6544117647058822
796,5,4,-1,893218765,893218933,168,151,393,3.5125
796,4,2,-2,893218933,893219033,100,393,91,3.6
796,2,2,0,893219033,893219065,32,91,768,3.238095238095238
796,2,4,2,893219065,893219092,27,768,389,3.272727272727273
796,4,2,-2,893219092,893219150,58,389,1076,2.5
796,2,4,2,893219150,893219151,1,1076,1049,2.5714285714285716
796,4,2,-2,893219151,893219180,29,1049,1001,2.6666666666666665
796,2,3,1,893219180,893219254,74,1001,795,2.4
796,3,3,0,893219254,893219403,149,795,542,2.888888888888889
796,3,3,0,893219403,893219451,48,542,1032,2.7142857142857144
796,3,4,1,893219451,893219477,26,1032,112,2.7
795,3,5,2,880557114,880557294,180,50,7,3.76056338028169
795,5,4,-1,880557294,880558122,828,7,117,3.689189189189189
795,4,3,-1,880558122,880558562,440,117,151,3.6544117647058822
795,3,3,0,880558562,880559275,713,151,546,2.9789473684210526
795,3,3,0,880559275,880559543,268,546,472,2.984375
795,3,2,-1,880559543,880560078,535,472,931,2.2758620689655173
795,2,3,1,880560078,880560263,185,931,235,3.106382978723404
795,3,3,0,880560263,880560736,473,235,826,2.5555555555555554
795,3,3,0,880560736,880568492,7756,826,429,3.742857142857143
795,3,4,1,880568492,880569414,922,429,28,3.923076923076923
795,4,3,-1,880569414,880569526,112,28,419,3.8208955223880596
795,3,4,1,880569526,880569625,99,419,174,4.253521126760563
795,4,4,0,880569625,880588141,18516,174,433,3.8035714285714284
795,4,4,0,880588141,881260622,672481,433,152,3.6785714285714284
795,4,3,-1,881260622,881265284,4662,152,189,3.88
795,3,4,1,881265284,881265372,88,189,214,3.272727272727273
795,4,5,1,881265372,881265483,111,214,91,3.6
795,5,3,-2,881265483,881265617,134,91,710,3.41025641025641
795,3,4,1,881265617,881528779,263162,710,1101,3.793103448275862
795,4,4,0,881528779,881529851,1072,1101,95,3.8194444444444446
795,4,3,-1,881529851,881529904,53,95,154,3.6031746031746033
795,3,4,1,881529904,881530041,137,154,182,3.842857142857143
795,4,3,-1,881530041,881530126,85,182,135,3.7974683544303796
795,3,3,0,881530126,881530154,28,135,655,3.7857142857142856
795,3,3,0,881530154,881530198,44,655,203,3.826923076923077
795,3,3,0,881530198,881530317,119,203,727,3.5517241379310347
795,3,2,-1,881530317,881530415,98,727,96,3.9130434782608696
795,2,3,1,881530415,883249643,1719228,96,1555,3.5
795,3,4,1,883249643,883250168,525,1555,583,3.4285714285714284
795,4,3,-1,883250168,883251581,1413,583,200,3.8157894736842106
795,3,3,0,883251581,883251659,78,200,675,3.625
795,3,3,0,883251659,883251800,141,675,226,3.378787878787879
795,3,3,0,883251800,883252003,203,226,72,3.175438596491228
795,3,3,0,883252003,883252104,101,72,219,2.735294117647059
795,3,3,0,883252104,883252202,98,219,367,3.4242424242424243
795,3,3,0,883252202,883252292,90,367,143,3.56
795,3,2,-1,883252292,883252686,394,143,17,3.032258064516129
795,2,3,1,883252686,883253137,451,17,68,3.5714285714285716
795,3,4,1,883253137,883253193,56,68,431,3.422222222222222
795,4,4,0,883253193,883253316,123,431,581,3.130434782608696
795,4,3,-1,883253316,883253368,52,581,164,3.6140350877192984
795,3,3,0,883253368,883253481,113,164,70,3.5833333333333335
795,3,4,1,883253481,883253661,180,70,39,3.107142857142857
795,4,2,-2,883253661,883254314,653,39,118,3.2764227642276422
795,2,3,1,883254314,883254348,34,118,167,2.8181818181818183
795,3,3,0,883254348,883254649,301,167,386,2.769230769230769
795,3,3,0,883254649,883254675,26,386,412,2.272727272727273
795,3,3,0,883254675,883254750,75,412,797,3.1538461538461537
795,3,3,0,883254750,883254802,52,797,554,2.9555555555555557
795,3,2,-1,883254802,883254905,103,554,402,3.3076923076923075
795,2,3,1,883254905,883254987,82,402,1413,3.75
795,3,3,0,883254987,883255182,195,1413,998,2.7777777777777777
795,3,3,0,883255182,883255381,199,998,1030,2.3636363636363638
795,3,3,0,883255381,883255477,96,1030,1052,2.4545454545454546
795,3,2,-1,883255477,883255578,101,1052,1036,3.0
795,2,4,2,883255578,883767204,511626,1036,1,3.902439024390244
795,4,2,-2,883767204,883767338,134,1,240,3.0350877192982457
793,4,4,0,875103739,875103810,71,117,181,3.98974358974359
793,4,4,0,875103810,875103842,32,181,844,3.8333333333333335
793,4,3,-1,875103842,875103971,129,844,222,3.578125
793,3,3,0,875103971,875104000,29,222,824,2.590909090909091
793,3,4,1,875104000,875104031,31,824,250,3.4698795180722892
793,4,4,0,875104031,875104067,36,250,129,3.744186046511628
793,4,4,0,875104067,875104091,24,129,293,3.630434782608696
793,4,2,-2,875104091,875104119,28,293,118,3.2764227642276422
793,2,5,3,875104119,875104142,23,118,151,3.6544117647058822
793,5,3,-2,875104142,875104193,51,151,121,3.521212121212121
793,3,2,-1,875104193,875104221,28,121,406,2.5294117647058822
793,2,3,1,875104221,875104243,22,406,458,3.0588235294117645
793,3,3,0,875104243,875104303,60,458,696,3.138888888888889
793,3,3,0,875104303,875104532,229,696,122,2.282608695652174
793,3,4,1,875104532,875104565,33,122,240,3.0350877192982457
793,4,4,0,875104565,875104592,27,240,3,3.0625
793,4,4,0,875104592,875104620,28,3,508,3.6923076923076925
793,4,3,-1,875104620,875104648,28,508,823,2.75
793,3,3,0,875104648,875104718,70,823,685,3.2666666666666666
793,3,3,0,875104718,875104752,34,685,456,2.2
793,3,3,0,875104752,875104864,112,456,928,3.142857142857143
798,5,3,-2,875295521,875295616,95,748,222,3.578125
798,3,4,1,875295616,875295695,79,222,1283,2.9
798,4,5,1,875295695,875295772,77,1283,181,3.98974358974359
798,5,5,0,875295772,875295810,38,181,50,4.306532663316583
798,5,4,-1,875295810,875295842,32,50,275,4.087912087912088
798,4,2,-2,875295842,875295930,88,275,14,4.101694915254237
798,2,1,-1,875295930,875296109,179,14,111,3.5106382978723403
798,1,3,2,875296109,875296178,69,111,125,3.5555555555555554
798,3,4,1,875296178,875296234,56,125,281,3.2
798,4,2,-2,875296234,875303559,7325,281,707,3.909090909090909
798,2,3,1,875303559,875303589,30,707,71,3.6575342465753424
798,3,4,1,875303589,875303683,94,71,83,4.204081632653061
798,4,3,-1,875303683,875303718,35,83,694,4.277777777777778
798,3,3,0,875303718,875303765,47,694,480,4.283018867924528
798,3,3,0,875303765,875554639,250874,480,993,3.4838709677419355
798,3,3,0,875554639,875554781,142,993,116,3.6666666666666665
798,3,3,0,875554781,875554892,111,116,1337,3.0
798,3,3,0,875554892,875555000,108,1337,105,2.6176470588235294
798,3,4,1,875555000,875637487,82487,105,225,3.0714285714285716
798,4,4,0,875637487,875637541,54,225,827,2.4375
798,4,5,1,875637541,875637661,120,827,930,2.793103448275862
798,5,4,-1,875637661,875637680,19,930,1102,2.6
798,4,3,-1,875637680,875637744,64,1102,1284,2.5454545454545454
798,3,2,-1,875637744,875637822,78,1284,476,3.1216216216216215
798,2,5,3,875637822,875637836,14,476,254,2.7419354838709675
798,5,5,0,875637836,875637963,127,254,283,3.901639344262295
798,5,3,-2,875637963,875638090,127,283,929,2.8421052631578947
798,3,3,0,875638090,875638150,60,929,1049,2.5714285714285716
798,3,4,1,875638150,875638203,53,1049,926,2.7857142857142856
798,4,2,-2,875638203,875638323,120,926,563,2.0
798,2,4,2,875638323,875638447,124,563,705,3.7857142857142856
798,4,1,-3,875638447,875638474,27,705,97,3.7282608695652173
798,1,3,2,875638474,875638514,40,97,493,3.909090909090909
798,3,2,-1,875638514,875638547,33,493,1034,2.6
798,2,4,2,875638547,875638627,80,1034,79,3.956989247311828
798,4,4,0,875638627,875638649,22,79,839,4.0
798,4,5,1,875638649,875638680,31,839,399,3.317073170731707
798,5,4,-1,875638680,875638717,37,399,1035,3.03125
798,4,2,-2,875638717,875638759,42,1035,732,3.6266666666666665
798,2,2,0,875638759,875638817,58,732,231,2.938775510204082
798,2,2,0,875638817,875638842,25,231,1224,2.6666666666666665
798,2,3,1,875638842,875638883,41,1224,72,3.175438596491228
798,3,2,-1,875638883,875638884,1,72,554,2.9555555555555557
798,2,3,1,875638884,875638925,41,554,1544,2.0
798,3,3,0,875638925,875638972,47,1544,560,3.111111111111111
798,3,5,2,875638972,875639010,38,560,736,4.083333333333333
798,5,2,-3,875639010,875639061,51,736,781,3.4166666666666665
798,2,2,0,875639061,875639095,34,781,202,3.730337078651685
798,2,4,2,875639095,875639134,39,202,132,3.929411764705882
798,4,3,-1,875639134,875639212,78,132,1032,2.7142857142857144
798,3,3,0,875639212,875639235,23,1032,161,3.5844155844155843
798,3,3,0,875639235,875639236,1,161,356,3.2
798,3,3,0,875639236,875639260,24,356,602,3.533333333333333
798,3,2,-1,875639260,875639290,30,602,953,3.076923076923077
798,2,3,1,875639290,875639324,34,953,576,3.125
798,3,2,-1,875639324,875639441,117,576,577,1.7058823529411764
798,2,3,1,875639441,875639478,37,577,1003,2.8
798,3,3,0,875639478,875639553,75,1003,785,3.4375
798,3,3,0,875639553,875639581,28,785,498,4.290909090909091
798,3,1,-2,875639581,875639656,75,498,1411,2.4615384615384617
798,1,3,2,875639656,875639680,24,1411,87,3.9
798,3,3,0,875639680,875639767,87,87,951,2.6666666666666665
798,3,5,2,875639767,875639784,17,951,485,3.717948717948718
798,5,2,-3,875639784,875639836,52,485,1435,2.5
798,2,3,1,875639836,875639864,28,1435,423,3.7016129032258065
798,3,4,1,875639864,875639889,25,423,486,3.9565217391304346
798,4,4,0,875639889,875656111,16222,486,568,3.5853658536585367
798,4,3,-1,875656111,875743006,86895,568,196,3.9404761904761907
798,3,4,1,875743006,875743140,134,196,174,4.253521126760563
798,4,4,0,875743140,875743196,56,174,491,3.55
798,4,3,-1,875743196,875743267,71,491,603,4.315789473684211
798,3,3,0,875743267,875743314,47,603,610,3.1818181818181817
798,3,4,1,875743314,875743366,52,610,194,4.029411764705882
798,4,3,-1,875743366,875743434,68,194,367,3.4242424242424243
798,3,4,1,875743434,875743458,24,367,191,4.168674698795181
798,4,3,-1,875743458,875743518,60,191,945,3.4
798,3,4,1,875743518,875743576,58,945,1540,3.25
798,4,4,0,875743576,875743605,29,1540,1517,4.0
798,4,4,0,875743605,875743642,37,1517,88,3.433734939759036
798,4,4,0,875743642,875743765,123,88,168,4.0476190476190474
798,4,4,0,875743765,875743787,22,168,2,3.0851063829787235
798,4,4,0,875743787,875743813,26,2,805,3.909090909090909
798,4,4,0,875743813,875743858,45,805,378,3.6904761904761907
798,4,3,-1,875743858,875814110,70252,378,163,3.53125
798,3,4,1,875814110,875814157,47,163,239,3.423076923076923
798,4,4,0,875814157,875914114,99957,239,73,3.588235294117647
798,4,4,0,875914114,875914458,344,73,110,2.25
798,4,4,0,875914458,875914484,26,110,394,3.5714285714285716
798,4,3,-1,875914484,875914534,50,394,722,2.9642857142857144
798,3,4,1,875914534,875914573,39,722,944,2.75
798,4,2,-2,875914573,875914604,31,944,158,2.7027027027027026
798,2,4,2,875914604,875914785,181,158,1249,3.2
798,4,5,1,875914785,875914860,75,1249,709,4.171428571428572
798,5,4,-1,875914860,875914898,38,709,1446,3.0
798,4,5,1,875914898,875914939,41,1446,63,3.125
798,5,3,-2,875914939,875915029,90,63,393,3.5125
798,3,3,0,875915029,875915155,126,393,1509,2.5
798,3,3,0,875915155,875915279,124,1509,395,2.5714285714285716
798,3,4,1,875915279,875915317,38,395,1425,2.6
798,4,5,1,875915317,875915777,460,1425,265,3.710144927536232
798,5,4,-1,875915777,875915806,29,265,38,2.784313725490196
798,4,3,-1,875915806,875915855,49,38,810,2.9473684210526314
798,3,5,2,875915855,875915940,85,810,720,3.2
798,5,4,-1,875915940,875915965,25,720,1239,2.25
798,4,3,-1,875915965,875916297,332,1239,402,3.3076923076923075
798,3,3,0,875916297,875916505,208,402,1297,3.0
798,3,4,1,875916505,876175467,258962,1297,140,3.238095238095238
798,4,3,-1,876175467,876175980,513,140,623,3.0454545454545454
798,3,3,0,876175980,876176043,63,623,1076,2.5
798,3,4,1,876176043,876176115,72,1076,465,3.75
798,4,3,-1,876176115,876176160,45,465,138,2.6
798,3,4,1,876176160,876176259,99,138,432,3.719298245614035
798,4,3,-1,876176259,876177330,1071,432,1285,3.1
798,3,3,0,876177330,876177353,23,1285,162,3.4651162790697674
798,3,3,0,876177353,876177436,83,162,660,3.71875
798,3,2,-1,876177436,876177839,403,660,1539,2.0
798,2,2,0,876177839,876249507,71668,1539,769,2.2222222222222223
791,1,3,2,879447940,879448035,95,331,748,3.1043478260869564
791,3,4,1,879448035,879448086,51,748,754,3.5789473684210527
791,4,3,-1,879448086,879448087,1,754,259,2.492063492063492
791,3,4,1,879448087,879448128,41,259,322,3.0476190476190474
791,4,5,1,879448128,879448166,38,322,332,3.6511627906976742
791,5,5,0,879448166,879448314,148,332,275,4.087912087912088
802,5,4,-1,875984637,875984776,139,326,678,2.8181818181818183
802,4,5,1,875984776,875984938,162,678,879,3.2291666666666665
802,5,2,-3,875984938,875985031,93,879,330,2.625
802,2,3,1,875985031,875985032,1,330,261,2.7333333333333334
802,3,3,0,875985032,875985142,110,261,304,3.5306122448979593
802,3,3,0,875985142,875985239,97,304,484,4.116279069767442
802,3,3,0,875985239,875985347,108,484,134,4.174603174603175
802,3,4,1,875985347,875985469,122,134,665,2.72972972972973
802,4,3,-1,875985469,875985601,132,665,56,4.051724137931035
802,3,5,2,875985601,875985767,166,56,219,2.735294117647059
802,5,2,-3,875985767,875985768,1,219,674,2.6875
802,2,4,2,875985768,875985840,72,674,53,2.9523809523809526
802,4,4,0,875985840,875985976,136,53,452,2.6129032258064515
802,4,4,0,875985976,875986155,179,452,681,2.25
800,3,2,-1,887645987,887646168,181,304,457,1.7
800,2,4,2,887646168,887646203,35,457,181,3.98974358974359
800,4,4,0,887646203,887646226,23,181,222,3.578125
800,4,3,-1,887646226,887646245,19,222,276,3.6036036036036037
800,3,4,1,887646245,887646263,18,276,50,4.306532663316583
800,4,4,0,887646263,887646283,20,50,1,3.902439024390244
800,4,3,-1,887646283,887646342,59,1,118,3.2764227642276422
800,3,4,1,887646342,887646423,81,118,121,3.521212121212121
800,4,4,0,887646423,887646555,132,121,597,3.2771084337349397
800,4,4,0,887646555,887646631,76,597,15,3.725663716814159
800,4,4,0,887646631,887646705,74,15,405,3.25
800,4,3,-1,887646705,887646776,71,405,476,3.1216216216216215
800,3,3,0,887646776,887646804,28,476,1047,2.6923076923076925
800,3,5,2,887646804,887646979,175,1047,292,3.6666666666666665
804,4,4,0,879440663,879440700,37,988,748,3.1043478260869564
804,4,3,-1,879440700,879440727,27,748,243,2.357142857142857
804,3,4,1,879440727,879440765,38,243,1025,2.95
804,4,2,-2,879440765,879440787,22,1025,260,2.4716981132075473
804,2,4,2,879440787,879440912,125,260,50,4.306532663316583
804,4,3,-1,879440912,879440947,35,50,127,4.162790697674419
804,3,5,2,879440947,879441000,53,127,515,4.202898550724638
804,5,2,-3,879441000,879441099,99,515,292,3.6666666666666665
804,2,2,0,879441099,879441132,33,292,1244,2.7777777777777777
804,2,4,2,879441132,879441160,28,1244,252,2.911392405063291
804,4,4,0,879441160,879441195,35,252,1615,3.5
804,4,2,-2,879441195,879441236,41,1615,993,3.4838709677419355
804,2,5,3,879441236,879441346,110,993,510,3.823529411764706
804,5,5,0,879441346,879441372,26,510,210,3.921259842519685
804,5,5,0,879441372,879441391,19,210,198,4.04
804,5,5,0,879441391,879441412,21,198,208,3.8125
804,5,5,0,879441412,879441450,38,208,318,4.5046728971962615
804,5,5,0,879441450,879441476,26,318,174,4.253521126760563
804,5,5,0,879441476,879441503,27,174,98,4.240875912408759
804,5,4,-1,879441503,879441524,21,98,89,3.9615384615384617
804,4,4,0,879441524,879441542,18,89,479,4.25
804,4,3,-1,879441542,879441598,56,479,154,3.6031746031746033
804,3,3,0,879441598,879441651,53,154,213,3.943396226415094
804,3,5,2,879441651,879441677,26,213,96,3.9130434782608696
804,5,4,-1,879441677,879441702,25,96,176,3.967032967032967
804,4,4,0,879441702,879441727,25,176,238,3.888888888888889
804,4,4,0,879441727,879441752,25,238,192,4.090909090909091
804,4,4,0,879441752,879441913,161,192,81,3.2857142857142856
804,4,4,0,879441913,879441936,23,81,646,3.9285714285714284
804,4,4,0,879441936,879441973,37,646,187,4.215189873417722
804,4,4,0,879441973,879442025,52,187,191,4.168674698795181
804,4,4,0,879442025,879442057,32,191,97,3.7282608695652173
804,4,4,0,879442057,879442079,22,97,202,3.730337078651685
804,4,4,0,879442079,879442122,43,202,203,3.826923076923077
804,4,4,0,879442122,879442192,70,203,4,3.5538461538461537
804,4,5,1,879442192,879442239,47,4,498,4.290909090909091
804,5,4,-1,879442239,879442269,30,498,161,3.5844155844155843
804,4,4,0,879442269,879442298,29,161,10,3.85
804,4,4,0,879442298,879442412,114,10,173,4.1441441441441444
804,4,4,0,879442412,879442413,1,173,662,3.4583333333333335
804,4,4,0,879442413,879442434,21,662,205,3.717391304347826
804,4,3,-1,879442434,879442490,56,205,143,3.56
804,3,5,2,879442490,879442538,48,143,195,3.9072164948453607
804,5,4,-1,879442538,879442557,19,195,23,3.9047619047619047
804,4,4,0,879442557,879442642,85,23,434,3.588235294117647
804,4,4,0,879442642,879442643,1,434,425,3.7027027027027026
804,4,5,1,879442643,879442661,18,425,1,3.902439024390244
804,5,4,-1,879442661,879442687,26,1,468,3.380952380952381
804,4,4,0,879442687,879442732,45,468,742,3.5555555555555554
804,4,4,0,879442732,879442762,30,742,1056,3.3333333333333335
804,4,3,-1,879442762,879442792,30,1056,495,3.65
804,3,4,1,879442792,879442793,1,495,568,3.5853658536585367
804,4,4,0,879442793,879442862,69,568,157,3.5714285714285716
804,4,4,0,879442862,879442954,92,157,11,3.8904109589041096
804,4,4,0,879442954,879443032,78,11,514,4.033333333333333
804,4,4,0,879443032,879443137,105,514,70,3.5833333333333335
804,4,4,0,879443137,879443673,536,70,7,3.76056338028169
804,4,5,1,879443673,879443736,63,7,235,3.106382978723404
804,5,4,-1,879443736,879443776,40,235,405,3.25
804,4,4,0,879443776,879443795,19,405,290,3.108108108108108
804,4,3,-1,879443795,879443819,24,290,108,3.107142857142857
804,3,3,0,879443819,879443852,33,108,1047,2.6923076923076925
804,3,3,0,879443852,879443884,32,1047,546,2.9789473684210526
804,3,4,1,879443884,879443900,16,546,118,3.2764227642276422
804,4,4,0,879443900,879443918,18,118,413,2.5652173913043477
804,4,4,0,879443918,879443946,28,413,685,3.2666666666666666
804,4,4,0,879443946,879443958,12,685,240,3.0350877192982457
804,4,4,0,879443958,879443993,35,240,926,2.7857142857142856
804,4,3,-1,879443993,879444011,18,926,456,2.2
804,3,4,1,879444011,879444048,37,456,982,3.2
804,4,3,-1,879444048,879444077,29,982,981,2.0
804,3,3,0,879444077,879444092,15,981,929,2.8421052631578947
804,3,3,0,879444092,879444133,41,929,406,2.5294117647058822
804,3,3,0,879444133,879444444,311,406,504,4.085714285714285
804,3,3,0,879444444,879444463,19,504,631,3.581818181818182
804,3,3,0,879444463,879444488,25,631,632,3.9523809523809526
804,3,4,1,879444488,879444518,30,632,193,3.883720930232558
804,4,4,0,879444518,879444536,18,193,670,2.9375
804,4,4,0,879444536,879444583,47,670,175,3.8354430379746836
804,4,3,-1,879444583,879444624,41,175,419,3.8208955223880596
804,3,4,1,879444624,879444714,90,419,433,3.8035714285714284
804,4,4,0,879444714,879444743,29,433,444,2.6842105263157894
804,4,4,0,879444743,879444781,38,444,156,4.017857142857143
804,4,4,0,879444781,879444805,24,156,211,3.958904109589041
804,4,4,0,879444805,879444820,15,211,566,3.543859649122807
804,4,3,-1,879444820,879444963,143,566,582,3.7457627118644066
804,3,4,1,879444963,879444964,1,582,584,3.5238095238095237
804,4,5,1,879444964,879444984,20,584,436,3.5
804,5,4,-1,879444984,879445037,53,436,732,3.6266666666666665
804,4,3,-1,879445037,879445072,35,732,393,3.5125
804,3,4,1,879445072,879445111,39,393,399,3.317073170731707
804,4,3,-1,879445111,879445132,21,399,719,2.6666666666666665
804,3,3,0,879445132,879445190,58,719,522,3.8461538461538463
804,3,3,0,879445190,879445232,42,522,573,2.909090909090909
804,3,3,0,879445232,879445254,22,573,949,3.392857142857143
804,3,4,1,879445254,879445280,26,949,797,3.1538461538461537
804,4,3,-1,879445280,879445355,75,797,675,3.625
804,3,4,1,879445355,879445372,17,675,226,3.378787878787879
804,4,3,-1,879445372,879445393,21,226,1170,3.1666666666666665
804,3,3,0,879445393,879445440,47,1170,206,3.0
804,3,3,0,879445440,879445441,1,206,402,3.3076923076923075
804,3,3,0,879445441,879445465,24,402,379,3.35
804,3,4,1,879445465,879445466,1,379,152,3.6785714285714284
804,4,3,-1,879445466,879445493,27,152,768,3.238095238095238
804,3,2,-1,879445493,879445536,43,768,624,3.0
804,2,3,1,879445536,879445556,20,624,642,3.4285714285714284
804,3,4,1,879445556,879445579,23,642,366,3.4285714285714284
804,4,3,-1,879445579,879445625,46,366,447,3.46875
804,3,3,0,879445625,879445660,35,447,155,3.0588235294117645
804,3,4,1,879445660,879445699,39,155,674,2.6875
804,4,4,0,879445699,879445715,16,674,380,3.4878048780487805
804,4,3,-1,879445715,879445739,24,380,40,2.7037037037037037
804,3,4,1,879445739,879445766,27,40,445,3.727272727272727
804,4,3,-1,879445766,879445783,17,445,708,3.3157894736842106
804,3,4,1,879445783,879445815,32,708,233,3.323529411764706
804,4,4,0,879445815,879445904,89,233,385,3.6129032258064515
804,4,3,-1,879445904,879445933,29,385,212,3.230769230769231
804,3,2,-1,879445933,879445955,22,212,412,2.272727272727273
804,2,3,1,879445955,879445956,1,412,396,2.84
804,3,3,0,879445956,879445990,34,396,1178,2.375
804,3,3,0,879445990,879446090,100,1178,1228,2.5
804,3,3,0,879446090,879446129,39,1228,1411,2.4615384615384617
804,3,3,0,879446129,879446145,16,1411,1139,2.611111111111111
804,3,4,1,879446145,879446194,49,1139,94,2.8823529411764706
804,4,4,0,879446194,879446209,15,94,552,2.8095238095238093
804,4,3,-1,879446209,879446391,182,552,415,2.6666666666666665
804,3,1,-2,879446391,879447476,1085,415,948,2.2962962962962963
803,3,5,2,880054629,880054671,42,300,887,3.5789473684210527
803,5,1,-4,880054671,880054754,83,887,261,2.7333333333333334
803,1,2,1,880054754,880054792,38,261,990,2.769230769230769
803,2,2,0,880054792,880054833,41,990,271,3.3134328358208953
803,2,3,1,880054833,880054834,1,271,339,2.7058823529411766
803,3,2,-1,880054834,880054971,137,339,259,2.492063492063492
803,2,2,0,880054971,880055043,72,259,322,3.0476190476190474
803,2,4,2,880055043,880055210,167,322,690,3.260869565217391
803,4,2,-2,880055210,880055309,99,690,264,2.65
803,2,4,2,880055309,880055378,69,264,245,3.056179775280899
803,4,5,1,880055378,880055604,226,245,305,3.5789473684210527
775,5,3,-2,891032777,891032804,27,344,348,3.2
775,3,4,1,891032804,891032837,33,348,313,4.323076923076923
775,4,3,-1,891032837,891032866,29,313,312,3.0
775,3,5,2,891032866,891032895,29,312,345,3.4782608695652173
775,5,4,-1,891032895,891032923,28,345,331,3.5517241379310347
775,4,4,0,891032923,891032956,33,331,300,3.6861313868613137
775,4,4,0,891032956,891032989,33,300,307,3.6031746031746033
775,4,3,-1,891032989,891033022,33,307,690,3.260869565217391
775,3,4,1,891033022,891033071,49,690,264,2.65
792,3,3,0,877909709,877909753,44,742,151,3.6544117647058822
792,3,3,0,877909753,877909798,45,151,1047,2.6923076923076925
792,3,4,1,877909798,877909865,67,1047,124,4.052631578947368
792,4,2,-2,877909865,877909892,27,124,25,3.3185840707964602
792,2,3,1,877909892,877909931,39,25,282,3.610526315789474
792,3,3,0,877909931,877910091,160,282,24,3.3728813559322033
792,3,3,0,877910091,877910126,35,24,111,3.5106382978723403
792,3,3,0,877910126,877910160,34,111,1132,2.588235294117647
792,3,1,-2,877910160,877910206,46,1132,476,3.1216216216216215
792,1,3,2,877910206,877910241,35,476,596,3.180327868852459
792,3,3,0,877910241,877910305,64,596,276,3.6036036036036037
792,3,3,0,877910305,877910353,48,276,546,2.9789473684210526
792,3,4,1,877910353,877910412,59,546,121,3.521212121212121
792,4,3,-1,877910412,877910444,32,121,237,3.7315436241610738
792,3,3,0,877910444,877910478,34,237,597,3.2771084337349397
792,3,2,-1,877910478,877910538,60,597,118,3.2764227642276422
792,2,2,0,877910538,877910539,1,118,840,3.090909090909091
792,2,3,1,877910539,877910730,191,840,1011,3.1
792,3,4,1,877910730,877910822,92,1011,471,3.5714285714285716
799,4,2,-2,879253720,879253755,35,321,748,3.1043478260869564
799,2,4,2,879253755,879253795,40,748,306,4.033333333333333
799,4,5,1,879253795,879254026,231,306,479,4.25
799,5,5,0,879254026,879254027,1,479,654,4.119047619047619
799,5,5,0,879254027,879254077,50,654,427,4.2025316455696204
805,1,3,2,879971049,879971215,166,259,258,3.7547169811320753
805,3,4,1,879971215,881684202,1712987,258,209,3.8275862068965516
805,4,5,1,881684202,881694286,10084,209,147,3.3142857142857145
805,5,3,-2,881694286,881694423,137,147,228,3.7246376811594204
805,3,4,1,881694423,881694713,290,228,96,3.9130434782608696
805,4,2,-2,881694713,881694798,85,96,4,3.5538461538461537
805,2,4,2,881694798,881694823,25,4,222,3.578125
805,4,3,-1,881694823,881694854,31,222,568,3.5853658536585367
805,3,5,2,881694854,881694885,31,568,33,3.2941176470588234
805,5,4,-1,881694885,881694886,1,33,403,3.298507462686567
805,4,4,0,881694886,881694923,37,403,24,3.3728813559322033
805,4,4,0,881694923,881694978,55,24,636,3.4146341463414633
805,4,3,-1,881694978,881695080,102,636,597,3.2771084337349397
805,3,5,2,881695080,881695196,116,597,443,3.8421052631578947
805,5,5,0,881695196,881695243,47,443,558,3.75
805,5,1,-4,881695243,881695244,1,558,288,3.5214285714285714
805,1,2,1,881695244,881695293,49,288,217,3.1538461538461537
805,2,4,2,881695293,881695346,53,217,17,3.032258064516129
805,4,3,-1,881695346,881695347,1,17,436,3.5
805,3,4,1,881695347,881695396,49,436,396,2.84
805,4,5,1,881695396,881695527,131,396,91,3.6
805,5,3,-2,881695527,881695677,150,91,659,4.027777777777778
805,3,4,1,881695677,881695723,46,659,123,3.297872340425532
805,4,3,-1,881695723,881695745,22,123,118,3.2764227642276422
805,3,2,-1,881695745,881695793,48,118,581,3.130434782608696
805,2,4,2,881695793,881695830,37,581,642,3.4285714285714284
805,4,5,1,881695830,881695872,42,642,470,3.72
805,5,3,-2,881695872,881695930,58,470,928,3.142857142857143
805,3,5,2,881695930,881695968,38,928,106,2.8125
805,5,5,0,881695968,881695999,31,106,771,2.5714285714285716
805,5,5,0,881695999,881696124,125,771,1157,3.142857142857143
805,5,3,-2,881696124,881696699,575,1157,213,3.943396226415094
805,3,3,0,881696699,881696729,30,213,747,3.5526315789473686
805,3,5,2,881696729,881696759,30,747,451,3.207792207792208
805,5,3,-2,881696759,881696905,146,451,387,3.5357142857142856
805,3,1,-2,881696905,881696923,18,387,155,3.0588235294117645
805,1,4,3,881696923,881696980,57,155,716,3.1904761904761907
805,4,2,-2,881696980,881697013,33,716,402,3.3076923076923075
805,2,4,2,881697013,881697128,115,402,45,4.130434782608695
805,4,4,0,881697128,881697229,101,45,1149,3.857142857142857
805,4,4,0,881697229,881697792,563,1149,32,3.7222222222222223
805,4,5,1,881697792,881698095,303,32,522,3.8461538461538463
805,5,3,-2,881698095,881698175,80,522,655,3.7857142857142856
805,3,4,1,881698175,881698258,83,655,382,3.764705882352941
805,4,3,-1,881698258,881698798,540,382,582,3.7457627118644066
805,3,4,1,881698798,881698881,83,582,856,4.142857142857143
805,4,3,-1,881698881,881699728,847,856,729,3.3793103448275863
805,3,5,2,881699728,881700749,1021,729,1170,3.1666666666666665
805,5,2,-3,881700749,881703473,2724,1170,546,2.9789473684210526
805,2,5,3,881703473,881703690,217,546,1629,5.0
805,5,3,-2,881703690,881704063,373,1629,8,3.903225806451613
805,3,3,0,881704063,881704150,87,8,1098,3.533333333333333
805,3,5,2,881704150,881704223,73,1098,238,3.888888888888889
805,5,3,-2,881704223,881704224,1,238,386,2.769230769230769
805,3,4,1,881704224,881705108,884,386,367,3.4242424242424243
805,4,2,-2,881705108,881705238,130,367,105,2.6176470588235294
805,2,3,1,881705238,881705292,54,105,321,3.0172413793103448
805,3,2,-1,881705292,881705327,35,321,959,3.4583333333333335
805,2,2,0,881705327,881705350,23,959,411,2.911764705882353
805,2,4,2,881705350,881705389,39,411,719,2.6666666666666665
805,4,1,-3,881705389,881705412,23,719,94,2.8823529411764706
805,1,4,3,881705412,881705456,44,94,1071,3.0
805,4,1,-3,881705456,881705488,32,1071,545,1.7142857142857142
805,1,3,2,881705488,881705534,46,545,167,2.8181818181818183
805,3,3,0,881705534,881705592,58,167,412,2.272727272727273
805,3,3,0,881705592,881705637,45,412,1054,2.5454545454545454
805,3,3,0,881705637,881705672,35,1054,725,3.0
805,3,3,0,881705672,881705765,93,725,143,3.56
805,3,5,2,881705765,881705810,45,143,151,3.6544117647058822
805,5,3,-2,881705810,881705892,82,151,140,3.238095238095238
805,3,2,-1,881705892,881705918,26,140,417,3.0588235294117645
805,2,2,0,881705918,881706049,131,417,768,3.238095238095238
805,2,3,1,881706049,881706146,97,768,1033,3.0
806,2,3,1,882384589,882384656,67,690,343,3.0
806,3,3,0,882384656,882384802,146,343,875,2.736842105263158
806,3,3,0,882384802,882384844,42,875,271,3.3134328358208953
806,3,2,-1,882384844,882384988,144,271,181,3.98974358974359
806,2,4,2,882384988,882385083,95,181,475,3.956043956043956
806,4,5,1,882385083,882385200,117,475,50,4.306532663316583
806,5,4,-1,882385200,882385278,78,50,1012,3.2916666666666665
806,4,3,-1,882385278,882385309,31,1012,628,3.573529411764706
806,3,3,0,882385309,882385394,85,628,24,3.3728813559322033
806,3,3,0,882385394,882385455,61,24,455,3.1702127659574466
806,3,4,1,882385455,882385563,108,455,150,3.803921568627451
806,4,2,-2,882385563,882385578,15,150,952,3.3529411764705883
806,2,3,1,882385578,882385643,65,952,1514,3.6666666666666665
806,3,3,0,882385643,882385694,51,1514,122,2.282608695652174
806,3,3,0,882385694,882385762,68,122,405,3.25
806,3,3,0,882385762,882385806,44,405,1010,3.611111111111111
806,3,1,-2,882385806,882386110,304,1010,1016,3.559322033898305
806,1,5,4,882386110,882386323,213,1016,127,4.162790697674419
806,5,3,-2,882386323,882387373,1050,127,357,4.063291139240507
806,3,4,1,882387373,882387409,36,357,483,4.475609756097561
806,4,3,-1,882387409,882387448,39,483,79,3.956989247311828
806,3,5,2,882387448,882387484,36,79,318,4.5046728971962615
806,5,5,0,882387484,882387520,36,318,210,3.921259842519685
806,5,4,-1,882387520,882387563,43,210,47,3.5869565217391304
806,4,4,0,882387563,882387595,32,47,705,3.7857142857142856
806,4,5,1,882387595,882387644,49,705,856,4.142857142857143
806,5,5,0,882387644,882387670,26,856,187,4.215189873417722
806,5,4,-1,882387670,882387728,58,187,197,4.112676056338028
806,4,5,1,882387728,882387756,28,197,169,4.548387096774194
806,5,5,0,882387756,882387798,42,169,176,3.967032967032967
806,5,5,0,882387798,882387870,72,176,179,3.8823529411764706
806,5,3,-2,882387870,882387974,104,179,157,3.5714285714285716
806,3,5,2,882387974,882387999,25,157,56,4.051724137931035
806,5,4,-1,882387999,882388036,37,56,234,3.7674418604651163
806,4,4,0,882388036,882388082,46,234,180,3.9473684210526314
806,4,4,0,882388082,882388128,46,180,216,3.8454545454545452
806,4,3,-1,882388128,882388159,31,216,188,3.625
806,3,5,2,882388159,882388204,45,188,12,4.358974358974359
806,5,5,0,882388204,882388205,1,12,204,3.6744186046511627
806,5,3,-2,882388205,882388231,26,204,518,3.5833333333333335
806,3,3,0,882388231,882388254,23,518,177,3.875
806,3,3,0,882388254,882388286,32,177,28,3.923076923076923
806,3,3,0,882388286,882388328,42,28,195,3.9072164948453607
806,3,5,2,882388328,882388381,53,195,485,3.717948717948718
806,5,3,-2,882388381,882388419,38,485,128,3.45
806,3,4,1,882388419,882388520,101,128,230,3.3518518518518516
806,4,3,-1,882388520,882388557,37,230,162,3.4651162790697674
806,3,2,-1,882388557,882388628,71,162,70,3.5833333333333335
806,2,4,2,882388628,882388658,30,70,153,3.7865168539325844
806,4,4,0,882388658,882388706,48,153,403,3.298507462686567
806,4,3,-1,882388706,882388795,89,403,702,2.764705882352941
806,3,4,1,882388795,882388897,102,702,421,3.462962962962963
806,4,4,0,882388897,882388965,68,421,1071,3.0
806,4,3,-1,882388965,882389054,89,1071,76,3.1875
806,3,4,1,882389054,882389179,125,76,82,3.6741573033707864
806,4,4,0,882389179,882389230,51,82,228,3.7246376811594204
806,4,4,0,882389230,882389319,89,228,789,3.7777777777777777
806,4,4,0,882389319,882389506,187,789,17,3.032258064516129
806,4,4,0,882389506,882389523,17,17,433,3.8035714285714284
806,4,3,-1,882389523,882389831,308,433,553,3.5
806,3,3,0,882389831,882389862,31,553,2,3.0851063829787235
806,3,4,1,882389862,882389908,46,2,1018,3.0714285714285716
806,4,4,0,882389908,882390191,283,1018,88,3.433734939759036
806,4,4,0,882390191,882390296,105,88,29,2.5714285714285716
806,4,2,-2,882390296,882390404,108,29,158,2.7027027027027026
806,2,4,2,882390404,882390496,92,158,131,3.731707317073171
806,4,3,-1,882390496,882390515,19,131,1074,2.857142857142857
807,3,3,0,892527100,892527385,285,258,271,3.3134328358208953
807,3,3,0,892527385,892527569,184,271,678,2.8181818181818183
807,3,3,0,892527569,892527606,37,678,358,2.6551724137931036
807,3,4,1,892527606,892527665,59,358,289,2.988888888888889
807,4,3,-1,892527665,892528110,445,289,505,4.0625
807,3,4,1,892528110,892528174,64,505,222,3.578125
807,4,4,0,892528174,892528231,57,222,1,3.902439024390244
807,4,3,-1,892528231,892528285,54,1,173,4.1441441441441444
807,3,4,1,892528285,892528324,39,173,1039,3.9583333333333335
807,4,5,1,892528324,892528374,50,1039,199,4.191489361702128
807,5,4,-1,892528374,892528427,53,199,427,4.2025316455696204
807,4,4,0,892528427,892528470,43,427,89,3.9615384615384617
807,4,5,1,892528470,892528515,45,89,172,4.225225225225225
807,5,3,-2,892528515,892528564,49,172,96,3.9130434782608696
807,3,3,0,892528564,892528605,41,96,205,3.717391304347826
807,3,5,2,892528605,892528646,41,205,527,3.823529411764706
807,5,5,0,892528646,892528690,44,527,612,4.0
807,5,3,-2,892528690,892528771,81,612,416,3.3846153846153846
807,3,5,2,892528771,892528813,42,416,419,3.8208955223880596
807,5,5,0,892528813,892528866,53,419,174,4.253521126760563
807,5,5,0,892528866,892528918,52,174,496,4.094594594594595
807,5,2,-3,892528918,892528919,1,496,154,3.6031746031746033
807,2,4,2,892528919,892529112,193,154,1063,3.642857142857143
807,4,4,0,892529112,892529150,38,1063,498,4.290909090909091
807,4,4,0,892529150,892529185,35,498,95,3.8194444444444446
807,4,5,1,892529185,892529311,126,95,1050,3.6153846153846154
807,5,4,-1,892529311,892529358,47,1050,418,3.825
807,4,5,1,892529358,892529401,43,418,510,3.823529411764706
807,5,4,-1,892529401,892529448,47,510,465,3.75
807,4,4,0,892529448,892529483,35,465,193,3.883720930232558
807,4,4,0,892529483,892529519,36,193,1084,4.0
807,4,3,-1,892529519,892529647,128,1084,127,4.162790697674419
807,3,4,1,892529647,892529713,66,127,118,3.2764227642276422
807,4,5,1,892529713,892529756,43,118,483,4.475609756097561
807,5,3,-2,892529756,892529805,49,483,421,3.462962962962963
807,3,5,2,892529805,892529851,46,421,684,3.847826086956522
807,5,4,-1,892529851,892529893,42,684,168,4.0476190476190474
807,4,4,0,892529893,892530003,110,168,132,3.929411764705882
807,4,2,-2,892530003,892530004,1,132,381,3.2758620689655173
807,2,5,3,892530004,892530061,57,381,526,3.909090909090909
807,5,5,0,892530061,892530112,51,526,451,3.207792207792208
807,5,4,-1,892530112,892530216,104,451,230,3.3518518518518516
807,4,5,1,892530216,892530251,35,230,588,3.8358208955223883
807,5,4,-1,892530251,892530349,98,588,385,3.6129032258064515
807,4,4,0,892530349,892530439,90,385,428,3.744186046511628
807,4,5,1,892530439,892530498,59,428,432,3.719298245614035
807,5,4,-1,892530498,892530626,128,432,29,2.5714285714285716
807,4,3,-1,892530626,892530656,30,29,622,3.3333333333333335
807,3,4,1,892530656,892530752,96,622,636,3.4146341463414633
807,4,4,0,892530752,892530792,40,636,596,3.180327868852459
807,4,4,0,892530792,892530881,89,596,831,2.6097560975609757
807,4,4,0,892530881,892530966,85,831,484,4.116279069767442
807,4,3,-1,892530966,892532030,1064,484,73,3.588235294117647
807,3,3,0,892532030,892532068,38,73,820,3.0444444444444443
807,3,4,1,892532068,892684456,152388,820,627,3.3823529411764706
807,4,4,0,892684456,892684529,73,627,554,2.9555555555555557
807,4,3,-1,892684529,892684576,47,554,141,3.4827586206896552
807,3,2,-1,892684576,892684615,39,141,843,2.933333333333333
807,2,5,3,892684615,892684675,60,843,91,3.6
807,5,4,-1,892684675,892684722,47,91,405,3.25
807,4,2,-2,892684722,892684932,210,405,206,3.0
807,2,5,3,892684932,892705096,20164,206,402,3.3076923076923075
807,5,4,-1,892705096,892705191,95,402,177,3.875
807,4,4,0,892705191,892705239,48,177,68,3.5714285714285716
807,4,4,0,892705239,892705277,38,68,597,3.2771084337349397
807,4,5,1,892705277,892705362,85,597,135,3.7974683544303796
807,5,4,-1,892705362,892775458,70096,135,477,3.1666666666666665
807,4,2,-2,892775458,892823225,47767,477,94,2.8823529411764706
807,2,3,1,892823225,892978296,155071,94,625,3.25
807,3,4,1,892978296,892978338,42,625,2,3.0851063829787235
807,4,4,0,892978338,892979116,778,2,403,3.298507462686567
807,4,3,-1,892979116,892979256,140,403,62,3.048780487804878
807,3,3,0,892979256,892979368,112,62,420,3.5652173913043477
807,3,4,1,892979368,892979501,133,420,102,3.3684210526315788
807,4,4,0,892979501,892979600,99,102,842,3.0
807,4,4,0,892979600,892979639,39,842,1078,2.625
807,4,5,1,892979639,892979747,108,1078,550,3.272727272727273
807,5,4,-1,892979747,893080516,100769,550,386,2.769230769230769
807,4,4,0,893080516,893080637,121,386,101,3.4827586206896552
807,4,4,0,893080637,893080801,164,101,720,3.2
807,4,4,0,893080801,893080838,37,720,384,2.7941176470588234
807,4,3,-1,893080838,893081338,500,384,946,3.1153846153846154
807,3,4,1,893081338,893081426,88,946,570,3.526315789473684
807,4,5,1,893081426,893081508,82,570,1066,3.2
807,5,3,-2,893081508,893081656,148,1066,998,2.7777777777777777
807,3,3,0,893081656,893082505,849,998,826,2.5555555555555554
807,3,5,2,893082505,893082544,39,826,1034,2.6
807,5,1,-4,893082544,893082619,75,1034,1411,2.4615384615384617
807,1,3,2,893082619,893082702,83,1411,415,2.6666666666666665
807,3,3,0,893082702,893082703,1,415,1091,2.5384615384615383
807,3,4,1,893082703,893082741,38,1091,422,3.25
807,4,5,1,893082741,893082778,37,422,930,2.793103448275862
807,5,5,0,893082778,893082893,115,930,449,2.9069767441860463
807,5,3,-2,893082893,893083109,216,449,374,2.111111111111111
807,3,3,0,893083109,893083179,70,374,1274,1.8
807,3,3,0,893083179,893083216,37,1274,743,1.9545454545454546
807,3,4,1,893083216,893083851,635,743,298,3.779220779220779
807,4,4,0,893083851,893084689,838,298,252,2.911392405063291
807,4,4,0,893084689,893084724,35,252,1089,2.1363636363636362
797,3,2,-1,879438992,879439031,39,309,300,3.6861313868613137
797,2,2,0,879439031,879439104,73,300,243,2.357142857142857
797,2,1,-1,879439104,879439105,1,243,748,3.1043478260869564
797,1,2,1,879439105,879439136,31,748,336,2.4
797,2,2,0,879439136,879439190,54,336,307,3.6031746031746033
797,2,1,-1,879439190,879439230,40,307,948,2.2962962962962963
797,1,4,3,879439230,879439297,67,948,127,4.162790697674419
797,4,5,1,879439297,879439314,17,127,50,4.306532663316583
797,5,5,0,879439314,879439362,48,50,181,3.98974358974359
797,5,2,-3,879439362,879439456,94,181,990,2.769230769230769
797,2,2,0,879439456,879439548,92,990,1254,2.4
797,2,5,3,879439548,879439594,46,1254,781,3.4166666666666665
801,5,5,0,890332719,890332748,29,332,300,3.6861313868613137
801,5,5,0,890332748,890332775,27,300,682,3.0476190476190474
801,5,5,0,890332775,890332820,45,682,288,3.5214285714285714
801,5,4,-1,890332820,890332853,33,288,752,3.6666666666666665
801,4,4,0,890332853,890332885,32,752,326,3.262295081967213
801,4,3,-1,890332885,890332929,44,326,355,2.75
801,3,3,0,890332929,890332986,57,355,259,2.492063492063492
801,3,2,-1,890332986,890333011,25,259,299,3.0
801,2,3,1,890333011,890333042,31,299,245,3.056179775280899
801,3,4,1,890333042,890333094,52,245,358,2.6551724137931036
801,4,2,-2,890333094,890333150,56,358,890,1.7692307692307692
809,4,5,1,891036744,891036809,65,340,307,3.6031746031746033
809,5,4,-1,891036809,891036903,94,307,300,3.6861313868613137
809,4,5,1,891036903,891036989,86,300,328,3.4895833333333335
809,5,1,-4,891036989,891037020,31,328,289,2.988888888888889
809,1,4,3,891037020,891037069,49,289,299,3.0
809,4,3,-1,891037069,891037091,22,299,748,3.1043478260869564
809,3,2,-1,891037091,891037172,81,748,678,2.8181818181818183
809,2,1,-1,891037172,891037205,33,678,1025,2.95
815,1,5,4,878691779,878691844,65,250,181,3.98974358974359
815,5,3,-2,878691844,878691884,40,181,117,3.689189189189189
815,3,4,1,878691884,878691975,91,117,7,3.76056338028169
815,4,4,0,878691975,878692016,41,7,713,3.5
815,4,5,1,878692016,878692043,27,713,596,3.180327868852459
815,5,4,-1,878692043,878692071,28,596,405,3.25
815,4,2,-2,878692071,878692149,78,405,471,3.5714285714285716
815,2,4,2,878692149,878692207,58,471,151,3.6544117647058822
815,4,5,1,878692207,878692242,35,151,125,3.5555555555555554
815,5,2,-3,878692242,878692319,77,125,240,3.0350877192982457
815,2,2,0,878692319,878692344,25,240,121,3.521212121212121
815,2,3,1,878692344,878693183,839,121,518,3.5833333333333335
815,3,5,2,878693183,878693381,198,518,190,4.233333333333333
815,5,4,-1,878693381,878693462,81,190,523,4.159090909090909
815,4,5,1,878693462,878693870,408,523,1039,3.9583333333333335
815,5,4,-1,878693870,878693871,1,1039,204,3.6744186046511627
815,4,5,1,878693871,878693906,35,204,357,4.063291139240507
815,5,4,-1,878693906,878693989,83,357,144,3.9545454545454546
815,4,5,1,878693989,878694027,38,144,496,4.094594594594595
815,5,3,-2,878694027,878694028,1,496,102,3.3684210526315788
815,3,4,1,878694028,878694055,27,102,199,4.191489361702128
815,4,5,1,878694055,878694106,51,199,732,3.6266666666666665
815,5,5,0,878694106,878694199,93,732,87,3.9
815,5,2,-3,878694199,878694228,29,87,179,3.8823529411764706
815,2,3,1,878694228,878694269,41,179,835,4.0
815,3,4,1,878694269,878694341,72,835,202,3.730337078651685
815,4,5,1,878694341,878694381,40,202,183,3.951219512195122
815,5,5,0,878694381,878694453,72,183,154,3.6031746031746033
815,5,2,-3,878694453,878694493,40,154,135,3.7974683544303796
815,2,5,3,878694493,878694563,70,135,239,3.423076923076923
815,5,5,0,878694563,878694613,50,239,133,3.7777777777777777
815,5,3,-2,878694613,878694664,51,133,603,4.315789473684211
815,3,4,1,878694664,878694665,1,603,99,3.8392857142857144
815,4,4,0,878694665,878694705,40,99,176,3.967032967032967
815,4,5,1,878694705,878694735,30,176,228,3.7246376811594204
815,5,5,0,878694735,878694820,85,228,215,3.662921348314607
815,5,5,0,878694820,878694854,34,215,57,4.133333333333334
815,5,3,-2,878694854,878694952,98,57,175,3.8354430379746836
815,3,5,2,878694952,878694983,31,175,613,4.1
815,5,4,-1,878694983,878695020,37,613,153,3.7865168539325844
815,4,3,-1,878695020,878695055,35,153,443,3.8421052631578947
815,3,5,2,878695055,878695092,37,443,686,3.9
815,5,2,-3,878695092,878695147,55,686,227,3.169811320754717
815,2,4,2,878695147,878695176,29,227,88,3.433734939759036
815,4,5,1,878695176,878695241,65,88,173,4.1441441441441444
815,5,4,-1,878695241,878695278,37,173,195,3.9072164948453607
815,4,5,1,878695278,878695311,33,195,136,3.764705882352941
815,5,5,0,878695311,878695438,127,136,402,3.3076923076923075
815,5,3,-2,878695438,878695490,52,402,419,3.8208955223880596
815,3,3,0,878695490,878695527,37,419,229,3.185185185185185
815,3,2,-1,878695527,878695645,118,229,158,2.7027027027027026
815,2,4,2,878695645,878695679,34,158,671,3.4285714285714284
815,4,4,0,878695679,878695744,65,671,418,3.825
815,4,4,0,878695744,878695798,54,418,77,3.3857142857142857
815,4,3,-1,878695798,878695877,79,77,559,3.477272727272727
815,3,3,0,878695877,878695964,87,559,614,3.727272727272727
815,3,4,1,878695964,878696054,90,614,193,3.883720930232558
815,4,4,0,878696054,878696093,39,193,526,3.909090909090909
815,4,2,-2,878696093,878696181,88,526,615,3.8333333333333335
815,2,4,2,878696181,878696441,260,615,660,3.71875
815,4,4,0,878696441,878696473,32,660,393,3.5125
815,4,3,-1,878696473,878696563,90,393,712,3.0434782608695654
815,3,3,0,878696563,878696619,56,712,434,3.588235294117647
815,3,4,1,878696619,878696650,31,434,203,3.826923076923077
815,4,2,-2,878696650,878696681,31,203,639,4.083333333333333
815,2,3,1,878696681,878696840,159,639,91,3.6
815,3,3,0,878696840,878696965,125,91,451,3.207792207792208
815,3,3,0,878696965,878697015,50,451,1299,2.5
815,3,4,1,878697015,878697163,148,1299,392,3.5555555555555554
815,4,1,-3,878697163,878697189,26,392,616,3.1052631578947367
815,1,4,3,878697189,878697532,343,616,403,3.298507462686567
815,4,3,-1,878697532,878697705,173,403,94,2.8823529411764706
815,3,2,-1,878697705,878697734,29,94,391,2.4285714285714284
815,2,2,0,878697734,878698449,715,391,131,3.731707317073171
815,2,2,0,878698449,878698525,76,131,665,2.72972972972973
815,2,2,0,878698525,878698553,28,665,210,3.921259842519685
815,2,2,0,878698553,878698661,108,210,449,2.9069767441860463
815,2,2,0,878698661,884267891,5569230,449,252,2.911392405063291
815,2,4,2,884267891,884320310,52419,252,258,3.7547169811320753
815,4,5,1,884320310,887978255,3657945,258,528,4.241379310344827
817,4,4,0,874815542,874815593,51,876,294,3.1052631578947367
817,4,4,0,874815593,874815679,86,294,358,2.6551724137931036
817,4,3,-1,874815679,874815835,156,358,121,3.521212121212121
817,3,3,0,874815835,874815836,1,121,9,3.8878504672897196
817,3,4,1,874815836,874815885,49,9,7,3.76056338028169
817,4,3,-1,874815885,874815947,62,7,455,3.1702127659574466
821,2,4,2,874792285,874792403,118,100,476,3.1216216216216215
821,4,3,-1,874792403,874792442,39,476,117,3.689189189189189
821,3,5,2,874792442,874792491,49,117,237,3.7315436241610738
821,5,4,-1,874792491,874792521,30,237,181,3.98974358974359
821,4,5,1,874792521,874792591,70,181,845,3.661290322580645
821,5,3,-2,874792591,874792650,59,845,148,3.2131147540983607
821,3,5,2,874792650,874792698,48,148,459,3.875
821,5,5,0,874792698,874792778,80,459,274,3.5609756097560976
821,5,5,0,874792778,874792813,35,274,1,3.902439024390244
821,5,5,0,874792813,874792835,22,1,15,3.725663716814159
821,5,4,-1,874792835,874792860,25,15,125,3.5555555555555554
821,4,4,0,874792860,874792889,29,125,151,3.6544117647058822
821,4,4,0,874792889,874793049,160,151,111,3.5106382978723403
821,4,2,-2,874793049,874793196,147,111,106,2.8125
821,2,3,1,874793196,874793218,22,106,118,3.2764227642276422
821,3,5,2,874793218,874793368,150,118,318,4.5046728971962615
821,5,5,0,874793368,874793469,101,318,28,3.923076923076923
821,5,5,0,874793469,874793517,48,28,180,3.9473684210526314
821,5,5,0,874793517,874793574,57,180,495,3.65
821,5,5,0,874793574,874793649,75,495,705,3.7857142857142856
821,5,4,-1,874793649,874793773,124,705,435,3.8933333333333335
821,4,5,1,874793773,874793806,33,435,213,3.943396226415094
821,5,5,0,874793806,874793847,41,213,56,4.051724137931035
821,5,5,0,874793847,874793848,1,56,97,3.7282608695652173
821,5,4,-1,874793848,874793898,50,97,161,3.5844155844155843
821,4,4,0,874793898,874793933,35,161,70,3.5833333333333335
821,4,5,1,874793933,874793969,36,70,71,3.6575342465753424
818,5,5,0,891870222,891870264,42,303,302,4.133333333333334
818,5,4,-1,891870264,891870301,37,302,258,3.7547169811320753
818,4,4,0,891870301,891870364,63,258,346,3.5128205128205128
818,4,2,-2,891870364,891870389,25,346,322,3.0476190476190474
818,2,5,3,891870389,891870473,84,322,751,3.3896103896103895
818,5,4,-1,891870473,891870515,42,751,245,3.056179775280899
818,4,2,-2,891870515,891870546,31,245,312,3.0
818,2,1,-1,891870546,891870590,44,312,875,2.736842105263158
814,3,3,0,885410957,885411030,73,234,448,3.466666666666667
814,3,4,1,885411030,885411073,43,448,7,3.76056338028169
814,4,3,-1,885411073,885411132,59,7,559,3.477272727272727
814,3,2,-1,885411132,885411204,72,559,667,2.4285714285714284
814,2,2,0,885411204,885411347,143,667,441,2.4
812,3,5,2,877625224,877625294,70,1393,333,3.546666666666667
812,5,2,-3,877625294,877625367,73,333,245,3.056179775280899
812,2,3,1,877625367,877625461,94,245,358,2.6551724137931036
812,3,4,1,877625461,877625537,76,358,873,2.7586206896551726
823,5,4,-1,878437589,878437658,69,174,426,3.1
823,4,4,0,878437658,878437703,45,426,195,3.9072164948453607
823,4,5,1,878437703,878437753,50,195,64,4.373737373737374
823,5,3,-2,878437753,878437836,83,64,1135,3.0526315789473686
823,3,5,2,878437836,878437890,54,1135,98,4.240875912408759
823,5,3,-2,878437890,878438024,134,98,83,4.204081632653061
823,3,5,2,878438024,878438057,33,83,238,3.888888888888889
823,5,5,0,878438057,878438058,1,238,22,4.215909090909091
823,5,5,0,878438058,878438095,37,22,69,3.8015873015873014
823,5,5,0,878438095,878438119,24,69,56,4.051724137931035
823,5,5,0,878438119,878438148,29,56,173,4.1441441441441444
823,5,3,-2,878438148,878438179,31,173,222,3.578125
823,3,4,1,878438179,878438206,27,222,111,3.5106382978723403
823,4,4,0,878438206,878438232,26,111,160,3.4
823,4,4,0,878438232,878438260,28,160,182,3.842857142857143
823,4,5,1,878438260,878438297,37,182,475,3.956043956043956
823,5,5,0,878438297,878438298,1,475,7,3.76056338028169
823,5,3,-2,878438298,878438332,34,7,33,3.2941176470588234
823,3,4,1,878438332,878438379,47,33,135,3.7974683544303796
823,4,5,1,878438379,878438435,56,135,50,4.306532663316583
823,5,4,-1,878438435,878438457,22,50,710,3.41025641025641
823,4,4,0,878438457,878438484,27,710,141,3.4827586206896552
823,4,4,0,878438484,878438511,27,141,1067,3.533333333333333
823,4,4,0,878438511,878438535,24,1067,410,3.0434782608695654
823,4,4,0,878438535,878438552,17,410,90,3.0
823,4,5,1,878438552,878438584,32,90,216,3.8454545454545452
823,5,4,-1,878438584,878438585,1,216,747,3.5526315789473686
823,4,5,1,878438585,878438607,22,747,4,3.5538461538461537
823,5,3,-2,878438607,878438642,35,4,25,3.3185840707964602
823,3,4,1,878438642,878438672,30,25,418,3.825
823,4,4,0,878438672,878438695,23,418,721,3.4583333333333335
823,4,4,0,878438695,878438732,37,721,151,3.6544117647058822
823,4,1,-3,878438732,878438733,1,151,374,2.111111111111111
823,1,5,4,878438733,878438780,47,374,89,3.9615384615384617
823,5,4,-1,878438780,878438856,76,89,153,3.7865168539325844
823,4,5,1,878438856,878438887,31,153,87,3.9
823,5,4,-1,878438887,878438930,43,87,204,3.6744186046511627
823,4,4,0,878438930,878438958,28,204,77,3.3857142857142857
823,4,4,0,878438958,878438959,1,77,239,3.423076923076923
823,4,4,0,878438959,878439008,49,239,180,3.9473684210526314
823,4,4,0,878439008,878439037,29,180,237,3.7315436241610738
823,4,4,0,878439037,878439038,1,237,79,3.956989247311828
823,4,4,0,878439038,878439065,27,79,198,4.04
823,4,4,0,878439065,878439089,24,198,206,3.0
823,4,4,0,878439089,878439113,24,206,478,4.161290322580645
823,4,5,1,878439113,878439136,23,478,194,4.029411764705882
823,5,5,0,878439136,878439183,47,194,732,3.6266666666666665
823,5,5,0,878439183,878439211,28,732,196,3.9404761904761907
823,5,5,0,878439211,878439229,18,196,53,2.9523809523809526
823,5,4,-1,878439229,878439257,28,53,95,3.8194444444444446
823,4,3,-1,878439257,878439293,36,95,568,3.5853658536585367
823,3,5,2,878439293,878439315,22,568,503,3.6363636363636362
823,5,3,-2,878439315,878439337,22,503,231,2.938775510204082
823,3,3,0,878439337,878439365,28,231,91,3.6
823,3,4,1,878439365,878439391,26,91,66,3.4705882352941178
823,4,1,-3,878439391,878439412,21,66,450,2.2758620689655173
823,1,4,3,878439412,878439438,26,450,692,3.56
823,4,3,-1,878439438,878439467,29,692,356,3.2
823,3,2,-1,878439467,878439497,30,356,94,2.8823529411764706
823,2,4,2,878439497,878439498,1,94,210,3.921259842519685
823,4,4,0,878439498,878439557,59,210,762,3.3962264150943398
823,4,4,0,878439557,878439582,25,762,739,3.391304347826087
823,4,3,-1,878439582,878439605,23,739,52,3.727272727272727
823,3,3,0,878439605,878439629,24,52,184,3.393939393939394
823,3,4,1,878439629,878439655,26,184,17,3.032258064516129
823,4,3,-1,878439655,878439845,190,17,333,3.546666666666667
823,3,3,0,878439845,878439981,136,333,294,3.1052631578947367
825,3,5,2,880755418,880755612,194,9,7,3.76056338028169
825,5,3,-2,880755612,880755693,81,7,249,3.3275862068965516
825,3,4,1,880755693,880755762,69,249,1199,2.6666666666666665
825,4,4,0,880755762,880755869,107,1199,248,3.746268656716418
825,4,4,0,880755869,880755942,73,248,100,4.0162162162162165
825,4,3,-1,880755942,880755982,40,100,126,3.8620689655172415
825,3,5,2,880755982,880756076,94,126,121,3.521212121212121
825,5,3,-2,880756076,880756077,1,121,1016,3.559322033898305
825,3,2,-1,880756077,880756320,243,1016,740,3.423076923076923
825,2,4,2,880756320,880756321,1,740,685,3.2666666666666666
825,4,5,1,880756321,880756401,80,685,273,3.5238095238095237
825,5,3,-2,880756401,880756402,1,273,1117,3.0
825,3,5,2,880756402,880756442,40,1117,405,3.25
825,5,3,-2,880756442,880756504,62,405,285,4.181818181818182
825,3,3,0,880756504,880756603,99,285,284,3.1547619047619047
825,3,4,1,880756603,880756725,122,284,148,3.2131147540983607
825,4,5,1,880756725,880756726,1,148,298,3.779220779220779
825,5,3,-2,880756726,880756796,70,298,831,2.6097560975609757
825,3,4,1,880756796,880756834,38,831,619,3.4782608695652173
825,4,3,-1,880756834,880756862,28,619,932,2.5
825,3,4,1,880756862,880756904,42,932,25,3.3185840707964602
825,4,5,1,880756904,880756933,29,25,597,3.2771084337349397
825,5,3,-2,880756933,880756934,1,597,1047,2.6923076923076925
825,3,5,2,880756934,880757103,169,1047,252,2.911392405063291
825,5,4,-1,880757103,880931887,174784,252,257,3.7154471544715446
825,4,3,-1,880931887,880931932,45,257,870,2.75
825,3,4,1,880931932,881101329,169397,870,833,2.9444444444444446
825,4,5,1,881101329,881101641,312,833,385,3.6129032258064515
825,5,4,-1,881101641,881101782,141,385,491,3.55
825,4,5,1,881101782,882109250,1007468,491,687,2.1481481481481484
825,5,1,-4,882109250,889020680,6911430,687,1008,3.5
825,1,3,2,889020680,889020779,99,1008,16,3.411764705882353
825,3,4,1,889020779,889020826,47,16,274,3.5609756097560976
825,4,3,-1,889020826,889020852,26,274,120,2.3421052631578947
825,3,3,0,889020852,889020961,109,120,696,3.138888888888889
825,3,3,0,889020961,889021037,76,696,1028,2.857142857142857
825,3,4,1,889021037,889021088,51,1028,717,2.9696969696969697
825,4,1,-3,889021088,889021209,121,717,122,2.282608695652174
825,1,2,1,889021209,889021235,26,122,130,1.8461538461538463
825,2,2,0,889021235,889021258,23,130,1291,2.125
825,2,3,1,889021258,889021287,29,1291,931,2.2758620689655173
827,4,3,-1,882201532,882201725,193,343,300,3.6861313868613137
827,3,4,1,882201725,882201885,160,300,301,3.2465753424657535
827,4,3,-1,882201885,882807571,605686,301,289,2.988888888888889
827,3,3,0,882807571,882807787,216,289,329,3.25
827,3,2,-1,882807787,882808622,835,329,358,2.6551724137931036
827,2,3,1,882808622,892157221,9348599,358,313,4.323076923076923
827,3,3,0,892157221,892157242,21,313,333,3.546666666666667
827,3,3,0,892157242,892157262,20,333,316,4.285714285714286
827,3,3,0,892157262,892157282,20,316,938,2.5555555555555554
827,3,3,0,892157282,892157356,74,938,347,3.59375
827,3,3,0,892157356,892157376,20,347,331,3.5517241379310347
829,4,3,-1,881086933,881086959,26,13,410,3.0434782608695654
829,3,4,1,881086959,881698803,611844,410,515,4.202898550724638
829,4,4,0,881698803,881698876,73,515,190,4.233333333333333
829,4,4,0,881698876,881698933,57,190,170,4.242424242424242
829,4,4,0,881698933,881698934,1,170,855,3.590909090909091
829,4,5,1,881698934,881698976,42,855,509,3.7058823529411766
829,5,4,-1,881698976,881699005,29,509,639,4.083333333333333
829,4,4,0,881699005,881699060,55,639,582,3.7457627118644066
829,4,4,0,881699060,881699584,524,582,257,3.7154471544715446
829,4,3,-1,881699584,881712349,12765,257,281,3.2
829,3,1,-2,881712349,881712488,139,281,278,3.0357142857142856
829,1,5,4,881712488,881712519,31,278,192,4.090909090909091
829,5,3,-2,881712519,891990619,10278100,192,125,3.5555555555555554
829,3,3,0,891990619,891990650,31,125,845,3.661290322580645
829,3,4,1,891990650,891990672,22,845,151,3.6544117647058822
829,4,4,0,891990672,891990694,22,151,276,3.6036036036036037
829,4,4,0,891990694,891990718,24,276,475,3.956043956043956
829,4,4,0,891990718,891990842,124,475,1067,3.533333333333333
829,4,2,-2,891990842,891992167,1325,1067,339,2.7058823529411766
829,2,4,2,891992167,892312770,320603,339,275,4.087912087912088
829,4,4,0,892312770,892312784,14,275,124,4.052631578947368
811,3,4,1,886377041,886377082,41,292,308,3.6153846153846154
811,4,5,1,886377082,886377248,166,308,690,3.260869565217391
811,5,5,0,886377248,886377373,125,690,300,3.6861313868613137
811,5,5,0,886377373,886377530,157,300,301,3.2465753424657535
811,5,5,0,886377530,886377579,49,301,323,3.0
811,5,4,-1,886377579,886377771,192,323,901,2.0
830,4,5,1,891462185,891462531,346,310,205,3.717391304347826
830,5,4,-1,891462531,891462594,63,205,87,3.9
830,4,3,-1,891462594,891561540,98946,87,418,3.825
830,3,3,0,891561540,891561541,1,418,625,3.25
830,3,5,2,891561541,891561606,65,625,172,4.225225225225225
830,5,5,0,891561606,891561607,1,172,210,3.921259842519685
830,5,4,-1,891561607,891561673,66,210,510,3.823529411764706
830,4,5,1,891561673,891561737,64,510,435,3.8933333333333335
830,5,4,-1,891561737,891561870,133,435,177,3.875
830,4,2,-2,891561870,891561937,67,177,229,3.185185185185185
830,2,2,0,891561937,891561938,1,229,231,2.938775510204082
830,2,5,3,891561938,891561999,61,231,554,2.9555555555555557
830,5,4,-1,891561999,891898211,336212,554,968,3.75
830,4,5,1,891898211,891898415,204,968,193,3.883720930232558
830,5,3,-2,891898415,891898551,136,193,204,3.6744186046511627
830,3,4,1,891898551,891898603,52,204,613,4.1
830,4,1,-3,891898603,891899476,873,613,790,2.8518518518518516
830,1,5,4,891899476,891899535,59,790,498,4.290909090909091
830,5,4,-1,891899535,892503035,603500,498,451,3.207792207792208
830,4,4,0,892503035,892503093,58,451,402,3.3076923076923075
826,3,4,1,885689821,885689892,71,332,309,2.3333333333333335
826,4,4,0,885689892,885689918,26,309,748,3.1043478260869564
826,4,4,0,885689918,885689942,24,748,678,2.8181818181818183
826,4,4,0,885689942,885690022,80,678,271,3.3134328358208953
826,4,5,1,885690022,885690046,24,271,343,3.0
826,5,4,-1,885690046,885690064,18,343,336,2.4
826,4,5,1,885690064,885690342,278,336,71,3.6575342465753424
826,5,3,-2,885690342,885690379,37,71,99,3.8392857142857144
826,3,3,0,885690379,885690380,1,99,501,3.289473684210526
826,3,4,1,885690380,885690442,62,501,1219,3.142857142857143
826,4,4,0,885690442,885690481,39,1219,187,4.215189873417722
826,4,3,-1,885690481,885690482,1,187,82,3.6741573033707864
826,3,5,2,885690482,885690526,44,82,265,3.710144927536232
826,5,3,-2,885690526,885690600,74,265,33,3.2941176470588234
826,3,5,2,885690600,885690636,36,33,55,4.051282051282051
826,5,5,0,885690636,885690676,40,55,177,3.875
826,5,5,0,885690676,885690677,1,177,385,3.6129032258064515
826,5,2,-3,885690677,885690712,35,385,679,3.2432432432432434
826,2,4,2,885690712,885690713,1,679,227,3.169811320754717
826,4,4,0,885690713,885690749,36,227,554,2.9555555555555557
826,4,4,0,885690749,885690790,41,554,570,3.526315789473684
826,4,5,1,885690790,885690819,29,570,665,2.72972972972973
826,5,3,-2,885690819,885690854,35,665,810,2.9473684210526314
826,3,3,0,885690854,885690900,46,810,771,2.5714285714285716
831,2,4,2,891353940,891353979,39,327,331,3.5517241379310347
831,4,4,0,891353979,891354000,21,331,270,3.7804878048780486
831,4,4,0,891354000,891354020,20,270,905,3.357142857142857
831,4,4,0,891354020,891354043,23,905,294,3.1052631578947367
831,4,4,0,891354043,891354063,20,294,354,3.6923076923076925
831,4,4,0,891354063,891354064,1,354,690,3.260869565217391
831,4,3,-1,891354064,891354191,127,690,300,3.6861313868613137
831,3,2,-1,891354191,891354225,34,300,749,3.2777777777777777
831,2,2,0,891354225,891354226,1,749,245,3.056179775280899
831,2,4,2,891354226,891354275,49,245,326,3.262295081967213
831,4,2,-2,891354275,891354297,22,326,748,3.1043478260869564
831,2,3,1,891354297,891354338,41,748,316,4.285714285714286
831,3,2,-1,891354338,891354371,33,316,260,2.4716981132075473
831,2,1,-1,891354371,891354424,53,260,688,2.111111111111111
831,1,5,4,891354424,891354534,110,688,174,4.253521126760563
831,5,5,0,891354534,891354535,1,174,603,4.315789473684211
831,5,2,-3,891354535,891354612,77,603,208,3.8125
831,2,5,3,891354612,891354645,33,208,204,3.6744186046511627
831,5,5,0,891354645,891354668,23,204,96,3.9130434782608696
831,5,5,0,891354668,891354687,19,96,12,4.358974358974359
831,5,2,-3,891354687,891354726,39,12,741,3.3043478260869565
831,2,3,1,891354726,891354751,25,741,1119,3.5185185185185186
831,3,3,0,891354751,891354773,22,1119,273,3.5238095238095237
831,3,4,1,891354773,891354798,25,273,317,3.774193548387097
831,4,3,-1,891354798,891354815,17,317,150,3.803921568627451
831,3,5,2,891354815,891354900,85,150,50,4.306532663316583
831,5,5,0,891354900,891354931,31,50,250,3.4698795180722892
831,5,5,0,891354931,891354947,16,250,7,3.76056338028169
831,5,4,-1,891354947,891355004,57,7,591,3.7169811320754715
819,2,4,2,879952538,879952565,27,258,304,3.5306122448979593
819,4,5,1,879952565,879952627,62,304,340,3.7419354838709675
819,5,4,-1,879952627,879952656,29,340,327,3.5076923076923077
819,4,3,-1,879952656,879952688,32,327,245,3.056179775280899
819,3,4,1,879952688,880382533,429845,245,1160,4.1
819,4,2,-2,880382533,884012586,3630053,1160,862,1.6666666666666667
819,2,4,2,884012586,884012614,28,862,268,3.9838709677419355
819,4,4,0,884012614,884618137,605523,268,345,3.4782608695652173
828,4,3,-1,891033756,891034148,392,327,906,3.8333333333333335
828,3,3,0,891034148,891034237,89,906,288,3.5214285714285714
828,3,3,0,891034237,891034306,69,288,751,3.3896103896103895
828,3,3,0,891034306,891034515,209,751,322,3.0476190476190474
828,3,1,-2,891034515,891035438,923,322,886,2.857142857142857
828,1,5,4,891035438,891035613,175,886,19,3.9615384615384617
828,5,3,-2,891035613,891035614,1,19,224,3.4545454545454546
828,3,4,1,891035614,891035724,110,224,475,3.956043956043956
828,4,4,0,891035724,891035819,95,475,14,4.101694915254237
828,4,3,-1,891035819,891035970,151,14,10,3.85
828,3,3,0,891035970,891036568,598,10,171,4.090909090909091
828,3,3,0,891036568,891036630,62,171,462,3.7954545454545454
828,3,2,-1,891036630,891036717,87,462,463,3.6818181818181817
828,2,2,0,891036717,891036826,109,463,557,3.090909090909091
828,2,3,1,891036826,891036972,146,557,730,3.8
828,3,3,0,891036972,891037231,259,730,510,3.823529411764706
828,3,3,0,891037231,891037639,408,510,52,3.727272727272727
828,3,3,0,891037639,891037640,1,52,57,4.133333333333334
828,3,2,-1,891037640,891037722,82,57,1672,2.0
828,2,2,0,891037722,891037865,143,1672,213,3.943396226415094
828,2,5,3,891037865,891037948,83,213,512,3.888888888888889
828,5,2,-3,891037948,891038098,150,512,1268,3.5
828,2,5,3,891038098,891038262,164,1268,958,4.2
828,5,3,-2,891038262,891379818,341556,958,955,3.2666666666666666
828,3,4,1,891379818,891380167,349,955,60,4.105263157894737
828,4,3,-1,891380167,891380355,188,60,874,3.230769230769231
828,3,2,-1,891380355,893186163,1805808,874,246,4.0
828,2,3,1,893186163,893186210,47,246,70,3.5833333333333335
808,4,3,-1,883949519,883949560,41,333,751,3.3896103896103895
808,3,4,1,883949560,883949639,79,751,332,3.6511627906976742
808,4,4,0,883949639,883949681,42,332,300,3.6861313868613137
808,4,4,0,883949681,883949822,141,300,245,3.056179775280899
808,4,5,1,883949822,883949986,164,245,264,2.65
835,3,4,1,891032356,891032536,180,294,127,4.162790697674419
835,4,4,0,891032536,891032579,43,127,591,3.7169811320754715
835,4,4,0,891032579,891032627,48,591,685,3.2666666666666666
835,4,5,1,891032627,891032653,26,685,1278,3.8333333333333335
835,5,4,-1,891032653,891032718,65,1278,281,3.2
835,4,3,-1,891032718,891032738,20,281,257,3.7154471544715446
835,3,5,2,891032738,891032764,26,257,25,3.3185840707964602
835,5,4,-1,891032764,891032792,28,25,285,4.181818181818182
835,4,3,-1,891032792,891032793,1,285,405,3.25
835,3,3,0,891032793,891032899,106,405,928,3.142857142857143
835,3,3,0,891032899,891032930,31,928,628,3.573529411764706
835,3,4,1,891032930,891033048,118,628,527,3.823529411764706
835,4,5,1,891033048,891033173,125,527,196,3.9404761904761907
835,5,5,0,891033173,891033200,27,196,606,4.294117647058823
835,5,4,-1,891033200,891033276,76,606,191,4.168674698795181
835,4,5,1,891033276,891033303,27,191,210,3.921259842519685
835,5,5,0,891033303,891033349,46,210,735,3.58
835,5,3,-2,891033349,891033380,31,735,204,3.6744186046511627
835,3,3,0,891033380,891033420,40,204,1,3.902439024390244
835,3,5,2,891033420,891033501,81,1,97,3.7282608695652173
835,5,4,-1,891033501,891033526,25,97,157,3.5714285714285716
835,4,5,1,891033526,891033623,97,157,174,4.253521126760563
835,5,5,0,891033623,891033718,95,174,133,3.7777777777777777
835,5,5,0,891033718,891033747,29,133,632,3.9523809523809526
835,5,5,0,891033747,891033772,25,632,504,4.085714285714285
835,5,5,0,891033772,891033819,47,504,143,3.56
835,5,3,-2,891033819,891033857,38,143,588,3.8358208955223883
835,3,5,2,891033857,891033889,32,588,197,4.112676056338028
835,5,3,-2,891033889,891033957,68,197,465,3.75
835,3,4,1,891033957,891033986,29,465,660,3.71875
835,4,3,-1,891033986,891034023,37,660,1673,3.0
835,3,4,1,891034023,891034052,29,1673,28,3.923076923076923
835,4,3,-1,891034052,891034084,32,28,205,3.717391304347826
835,3,5,2,891034084,891034117,33,205,488,4.277777777777778
835,5,4,-1,891034117,891034143,26,488,194,4.029411764705882
835,4,3,-1,891034143,891034219,76,194,160,3.4
835,3,4,1,891034219,891034285,66,160,1063,3.642857142857143
835,4,4,0,891034285,891034310,25,1063,609,3.7058823529411766
835,4,5,1,891034310,891034366,56,609,69,3.8015873015873014
835,5,4,-1,891034366,891035310,944,69,23,3.9047619047619047
833,2,4,2,875035534,875035660,126,328,1386,4.0
833,4,3,-1,875035660,875035718,58,1386,129,3.744186046511628
833,3,3,0,875035718,875035800,82,129,980,3.142857142857143
833,3,5,2,875035800,875035850,50,980,1187,4.333333333333333
833,5,3,-2,875035850,875035885,35,1187,1353,3.0
833,3,4,1,875035885,875035914,29,1353,933,2.5
833,4,3,-1,875035914,875035953,39,933,7,3.76056338028169
833,3,3,0,875035953,875035954,1,7,273,3.5238095238095237
833,3,4,1,875035954,875036056,102,273,93,3.5641025641025643
833,4,2,-2,875036056,875036102,46,93,108,3.107142857142857
833,2,2,0,875036102,875036139,37,108,13,3.5454545454545454
833,2,4,2,875036139,875036169,30,13,100,4.0162162162162165
833,4,4,0,875036169,875036213,44,100,24,3.3728813559322033
833,4,2,-2,875036213,875036321,108,24,181,3.98974358974359
833,2,2,0,875036321,875036354,33,181,546,2.9789473684210526
833,2,5,3,875036354,875036383,29,546,298,3.779220779220779
833,5,4,-1,875036383,875036418,35,298,235,3.106382978723404
833,4,3,-1,875036418,875036468,50,235,742,3.5555555555555554
833,3,3,0,875036468,875036499,31,742,250,3.4698795180722892
833,3,3,0,875036499,875036912,413,250,696,3.138888888888889
833,3,2,-1,875036912,875038433,1521,696,1335,2.25
833,2,2,0,875038433,875038483,50,1335,118,3.2764227642276422
833,2,3,1,875038483,875038626,143,118,642,3.4285714285714284
833,3,4,1,875038626,875038671,45,642,504,4.085714285714285
833,4,3,-1,875038671,875038709,38,504,153,3.7865168539325844
833,3,4,1,875038709,875038742,33,153,511,4.096153846153846
833,4,4,0,875038742,875038775,33,511,156,4.017857142857143
833,4,5,1,875038775,875038807,32,156,589,4.384615384615385
833,5,5,0,875038807,875038850,43,589,11,3.8904109589041096
833,5,3,-2,875038850,875038888,38,11,434,3.588235294117647
833,3,5,2,875038888,875038987,99,434,134,4.174603174603175
833,5,2,-3,875038987,875039039,52,134,522,3.8461538461538463
833,2,4,2,875039039,875039101,62,522,1154,3.6
833,4,1,-3,875039101,875039153,52,1154,1006,2.7777777777777777
833,1,3,2,875039153,875039254,101,1006,79,3.956989247311828
833,3,1,-2,875039254,875039255,1,79,204,3.6744186046511627
833,1,3,2,875039255,875039326,71,204,208,3.8125
833,3,5,2,875039326,875039416,90,208,12,4.358974358974359
833,5,4,-1,875039416,875122716,83300,12,483,4.475609756097561
833,4,3,-1,875122716,875122884,168,483,234,3.7674418604651163
833,3,5,2,875122884,875123026,142,234,183,3.951219512195122
833,5,3,-2,875123026,875123195,169,183,684,3.847826086956522
833,3,4,1,875123195,875123299,104,684,445,3.727272727272727
833,4,3,-1,875123299,875123359,60,445,367,3.4242424242424243
833,3,5,2,875123359,875123427,68,367,646,3.9285714285714284
833,5,3,-2,875123427,875123494,67,646,1428,3.2857142857142856
833,3,3,0,875123494,875123506,12,1428,429,3.742857142857143
833,3,4,1,875123506,875123536,30,429,656,3.75
833,4,5,1,875123536,875123677,141,656,180,3.9473684210526314
833,5,3,-2,875123677,875123781,104,180,4,3.5538461538461537
833,3,5,2,875123781,875124181,400,4,179,3.8823529411764706
833,5,3,-2,875124181,875124225,44,179,664,3.15
833,3,5,2,875124225,875124348,123,664,187,4.215189873417722
833,5,2,-3,875124348,875124382,34,187,76,3.1875
833,2,1,-1,875124382,875124428,46,76,670,2.9375
833,1,4,3,875124428,875124495,67,670,218,3.5555555555555554
833,4,5,1,875124495,875124535,40,218,160,3.4
833,5,2,-3,875124535,875124604,69,160,860,1.8
833,2,4,2,875124604,875124647,43,860,320,4.75
833,4,3,-1,875124647,875124648,1,320,378,3.6904761904761907
833,3,4,1,875124648,875131847,7199,378,200,3.8157894736842106
833,4,3,-1,875131847,875131974,127,200,1427,2.3333333333333335
833,3,2,-1,875131974,875132079,105,1427,506,3.566666666666667
833,2,5,3,875132079,875132134,55,506,96,3.9130434782608696
833,5,2,-3,875132134,875132195,61,96,157,3.5714285714285716
833,2,4,2,875132195,875132237,42,157,1231,2.7
833,4,2,-2,875132237,875133633,1396,1231,517,3.625
833,2,1,-1,875133633,875133661,28,517,26,3.36
833,1,4,3,875133661,875133840,179,26,430,4.136363636363637
833,4,1,-3,875133840,875134016,176,430,451,3.207792207792208
833,1,4,3,875134016,875134063,47,451,745,4.0
833,4,4,0,875134063,875134150,87,745,201,3.75
833,4,2,-2,875134150,875134264,114,201,33,3.2941176470588234
833,2,3,1,875134264,875134317,53,33,663,3.948717948717949
833,3,3,0,875134317,875134891,574,663,67,3.106382978723404
833,3,1,-2,875134891,875134940,49,67,1029,1.5
833,1,2,1,875134940,875135058,118,1029,122,2.282608695652174
833,2,1,-1,875135058,875135113,55,122,577,1.7058823529411764
833,1,2,1,875135113,875223813,88700,577,431,3.422222222222222
833,2,3,1,875223813,875223976,163,431,552,2.8095238095238093
833,3,1,-2,875223976,875224039,63,552,53,2.9523809523809526
833,1,1,0,875224039,875224178,139,53,452,2.6129032258064515
833,1,2,1,875224178,875224252,74,452,217,3.1538461538461537
833,2,3,1,875224252,875224309,57,217,861,3.0
833,3,3,0,875224309,875224352,43,861,444,2.6842105263157894
833,3,1,-2,875224352,875224381,29,444,667,2.4285714285714284
833,1,3,2,875224381,875224482,101,667,679,3.2432432432432434
833,3,4,1,875224482,875224515,33,679,68,3.5714285714285716
833,4,1,-3,875224515,875224687,172,68,540,2.4615384615384617
833,1,3,2,875224687,875225219,532,540,1628,4.333333333333333
833,3,2,-1,875225219,878078056,2852837,1628,336,2.4
833,2,2,0,878078056,878078229,173,336,435,3.8933333333333335
833,2,1,-1,878078229,878078280,51,435,1274,1.8
833,1,3,2,878078280,878078390,110,1274,52,3.727272727272727
833,3,1,-2,878078390,879818535,1740145,52,5,3.1481481481481484
833,1,2,1,879818535,879818575,40,5,164,3.6140350877192984
833,2,3,1,879818575,879818619,44,164,291,3.2
833,3,3,0,879818619,879818659,40,291,636,3.4146341463414633
833,3,2,-1,879818659,879818689,30,636,928,3.142857142857143
833,2,1,-1,879818689,879818760,71,928,38,2.784313725490196
833,1,1,0,879818760,879818799,39,38,1210,2.7142857142857144
836,4,2,-2,885753595,885753639,44,324,322,3.0476190476190474
836,2,2,0,885753639,885753691,52,322,260,2.4716981132075473
836,2,1,-1,885753691,885753752,61,260,875,2.736842105263158
836,1,4,3,885753752,885754058,306,875,210,3.921259842519685
836,4,5,1,885754058,885754096,38,210,611,4.384615384615385
836,5,5,0,885754096,885754150,54,611,654,4.119047619047619
836,5,5,0,885754150,885754172,22,654,318,4.5046728971962615
836,5,5,0,885754172,885754173,1,318,357,4.063291139240507
836,5,5,0,885754173,885754200,27,357,187,4.215189873417722
836,5,4,-1,885754200,885754231,31,187,1065,3.1578947368421053
836,4,3,-1,885754231,885754266,35,1065,42,3.893617021276596
816,5,4,-1,891710780,891710837,57,313,678,2.8181818181818183
816,4,4,0,891710837,891710922,85,678,322,3.0476190476190474
816,4,4,0,891710922,891710968,46,322,328,3.4895833333333335
816,4,4,0,891710968,891710994,26,328,332,3.6511627906976742
816,4,3,-1,891710994,891711378,384,332,258,3.7547169811320753
816,3,4,1,891711378,891711423,45,258,343,3.0
816,4,2,-2,891711423,891711472,49,343,355,2.75
816,2,4,2,891711472,891711495,23,355,1025,2.95
816,4,4,0,891711495,891711519,24,1025,342,2.64
816,4,4,0,891711519,891711554,35,342,243,2.357142857142857
838,2,4,2,887060778,887060879,101,300,750,4.027777777777778
838,4,4,0,887060879,887060972,93,750,271,3.3134328358208953
838,4,5,1,887060972,887061035,63,271,289,2.988888888888889
838,5,4,-1,887061035,887063994,2959,289,100,4.0162162162162165
838,4,5,1,887063994,887064014,20,100,257,3.7154471544715446
838,5,5,0,887064014,887064024,10,257,1,3.902439024390244
838,5,5,0,887064024,887064051,27,1,718,3.8
838,5,4,-1,887064051,887064193,142,718,713,3.5
838,4,3,-1,887064193,887064231,38,713,993,3.4838709677419355
838,3,5,2,887064231,887064275,44,993,596,3.180327868852459
838,5,4,-1,887064275,887064315,40,596,249,3.3275862068965516
838,4,5,1,887064315,887064316,1,249,919,4.0
838,5,4,-1,887064316,887064357,41,919,111,3.5106382978723403
838,4,4,0,887064357,887064388,31,111,274,3.5609756097560976
838,4,3,-1,887064388,887064476,88,274,298,3.779220779220779
838,3,2,-1,887064476,887064515,39,298,235,3.106382978723404
838,2,4,2,887064515,887064589,74,235,405,3.25
838,4,5,1,887064589,887065709,1120,405,191,4.168674698795181
838,5,4,-1,887065709,887065781,72,191,96,3.9130434782608696
838,4,5,1,887065781,887065807,26,96,83,4.204081632653061
838,5,4,-1,887065807,887065822,15,83,114,4.3478260869565215
838,4,4,0,887065822,887065878,56,114,22,4.215909090909091
838,4,4,0,887065878,887066078,200,22,174,4.253521126760563
838,4,4,0,887066078,887066143,65,174,584,3.5238095238095237
838,4,3,-1,887066143,887066186,43,584,175,3.8354430379746836
838,3,3,0,887066186,887066304,118,175,134,4.174603174603175
838,3,5,2,887066304,887066678,374,134,168,4.0476190476190474
838,5,4,-1,887066678,887066724,46,168,128,3.45
838,4,5,1,887066724,887066782,58,128,56,4.051724137931035
838,5,4,-1,887066782,887066988,206,56,190,4.233333333333333
838,4,5,1,887066988,887066989,1,190,419,3.8208955223880596
838,5,3,-2,887066989,887067019,30,419,187,4.215189873417722
838,3,4,1,887067019,887067063,44,187,12,4.358974358974359
838,4,5,1,887067063,887067085,22,12,318,4.5046728971962615
838,5,4,-1,887067085,887067126,41,318,487,4.043478260869565
838,4,4,0,887067126,887067127,1,487,385,3.6129032258064515
838,4,4,0,887067127,887067162,35,385,72,3.175438596491228
838,4,4,0,887067162,887067359,197,72,210,3.921259842519685
838,4,4,0,887067359,887067390,31,210,228,3.7246376811594204
838,4,4,0,887067390,887067609,219,228,69,3.8015873015873014
838,4,5,1,887067609,887067631,22,69,143,3.56
839,4,1,-3,875751442,875751470,28,333,321,3.0172413793103448
839,1,4,3,875751470,875751519,49,321,326,3.262295081967213
839,4,3,-1,875751519,875751559,40,326,292,3.6666666666666665
839,3,2,-1,875751559,875751560,1,292,260,2.4716981132075473
839,2,4,2,875751560,875751723,163,260,1,3.902439024390244
839,4,2,-2,875751723,875751774,51,1,713,3.5
839,2,3,1,875751774,875751799,25,713,276,3.6036036036036037
839,3,5,2,875751799,875751856,57,276,475,3.956043956043956
839,5,4,-1,875751856,875751893,37,475,129,3.744186046511628
839,4,3,-1,875751893,875751930,37,129,257,3.7154471544715446
839,3,3,0,875751930,875751991,61,257,100,4.0162162162162165
839,3,2,-1,875751991,875751992,1,100,7,3.76056338028169
839,2,4,2,875751992,875752056,64,7,93,3.5641025641025643
839,4,4,0,875752056,875752107,51,93,455,3.1702127659574466
839,4,5,1,875752107,875752138,31,455,285,4.181818181818182
839,5,5,0,875752138,875752169,31,285,117,3.689189189189189
839,5,3,-2,875752169,875752200,31,117,742,3.5555555555555554
839,3,1,-2,875752200,875752274,74,742,410,3.0434782608695654
839,1,4,3,875752274,875752408,134,410,1245,2.3333333333333335
839,4,3,-1,875752408,875752456,48,1245,281,3.2
839,3,3,0,875752456,875752479,23,281,508,3.6923076923076925
839,3,3,0,875752479,875752560,81,508,1009,3.2962962962962963
839,3,2,-1,875752560,875752687,127,1009,866,3.3962264150943398
839,2,5,3,875752687,875752877,190,866,1085,4.0
839,5,1,-4,875752877,875752902,25,1085,1664,2.5
839,1,1,0,875752902,875752990,88,1664,1048,2.857142857142857
839,1,3,2,875752990,875753029,39,1048,220,3.433333333333333
839,3,2,-1,875753029,875753052,23,220,846,3.1052631578947367
840,4,5,1,891202784,891202889,105,750,303,3.75
840,5,5,0,891202889,891203087,198,303,884,3.5
840,5,5,0,891203087,891203166,79,884,100,4.0162162162162165
840,5,4,-1,891203166,891203203,37,100,285,4.181818181818182
840,4,5,1,891203203,891203250,47,285,14,4.101694915254237
840,5,5,0,891203250,891203280,30,14,515,4.202898550724638
840,5,4,-1,891203280,891203309,29,515,221,3.6923076923076925
840,4,5,1,891203309,891203334,25,221,297,4.142857142857143
840,5,4,-1,891203334,891203366,32,297,127,4.162790697674419
840,4,5,1,891203366,891203408,42,127,473,2.9166666666666665
840,5,4,-1,891203408,891203504,96,473,936,3.727272727272727
840,4,5,1,891203504,891203553,49,936,845,3.661290322580645
840,5,4,-1,891203553,891203585,32,845,405,3.25
840,4,4,0,891203585,891203664,79,405,756,2.6885245901639343
840,4,4,0,891203664,891204089,425,756,511,4.096153846153846
840,4,4,0,891204089,891204135,46,511,79,3.956989247311828
840,4,5,1,891204135,891204215,80,79,169,4.548387096774194
840,5,3,-2,891204215,891204239,24,169,638,3.923076923076923
840,3,3,0,891204239,891204264,25,638,194,4.029411764705882
840,3,5,2,891204264,891204265,1,194,582,3.7457627118644066
840,5,4,-1,891204265,891204295,30,582,163,3.53125
840,4,3,-1,891204295,891204296,1,163,632,3.9523809523809526
840,3,4,1,891204296,891204322,26,632,663,3.948717948717949
840,4,5,1,891204322,891204356,34,663,135,3.7974683544303796
840,5,4,-1,891204356,891204385,29,135,479,4.25
840,4,5,1,891204385,891204418,33,479,89,3.9615384615384617
840,5,5,0,891204418,891204441,23,89,661,4.133333333333334
840,5,3,-2,891204441,891204474,33,661,664,3.15
840,3,3,0,891204474,891204509,35,664,945,3.4
840,3,3,0,891204509,891204564,55,945,509,3.7058823529411766
840,3,3,0,891204564,891204592,28,509,210,3.921259842519685
840,3,5,2,891204592,891204627,35,210,203,3.826923076923077
840,5,4,-1,891204627,891204664,37,203,642,3.4285714285714284
840,4,3,-1,891204664,891204714,50,642,645,3.5714285714285716
840,3,3,0,891204714,891204755,41,645,176,3.967032967032967
840,3,5,2,891204755,891204798,43,176,166,4.0
840,5,3,-2,891204798,891204827,29,166,429,3.742857142857143
840,3,5,2,891204827,891204868,41,429,168,4.0476190476190474
840,5,3,-2,891204868,891204921,53,168,11,3.8904109589041096
840,3,3,0,891204921,891204947,26,11,732,3.6266666666666665
840,3,4,1,891204947,891204948,1,732,81,3.2857142857142856
840,4,4,0,891204948,891204971,23,81,526,3.909090909090909
840,4,4,0,891204971,891205004,33,526,631,3.581818181818182
840,4,3,-1,891205004,891205041,37,631,97,3.7282608695652173
840,3,5,2,891205041,891205069,28,97,179,3.8823529411764706
840,5,4,-1,891205069,891205070,1,179,196,3.9404761904761907
840,4,4,0,891205070,891205093,23,196,675,3.625
840,4,5,1,891205093,891205123,30,675,1451,4.0
840,5,5,0,891205123,891205143,20,1451,180,3.9473684210526314
840,5,4,-1,891205143,891205199,56,180,213,3.943396226415094
840,4,3,-1,891205199,891205222,23,213,187,4.215189873417722
840,3,5,2,891205222,891205245,23,187,655,3.7857142857142856
840,5,4,-1,891205245,891205287,42,655,367,3.4242424242424243
840,4,4,0,891205287,891205321,34,367,588,3.8358208955223883
840,4,5,1,891205321,891205371,50,588,512,3.888888888888889
840,5,4,-1,891205371,891208667,3296,512,507,3.6285714285714286
840,4,5,1,891208667,891208703,36,507,483,4.475609756097561
840,5,5,0,891208703,891208897,194,483,419,3.8208955223880596
840,5,5,0,891208897,891208958,61,419,8,3.903225806451613
840,5,4,-1,891208958,891208998,40,8,157,3.5714285714285716
840,4,4,0,891208998,891209033,35,157,708,3.3157894736842106
840,4,3,-1,891209033,891209104,71,708,144,3.9545454545454546
840,3,4,1,891209104,891209159,55,144,501,3.289473684210526
840,4,4,0,891209159,891209183,24,501,199,4.191489361702128
840,4,4,0,891209183,891209241,58,199,88,3.433734939759036
840,4,3,-1,891209241,891209322,81,88,495,3.65
840,3,5,2,891209322,891209364,42,495,616,3.1052631578947367
840,5,3,-2,891209364,891209408,44,616,117,3.689189189189189
840,3,5,2,891209408,891209490,82,117,443,3.8421052631578947
840,5,3,-2,891209490,891209509,19,443,66,3.4705882352941178
840,3,4,1,891209509,891209547,38,66,428,3.744186046511628
840,4,4,0,891209547,891209571,24,428,497,3.35
840,4,3,-1,891209571,891211664,2093,497,1018,3.0714285714285716
840,3,4,1,891211664,891211682,18,1018,1674,4.0
840,4,1,-3,891211682,891211729,47,1674,1214,1.8
832,3,4,1,888259020,888259121,101,328,326,3.262295081967213
832,4,4,0,888259121,888259231,110,326,307,3.6031746031746033
832,4,2,-2,888259231,888259285,54,307,895,3.142857142857143
832,2,3,1,888259285,888259404,119,895,260,2.4716981132075473
832,3,3,0,888259404,888259480,76,260,876,3.0
832,3,3,0,888259480,888260089,609,876,181,3.98974358974359
832,3,2,-1,888260089,888260157,68,181,25,3.3185840707964602
810,5,4,-1,879895290,879895314,24,321,323,3.0
810,4,4,0,879895314,879895350,36,323,881,2.769230769230769
810,4,5,1,879895350,879895403,53,881,289,2.988888888888889
810,5,4,-1,879895403,879895453,50,289,678,2.8181818181818183
810,4,4,0,879895453,879895500,47,678,878,2.0
810,4,4,0,879895500,885406558,5511058,878,304,3.5306122448979593
810,4,5,1,885406558,885406635,77,304,328,3.4895833333333335
810,5,5,0,885406635,890083187,4676552,328,300,3.6861313868613137
810,5,5,0,890083187,890083210,23,300,902,3.9444444444444446
810,5,4,-1,890083210,891873686,1790476,902,331,3.5517241379310347
810,4,5,1,891873686,891873739,53,331,326,3.262295081967213
844,2,3,1,877381206,877381268,62,294,326,3.262295081967213
844,3,1,-2,877381268,877381312,44,326,260,2.4716981132075473
844,1,4,3,877381312,877381484,172,260,251,3.8333333333333335
844,4,3,-1,877381484,877381534,50,251,919,4.0
844,3,4,1,877381534,877381674,140,919,151,3.6544117647058822
844,4,3,-1,877381674,877381708,34,151,13,3.5454545454545454
844,3,3,0,877381708,877381736,28,13,471,3.5714285714285716
844,3,2,-1,877381736,877381850,114,471,109,3.282608695652174
844,2,3,1,877381850,877382008,158,109,255,3.2027027027027026
844,3,3,0,877382008,877382055,47,255,121,3.521212121212121
844,3,2,-1,877382055,877382189,134,121,405,3.25
844,2,3,1,877382189,877382269,80,405,125,3.5555555555555554
844,3,3,0,877382269,877382339,70,125,597,3.2771084337349397
844,3,4,1,877382339,877382717,378,597,1039,3.9583333333333335
844,4,3,-1,877382717,877382762,45,1039,423,3.7016129032258065
844,3,4,1,877382762,877386897,4135,423,56,4.051724137931035
844,4,4,0,877386897,877386928,31,56,210,3.921259842519685
844,4,3,-1,877386928,877387052,124,210,154,3.6031746031746033
844,3,4,1,877387052,877387150,98,154,241,3.5625
844,4,4,0,877387150,877387195,45,241,778,3.5925925925925926
844,4,3,-1,877387195,877387242,47,778,90,3.0
844,3,3,0,877387242,877387280,38,90,549,3.4871794871794872
844,3,2,-1,877387280,877387391,111,549,1099,3.7142857142857144
844,2,3,1,877387391,877387769,378,1099,184,3.393939393939394
844,3,3,0,877387769,877387857,88,184,82,3.6741573033707864
844,3,3,0,877387857,877387858,1,82,228,3.7246376811594204
844,3,4,1,877387858,877387964,106,228,568,3.5853658536585367
844,4,4,0,877387964,877388040,76,568,588,3.8358208955223883
844,4,3,-1,877388040,877388107,67,588,946,3.1153846153846154
844,3,5,2,877388107,877388182,75,946,12,4.358974358974359
843,2,4,2,879443297,879443341,44,637,217,3.1538461538461537
843,4,2,-2,879443341,879443442,101,217,444,2.6842105263157894
843,2,3,1,879443442,879443443,1,444,860,1.8
843,3,2,-1,879443443,879443545,102,860,563,2.0
843,2,2,0,879443545,879443597,52,563,667,2.4285714285714284
843,2,3,1,879443597,879443668,71,667,98,4.240875912408759
843,3,3,0,879443668,879443763,95,98,431,3.422222222222222
843,3,5,2,879443763,879443800,37,431,183,3.951219512195122
843,5,4,-1,879443800,879443837,37,183,636,3.4146341463414633
843,4,3,-1,879443837,879443908,71,636,227,3.169811320754717
843,3,2,-1,879443908,879443951,43,227,628,3.573529411764706
843,2,2,0,879443951,879443975,24,628,77,3.3857142857142857
843,2,3,1,879443975,879444047,72,77,121,3.521212121212121
843,3,2,-1,879444047,879444083,36,121,450,2.2758620689655173
843,2,3,1,879444083,879444114,31,450,1157,3.142857142857143
843,3,3,0,879444114,879444670,556,1157,530,4.125
843,3,3,0,879444670,879444711,41,530,172,4.225225225225225
843,3,2,-1,879444711,879444739,28,172,182,3.842857142857143
843,2,3,1,879444739,879444766,27,182,566,3.543859649122807
843,3,2,-1,879444766,879444767,1,566,188,3.625
843,2,3,1,879444767,879444801,34,188,82,3.6741573033707864
843,3,4,1,879444801,879444851,50,82,679,3.2432432432432434
843,4,2,-2,879444851,879444934,83,679,403,3.298507462686567
843,2,2,0,879444934,879445059,125,403,127,4.162790697674419
843,2,4,2,879445059,879445087,28,127,250,3.4698795180722892
843,4,3,-1,879445087,879445114,27,250,252,2.911392405063291
843,3,3,0,879445114,879445738,624,252,474,4.172413793103448
843,3,3,0,879445738,879446186,448,474,1,3.902439024390244
843,3,3,0,879446186,879446215,29,1,615,3.8333333333333335
843,3,3,0,879446215,879446281,66,615,154,3.6031746031746033
843,3,3,0,879446281,879446359,78,154,238,3.888888888888889
843,3,3,0,879446359,879446476,117,238,69,3.8015873015873014
843,3,2,-1,879446476,879446477,1,69,435,3.8933333333333335
843,2,2,0,879446477,879446502,25,435,357,4.063291139240507
843,2,4,2,879446502,879446503,1,357,429,3.742857142857143
843,4,2,-2,879446503,879446638,135,429,197,4.112676056338028
843,2,3,1,879446638,879446680,42,197,275,4.087912087912088
843,3,2,-1,879446680,879446696,16,275,23,3.9047619047619047
843,2,3,1,879446696,879446755,59,23,191,4.168674698795181
843,3,4,1,879446755,879446774,19,191,179,3.8823529411764706
843,4,2,-2,879446774,879446806,32,179,216,3.8454545454545452
843,2,3,1,879446806,879446863,57,216,193,3.883720930232558
843,3,4,1,879446863,879446888,25,193,205,3.717391304347826
843,4,3,-1,879446888,879446889,1,205,671,3.4285714285714284
843,3,2,-1,879446889,879446911,22,671,504,4.085714285714285
843,2,3,1,879446911,879446948,37,504,83,4.204081632653061
843,3,3,0,879446948,879446977,29,83,28,3.923076923076923
843,3,2,-1,879446977,879447110,133,28,52,3.727272727272727
843,2,4,2,879447110,879447146,36,52,434,3.588235294117647
843,4,2,-2,879447146,879447170,24,434,186,3.905263157894737
843,2,2,0,879447170,879447214,44,186,215,3.662921348314607
843,2,3,1,879447214,879447234,20,215,180,3.9473684210526314
843,3,3,0,879447234,879447285,51,180,633,3.9
843,3,2,-1,879447285,879447326,41,633,432,3.719298245614035
843,2,4,2,879447326,879447327,1,432,141,3.4827586206896552
843,4,2,-2,879447327,879447377,50,141,392,3.5555555555555554
843,2,3,1,879447377,879447424,47,392,101,3.4827586206896552
843,3,3,0,879447424,879447453,29,101,214,3.272727272727273
843,3,2,-1,879447453,879447484,31,214,660,3.71875
843,2,2,0,879447484,879447523,39,660,739,3.391304347826087
843,2,2,0,879447523,879447578,55,739,501,3.289473684210526
843,2,2,0,879447578,879447579,1,501,588,3.8358208955223883
843,2,2,0,879447579,879447599,20,588,402,3.3076923076923075
843,2,2,0,879447599,879447625,26,402,162,3.4651162790697674
843,2,3,1,879447625,879447670,45,162,239,3.423076923076923
843,3,2,-1,879447670,879447718,48,239,627,3.3823529411764706
843,2,2,0,879447718,879447757,39,627,143,3.56
843,2,3,1,879447757,879447801,44,143,200,3.8157894736842106
843,3,3,0,879447801,879447837,36,200,511,4.096153846153846
843,3,3,0,879447837,879448073,236,511,204,3.6744186046511627
843,3,3,0,879448073,879448112,39,204,206,3.0
843,3,3,0,879448112,879448138,26,206,527,3.823529411764706
843,3,2,-1,879448138,879448199,61,527,157,3.5714285714285716
843,2,2,0,879448199,879448230,31,157,378,3.6904761904761907
843,2,3,1,879448230,879448262,32,378,380,3.4878048780487805
843,3,2,-1,879448262,879448352,90,380,416,3.3846153846153846
843,2,2,0,879448352,879448392,40,416,21,2.9210526315789473
843,2,2,0,879448392,879448431,39,21,422,3.25
843,2,3,1,879448431,879448486,55,422,596,3.180327868852459
843,3,2,-1,879448486,879448542,56,596,625,3.25
843,2,2,0,879448542,879448604,62,625,142,3.1481481481481484
843,2,3,1,879448604,879448751,147,142,1065,3.1578947368421053
843,3,2,-1,879448751,879448830,79,1065,74,2.4
843,2,2,0,879448830,879448858,28,74,393,3.5125
843,2,2,0,879448858,879449193,335,393,473,2.9166666666666665
843,2,3,1,879449193,879449256,63,473,616,3.1052631578947367
843,3,2,-1,879449256,879449336,80,616,158,2.7027027027027026
843,2,3,1,879449336,879449377,41,158,1411,2.4615384615384617
834,3,3,0,890860159,890860298,139,294,751,3.3896103896103895
834,3,4,1,890860298,890860386,88,751,326,3.262295081967213
834,4,4,0,890860386,890860416,30,326,245,3.056179775280899
834,4,5,1,890860416,890860566,150,245,316,4.285714285714286
834,5,5,0,890860566,890860687,121,316,315,4.15
834,5,4,-1,890860687,890862311,1624,315,100,4.0162162162162165
834,4,5,1,890862311,890862362,51,100,50,4.306532663316583
834,5,5,0,890862362,890862412,50,50,127,4.162790697674419
834,5,5,0,890862412,890862437,25,127,237,3.7315436241610738
834,5,3,-2,890862437,890862468,31,237,25,3.3185840707964602
834,3,5,2,890862468,890862526,58,25,181,3.98974358974359
834,5,4,-1,890862526,890862527,1,181,744,3.5714285714285716
834,4,2,-2,890862527,890862563,36,744,1017,3.0
834,2,5,3,890862563,890862564,1,1017,150,3.803921568627451
834,5,3,-2,890862564,890862648,84,150,275,4.087912087912088
834,3,4,1,890862648,890863052,404,275,282,3.610526315789474
846,5,3,-2,883946315,883946477,162,269,294,3.1052631578947367
846,3,4,1,883946477,883946548,71,294,289,2.988888888888889
846,4,5,1,883946548,883946611,63,289,271,3.3134328358208953
846,5,5,0,883946611,883946861,250,271,302,4.133333333333334
846,5,5,0,883946861,883947589,728,302,513,4.526315789473684
846,5,5,0,883947589,883947590,1,513,657,4.341463414634147
846,5,4,-1,883947590,883947630,40,657,178,4.378378378378378
846,4,4,0,883947630,883947694,64,178,519,4.291666666666667
846,4,3,-1,883947694,883947737,43,519,177,3.875
846,3,5,2,883947737,883947777,40,177,12,4.358974358974359
846,5,3,-2,883947777,883947778,1,12,430,4.136363636363637
846,3,4,1,883947778,883947819,41,430,98,4.240875912408759
846,4,3,-1,883947819,883947861,42,98,507,3.6285714285714286
846,3,4,1,883947861,883947862,1,507,490,3.5454545454545454
846,4,4,0,883947862,883947911,49,490,83,4.204081632653061
846,4,4,0,883947911,883947960,49,83,357,4.063291139240507
846,4,5,1,883947960,883948003,43,357,50,4.306532663316583
846,5,3,-2,883948003,883948141,138,50,204,3.6744186046511627
846,3,5,2,883948141,883948222,81,204,463,3.6818181818181817
846,5,5,0,883948222,883948343,121,463,11,3.8904109589041096
846,5,4,-1,883948343,883948417,74,11,789,3.7777777777777777
846,4,4,0,883948417,883948457,40,789,433,3.8035714285714284
846,4,5,1,883948457,883948495,38,433,1118,3.533333333333333
846,5,4,-1,883948495,883948571,76,1118,518,3.5833333333333335
846,4,5,1,883948571,883948606,35,518,42,3.893617021276596
846,5,4,-1,883948606,883948607,1,42,219,2.735294117647059
846,4,5,1,883948607,883948642,35,219,55,4.051282051282051
846,5,4,-1,883948642,883948643,1,55,443,3.8421052631578947
846,4,4,0,883948643,883948719,76,443,721,3.4583333333333335
846,4,3,-1,883948719,883948720,1,721,1479,3.5
846,3,5,2,883948720,883948765,45,1479,614,3.727272727272727
846,5,4,-1,883948765,883948840,75,614,661,4.133333333333334
846,4,4,0,883948840,883948873,33,661,727,3.5517241379310347
846,4,5,1,883948873,883948874,1,727,566,3.543859649122807
846,5,5,0,883948874,883948908,34,566,4,3.5538461538461537
846,5,5,0,883948908,883948948,40,4,486,3.9565217391304346
846,5,3,-2,883948948,883948989,41,486,1206,2.8333333333333335
846,3,4,1,883948989,883949121,132,1206,367,3.4242424242424243
846,4,5,1,883949121,883949156,35,367,425,3.7027027027027026
846,5,5,0,883949156,883949199,43,425,609,3.7058823529411766
846,5,4,-1,883949199,883949255,56,609,602,3.533333333333333
846,4,3,-1,883949255,883949290,35,602,232,3.0789473684210527
846,3,5,2,883949290,883949335,45,232,1473,4.5
846,5,4,-1,883949335,883949336,1,1473,101,3.4827586206896552
846,4,4,0,883949336,883949379,43,101,451,3.207792207792208
846,4,3,-1,883949379,883949380,1,451,380,3.4878048780487805
846,3,4,1,883949380,883949421,41,380,1018,3.0714285714285716
846,4,3,-1,883949421,883949459,38,1018,1055,3.125
846,3,4,1,883949459,883949508,49,1055,768,3.238095238095238
846,4,3,-1,883949508,883949547,39,768,393,3.5125
846,3,5,2,883949547,883949594,47,393,202,3.730337078651685
846,5,5,0,883949594,883949697,103,202,184,3.393939393939394
846,5,4,-1,883949697,883949698,1,184,570,3.526315789473684
846,4,4,0,883949698,883949728,30,570,554,2.9555555555555557
846,4,3,-1,883949728,883949771,43,554,229,3.185185185185185
846,3,2,-1,883949771,883949982,211,229,1078,2.625
846,2,2,0,883949982,883950001,19,1078,90,3.0
846,2,4,2,883950001,883950053,52,90,729,3.3793103448275863
846,4,4,0,883950053,883950128,75,729,1107,2.9
846,4,4,0,883950128,883950129,1,1107,581,3.130434782608696
846,4,2,-2,883950129,883950155,26,581,377,1.75
846,2,5,3,883950155,883950186,31,377,836,4.142857142857143
846,5,3,-2,883950186,883950220,34,836,1221,3.4285714285714284
846,3,4,1,883950220,883950252,32,1221,441,2.4
846,4,2,-2,883950252,883950253,1,441,40,2.7037037037037037
846,2,2,0,883950253,883950286,33,40,102,3.3684210526315788
846,2,3,1,883950286,883950311,25,102,755,3.085714285714286
846,3,4,1,883950311,883950364,53,755,785,3.4375
846,4,3,-1,883950364,883950390,26,785,1110,2.85
846,3,3,0,883950390,883950391,1,1110,373,3.142857142857143
846,3,2,-1,883950391,883950434,43,373,1220,2.9166666666666665
846,2,5,3,883950434,883950463,29,1220,562,3.2941176470588234
846,5,2,-3,883950463,883950488,25,562,1182,2.4285714285714284
846,2,2,0,883950488,883950524,36,1182,1188,2.45
846,2,3,1,883950524,883950568,44,1188,1066,3.2
846,3,4,1,883950568,883950569,1,1066,1168,3.4166666666666665
846,4,2,-2,883950569,883950605,36,1168,415,2.6666666666666665
846,2,3,1,883950605,883950634,29,415,387,3.5357142857142856
846,3,3,0,883950634,883950665,31,387,1297,3.0
846,3,2,-1,883950665,883950712,47,1297,565,2.4285714285714284
846,2,3,1,883950712,883950753,41,565,561,3.1515151515151514
846,3,4,1,883950753,883950820,67,561,1044,3.2777777777777777
846,4,1,-3,883950820,883950858,38,1044,1209,2.3333333333333335
846,1,1,0,883950858,883950889,31,1209,400,2.375
846,1,3,2,883950889,883950950,61,400,388,2.5833333333333335
837,4,5,1,875721502,875721539,37,294,289,2.988888888888889
837,5,4,-1,875721539,875721604,65,289,328,3.4895833333333335
837,4,5,1,875721604,875721734,130,328,151,3.6544117647058822
837,5,5,0,875721734,875721765,31,151,1009,3.2962962962962963
837,5,1,-4,875721765,875721843,78,1009,276,3.6036036036036037
837,1,3,2,875721843,875721869,26,276,15,3.725663716814159
837,3,4,1,875721869,875721919,50,15,20,3.375
837,4,4,0,875721919,875721948,29,20,19,3.9615384615384617
837,4,3,-1,875721948,875721969,21,19,596,3.180327868852459
837,3,4,1,875721969,875721989,20,596,274,3.5609756097560976
837,4,4,0,875721989,875722007,18,274,220,3.433333333333333
837,4,5,1,875722007,875722032,25,220,125,3.5555555555555554
837,5,4,-1,875722032,875722050,18,125,111,3.5106382978723403
837,4,5,1,875722050,875722069,19,111,283,3.901639344262295
837,5,1,-4,875722069,875722104,35,283,284,3.1547619047619047
837,1,1,0,875722104,875722123,19,284,763,3.347826086956522
837,1,3,2,875722123,875722141,18,763,472,2.984375
837,3,3,0,875722141,875722225,84,472,476,3.1216216216216215
837,3,1,-2,875722225,875722267,42,476,1047,2.6923076923076925
837,1,1,0,875722267,875722298,31,1047,1049,2.5714285714285716
837,1,2,1,875722298,875722318,20,1049,762,3.3962264150943398
837,2,1,-1,875722318,875722371,53,762,926,2.7857142857142856
837,1,4,3,875722371,875722392,21,926,845,3.661290322580645
837,4,1,-3,875722392,875722393,1,845,717,2.9696969696969697
837,1,2,1,875722393,875722483,90,717,934,3.0294117647058822
813,1,3,2,883752331,883752380,49,877,326,3.262295081967213
813,3,1,-2,883752380,883752417,37,326,342,2.64
813,1,4,3,883752417,883752455,38,342,271,3.3134328358208953
813,4,2,-2,883752455,883752528,73,271,259,2.492063492063492
813,2,3,1,883752528,883752606,78,259,358,2.6551724137931036
813,3,3,0,883752606,883752708,102,358,893,2.625
842,3,3,0,891217835,891217891,56,258,362,2.1666666666666665
842,3,4,1,891217891,891217942,51,362,306,4.033333333333333
842,4,5,1,891217942,891218002,60,306,303,3.75
842,5,5,0,891218002,891218059,57,303,268,3.9838709677419355
842,5,4,-1,891218059,891218060,1,268,749,3.2777777777777777
842,4,2,-2,891218060,891218192,132,749,328,3.4895833333333335
842,2,5,3,891218192,891218251,59,328,270,3.7804878048780486
842,5,4,-1,891218251,891218353,102,270,752,3.6666666666666665
842,4,5,1,891218353,891218459,106,752,902,3.9444444444444446
847,1,5,4,878774763,878774788,25,261,262,3.5217391304347827
847,5,1,-4,878774788,878774856,68,262,243,2.357142857142857
847,1,5,4,878774856,878775470,614,243,222,3.578125
847,5,3,-2,878775470,878775523,53,222,121,3.521212121212121
847,3,1,-2,878775523,878775570,47,121,93,3.5641025641025643
847,1,1,0,878775570,878775647,77,93,225,3.0714285714285716
847,1,1,0,878775647,878775729,82,225,1012,3.2916666666666665
847,1,3,2,878775729,878775796,67,1012,25,3.3185840707964602
847,3,3,0,878775796,878775863,67,25,257,3.7154471544715446
847,3,1,-2,878775863,878775914,51,257,763,3.347826086956522
847,1,4,3,878775914,878775961,47,763,476,3.1216216216216215
847,4,3,-1,878775961,878775982,21,476,118,3.2764227642276422
847,3,1,-2,878775982,878776020,38,118,756,2.6885245901639343
847,1,1,0,878776020,878938855,162835,756,410,3.0434782608695654
847,1,3,2,878938855,878938897,42,410,13,3.5454545454545454
847,3,2,-1,878938897,878938922,25,13,685,3.2666666666666666
847,2,4,2,878938922,878939153,231,685,1160,4.1
847,4,4,0,878939153,878939327,174,1160,220,3.433333333333333
847,4,3,-1,878939327,878939375,48,220,928,3.142857142857143
847,3,1,-2,878939375,878939393,18,928,456,2.2
847,1,1,0,878939393,878939451,58,456,369,2.5714285714285716
847,1,2,1,878939451,878939503,52,369,185,3.9726027397260273
847,2,2,0,878939503,878939536,33,185,527,3.823529411764706
847,2,5,3,878939536,878939645,109,527,1167,3.6666666666666665
847,5,2,-3,878939645,878939700,55,1167,47,3.5869565217391304
847,2,1,-1,878939700,878939803,103,47,1172,3.4
847,1,3,2,878939803,878939839,36,1172,196,3.9404761904761907
847,3,3,0,878939839,878939876,37,196,11,3.8904109589041096
847,3,2,-1,878939876,878939945,69,11,180,3.9473684210526314
847,2,2,0,878939945,878939975,30,180,238,3.888888888888889
847,2,2,0,878939975,878940013,38,238,99,3.8392857142857144
847,2,3,1,878940013,878940039,26,99,480,4.283018867924528
847,3,4,1,878940039,878940161,122,480,198,4.04
847,4,5,1,878940161,878940189,28,198,372,3.6666666666666665
847,5,4,-1,878940189,878940255,66,372,202,3.730337078651685
847,4,4,0,878940255,878940301,46,202,96,3.9130434782608696
847,4,2,-2,878940301,878940332,31,96,89,3.9615384615384617
847,2,3,1,878940332,878940356,24,89,216,3.8454545454545452
847,3,4,1,878940356,878940383,27,216,228,3.7246376811594204
847,4,3,-1,878940383,878940405,22,228,479,4.25
847,3,1,-2,878940405,878940463,58,479,157,3.5714285714285716
847,1,4,3,878940463,878940510,47,157,732,3.6266666666666665
847,4,2,-2,878940510,878940531,21,732,39,3.107142857142857
847,2,2,0,878940531,878940584,53,39,482,3.9444444444444446
847,2,3,1,878940584,878940618,34,482,1050,3.6153846153846154
847,3,4,1,878940618,878940652,34,1050,191,4.168674698795181
847,4,3,-1,878940652,878940732,80,191,404,3.6578947368421053
847,3,3,0,878940732,878940756,24,404,200,3.8157894736842106
847,3,3,0,878940756,878940757,1,200,1204,4.0
847,3,3,0,878940757,878940782,25,1204,444,2.6842105263157894
847,3,3,0,878940782,878940805,23,444,578,3.066666666666667
847,3,5,2,878940805,878940830,25,578,1400,3.5
847,5,2,-3,878940830,878941005,175,1400,1031,2.6
847,2,3,1,878941005,878941027,22,1031,419,3.8208955223880596
847,3,3,0,878941027,878941056,29,419,164,3.6140350877192984
847,3,4,1,878941056,878941082,26,164,8,3.903225806451613
847,4,4,0,878941082,878941144,62,8,135,3.7974683544303796
847,4,3,-1,878941144,878941168,24,135,142,3.1481481481481484
847,3,3,0,878941168,878941398,230,142,176,3.967032967032967
847,3,4,1,878941398,878941421,23,176,77,3.3857142857142857
847,4,4,0,878941421,878941442,21,77,568,3.5853658536585367
847,4,4,0,878941442,878941466,24,568,82,3.6741573033707864
847,4,2,-2,878941466,878941588,122,82,417,3.0588235294117645
848,1,4,3,887037584,887037822,238,689,650,3.1363636363636362
848,4,4,0,887037822,887037861,39,650,234,3.7674418604651163
848,4,5,1,887037861,887037935,74,234,498,4.290909090909091
848,5,5,0,887037935,887038021,86,498,483,4.475609756097561
848,5,5,0,887038021,887038073,52,483,638,3.923076923076923
848,5,5,0,887038073,887038104,31,638,357,4.063291139240507
848,5,5,0,887038104,887038134,30,357,173,4.1441441441441444
848,5,3,-2,887038134,887038159,25,173,127,4.162790697674419
848,3,5,2,887038159,887038197,38,127,132,3.929411764705882
848,5,5,0,887038197,887038397,200,132,209,3.8275862068965516
848,5,5,0,887038397,887038441,44,209,474,4.172413793103448
848,5,2,-3,887038441,887038475,34,474,812,3.375
848,2,2,0,887038475,887038527,52,812,65,3.511111111111111
848,2,5,3,887038527,887038528,1,65,431,3.422222222222222
848,5,5,0,887038528,887038564,36,431,191,4.168674698795181
848,5,5,0,887038564,887038634,70,191,462,3.7954545454545454
848,5,5,0,887038634,887039136,502,462,427,4.2025316455696204
848,5,5,0,887039136,887039164,28,427,82,3.6741573033707864
848,5,5,0,887039164,887039271,107,82,186,3.905263157894737
848,5,5,0,887039271,887039329,58,186,647,4.142857142857143
848,5,4,-1,887039329,887040097,768,647,655,3.7857142857142856
848,4,5,1,887040097,887040159,62,655,125,3.5555555555555554
848,5,3,-2,887040159,887040302,143,125,661,4.133333333333334
848,3,5,2,887040302,887042377,2075,661,179,3.8823529411764706
848,5,3,-2,887042377,887042427,50,179,435,3.8933333333333335
848,3,5,2,887042427,887043040,613,435,530,4.125
848,5,5,0,887043040,887043265,225,530,207,3.4761904761904763
848,5,4,-1,887043265,887043266,1,207,121,3.521212121212121
848,4,2,-2,887043266,887043340,74,121,69,3.8015873015873014
848,2,5,3,887043340,887043421,81,69,164,3.6140350877192984
848,5,5,0,887043421,887043514,93,164,517,3.625
848,5,5,0,887043514,887043607,93,517,97,3.7282608695652173
848,5,5,0,887043607,887043777,170,97,1021,3.8666666666666667
848,5,5,0,887043777,887046259,2482,1021,610,3.1818181818181817
848,5,4,-1,887046259,887046329,70,610,238,3.888888888888889
848,4,5,1,887046329,887046565,236,238,845,3.661290322580645
848,5,4,-1,887046565,887046674,109,845,509,3.7058823529411766
848,4,5,1,887046674,887046890,216,509,25,3.3185840707964602
848,5,5,0,887046890,887046915,25,25,405,3.25
848,5,4,-1,887046915,887047308,393,405,133,3.7777777777777777
848,4,4,0,887047308,887047808,500,133,265,3.710144927536232
848,4,5,1,887047808,887047809,1,265,428,3.744186046511628
848,5,5,0,887047809,887047921,112,428,443,3.8421052631578947
848,5,5,0,887047921,887047962,41,443,393,3.5125
848,5,3,-2,887047962,887048073,111,393,501,3.289473684210526
848,3,5,2,887048073,887048111,38,501,805,3.909090909090909
848,5,2,-3,887048111,887048154,43,805,1065,3.1578947368421053
848,2,5,3,887048154,887048260,106,1065,739,3.391304347826087
822,4,3,-1,891033747,891035141,1394,333,751,3.3896103896103895
822,3,3,0,891035141,891036851,1710,751,206,3.0
822,3,5,2,891036851,891037291,440,206,408,4.4772727272727275
822,5,2,-3,891037291,891037394,103,408,588,3.8358208955223883
822,2,4,2,891037394,891037465,71,588,71,3.6575342465753424
822,4,1,-3,891037465,891039486,2021,71,410,3.0434782608695654
822,1,3,2,891039486,891039543,57,410,25,3.3185840707964602
852,3,4,1,891036039,891036414,375,323,257,3.7154471544715446
852,4,3,-1,891036414,891036435,21,257,685,3.2666666666666666
852,3,4,1,891036435,891036457,22,685,1,3.902439024390244
852,4,3,-1,891036457,891036485,28,1,7,3.76056338028169
852,3,3,0,891036485,891036505,20,7,109,3.282608695652174
852,3,4,1,891036505,891036765,260,109,235,3.106382978723404
852,4,3,-1,891036765,891036802,37,235,25,3.3185840707964602
852,3,4,1,891036802,891036817,15,25,290,3.108108108108108
852,4,5,1,891036817,891036843,26,290,408,4.4772727272727275
852,5,3,-2,891036843,891036866,23,408,252,2.911392405063291
852,3,4,1,891036866,891036901,35,252,121,3.521212121212121
852,4,3,-1,891036901,891036902,1,121,926,2.7857142857142856
852,3,4,1,891036902,891036922,20,926,151,3.6544117647058822
852,4,4,0,891036922,891037262,340,151,118,3.2764227642276422
852,4,3,-1,891037262,891037586,324,118,825,2.914285714285714
852,3,3,0,891037586,891037605,19,825,472,2.984375
852,3,4,1,891037605,891037625,20,472,841,2.772727272727273
852,4,4,0,891037625,891037754,129,841,820,3.0444444444444443
852,4,3,-1,891037754,891037777,23,820,930,2.793103448275862
852,3,4,1,891037777,891037888,111,930,1052,2.4545454545454546
852,4,5,1,891037888,891037917,29,1052,969,3.8947368421052633
851,3,4,1,874728338,874728396,58,696,473,2.9166666666666665
851,4,4,0,874728396,874728430,34,473,290,3.108108108108108
851,4,4,0,874728430,874728461,31,290,147,3.3142857142857145
851,4,4,0,874728461,874728565,104,147,121,3.521212121212121
851,4,5,1,874728565,874767519,38954,121,742,3.5555555555555554
851,5,3,-2,874767519,874767550,31,742,815,3.135135135135135
851,3,2,-1,874767550,874789084,21534,815,1009,3.2962962962962963
851,2,4,2,874789084,874789109,25,1009,924,3.3703703703703702
851,4,4,0,874789109,875729820,940711,924,879,3.2291666666666665
851,4,3,-1,875729820,875729887,67,879,676,3.3142857142857145
851,3,3,0,875729887,875730030,143,676,10,3.85
851,3,2,-1,875730030,875730279,249,10,818,2.769230769230769
851,2,3,1,875730279,875730312,33,818,930,2.793103448275862
851,3,5,2,875730312,875730379,67,930,250,3.4698795180722892
851,5,3,-2,875730379,875730418,39,250,1089,2.1363636363636362
851,3,3,0,875730418,875730532,114,1089,823,2.75
851,3,3,0,875730532,875730533,1,823,1059,2.764705882352941
851,3,1,-2,875730533,875730601,68,1059,987,2.0
851,1,1,0,875730601,875730629,28,987,112,2.7
851,1,4,3,875730629,875730686,57,112,597,3.2771084337349397
851,4,2,-2,875730686,875730719,33,597,456,2.2
851,2,3,1,875730719,875730757,38,456,841,2.772727272727273
851,3,4,1,875730757,875730826,69,841,125,3.5555555555555554
851,4,1,-3,875730826,875730895,69,125,1254,2.4
851,1,3,2,875730895,875730947,52,1254,820,3.0444444444444443
851,3,2,-1,875730947,875730979,32,820,1291,2.125
851,2,3,1,875730979,875731021,42,1291,595,2.9166666666666665
851,3,4,1,875731021,875731189,168,595,234,3.7674418604651163
851,4,4,0,875731189,875731225,36,234,553,3.5
851,4,4,0,875731225,875731370,145,553,132,3.929411764705882
851,4,5,1,875731370,875731406,36,132,480,4.283018867924528
851,5,4,-1,875731406,875731441,35,480,192,4.090909090909091
851,4,5,1,875731441,875731489,48,192,4,3.5538461538461537
851,5,3,-2,875731489,875731490,1,4,161,3.5844155844155843
851,3,2,-1,875731490,875731529,39,161,1540,3.25
851,2,5,3,875731529,875731605,76,1540,180,3.9473684210526314
851,5,2,-3,875731605,875731674,69,180,406,2.5294117647058822
851,2,4,2,875731674,875731776,102,406,228,3.7246376811594204
851,4,4,0,875731776,875731816,40,228,176,3.967032967032967
851,4,4,0,875731816,875806721,74905,176,483,4.475609756097561
851,4,4,0,875806721,875806765,44,483,27,3.235294117647059
851,4,5,1,875806765,875806791,26,27,92,3.7142857142857144
851,5,3,-2,875806791,875806892,101,92,564,2.0
851,3,3,0,875806892,875806953,61,564,159,3.3902439024390243
851,3,3,0,875806953,875807019,66,159,772,3.3333333333333335
851,3,4,1,875807019,875807058,39,772,31,3.642857142857143
851,4,5,1,875807058,875807089,31,31,17,3.032258064516129
851,5,3,-2,875807089,877831020,2023931,17,304,3.5306122448979593
851,3,3,0,877831020,877831111,91,304,261,2.7333333333333334
851,3,4,1,877831111,883148669,5317558,261,751,3.3896103896103895
851,4,5,1,883148669,883148692,23,751,271,3.3134328358208953
851,5,3,-2,883148692,883148867,175,271,689,3.1538461538461537
851,3,2,-1,883148867,884205201,1056334,689,1025,2.95
851,2,1,-1,884205201,884205263,62,1025,332,3.6511627906976742
851,1,3,2,884205263,886534572,2329309,332,328,3.4895833333333335
851,3,4,1,886534572,886534617,45,328,299,3.0
851,4,2,-2,886534617,886534635,18,299,892,2.9615384615384617
851,2,1,-1,886534635,886534672,37,892,681,2.25
851,1,3,2,886534672,886534717,45,681,680,2.8333333333333335
851,3,4,1,886534717,888540093,2005376,680,339,2.7058823529411766
851,4,2,-2,888540093,888540205,112,339,342,2.64
851,2,1,-1,888540205,890343544,1803339,342,352,1.8333333333333333
851,1,3,2,890343544,890343651,107,352,255,3.2027027027027026
851,3,2,-1,890343651,890343707,56,255,1120,3.1
851,2,3,1,890343707,890343790,83,1120,1258,2.3333333333333335
851,3,4,1,890343790,890804671,460881,1258,327,3.5076923076923077
851,4,4,0,890804671,890804691,20,327,336,2.4
851,4,3,-1,890804691,890862878,58187,336,353,2.4285714285714284
851,3,3,0,890862878,890862917,39,353,349,2.5714285714285716
851,3,4,1,890862917,890862961,44,349,1105,3.0
851,4,3,-1,890862961,891961195,1098234,1105,916,3.3333333333333335
851,3,5,2,891961195,891961664,469,916,318,4.5046728971962615
851,5,3,-2,891961664,891961750,86,318,338,2.75
851,3,5,2,891961750,891961798,48,338,1143,3.3333333333333335
851,5,2,-3,891961798,891961831,33,1143,754,3.5789473684210527
851,2,2,0,891961831,891961856,25,754,1013,2.388888888888889
849,4,5,1,879695125,879695153,28,406,928,3.142857142857143
849,5,4,-1,879695153,879695317,164,928,427,4.2025316455696204
849,4,5,1,879695317,879695420,103,427,625,3.25
849,5,5,0,879695420,879695469,49,625,174,4.253521126760563
849,5,5,0,879695469,879695588,119,174,421,3.462962962962963
849,5,5,0,879695588,879695680,92,421,588,3.8358208955223883
849,5,5,0,879695680,879695896,216,588,15,3.725663716814159
849,5,5,0,879695896,879696059,163,15,133,3.7777777777777777
854,3,3,0,882811773,882811810,37,343,303,3.75
854,3,3,0,882811810,882811836,26,303,302,4.133333333333334
854,3,1,-2,882811836,882811865,29,302,322,3.0476190476190474
854,1,1,0,882811865,882811888,23,322,264,2.65
854,1,3,2,882811888,882811913,25,264,321,3.0172413793103448
854,3,4,1,882811913,882811937,24,321,271,3.3134328358208953
854,4,2,-2,882811937,882811962,25,271,289,2.988888888888889
854,2,3,1,882811962,882812030,68,289,260,2.4716981132075473
854,3,4,1,882812030,882812102,72,260,50,4.306532663316583
854,4,4,0,882812102,882812165,63,50,285,4.181818181818182
854,4,3,-1,882812165,882812195,30,285,246,4.0
854,3,3,0,882812195,882812263,68,246,1197,3.625
854,3,4,1,882812263,882812288,25,1197,713,3.5
854,4,3,-1,882812288,882812314,26,713,150,3.803921568627451
854,3,4,1,882812314,882812352,38,150,7,3.76056338028169
854,4,4,0,882812352,882812376,24,7,250,3.4698795180722892
854,4,4,0,882812376,882812406,30,250,919,4.0
854,4,3,-1,882812406,882812492,86,919,147,3.3142857142857145
854,3,2,-1,882812492,882812787,295,147,744,3.5714285714285716
854,2,3,1,882812787,882812826,39,744,458,3.0588235294117645
854,3,1,-2,882812826,882812852,26,458,255,3.2027027027027026
854,1,3,2,882812852,882812877,25,255,257,3.7154471544715446
854,3,2,-1,882812877,882812905,28,257,762,3.3962264150943398
854,2,2,0,882812905,882812906,1,762,455,3.1702127659574466
854,2,3,1,882812906,882812928,22,455,249,3.3275862068965516
854,3,2,-1,882812928,882812961,33,249,696,3.138888888888889
854,2,2,0,882812961,882812981,20,696,815,3.135135135135135
854,2,2,0,882812981,882813047,66,815,1283,2.9
854,2,2,0,882813047,882813074,27,1283,291,3.2
854,2,3,1,882813074,882813099,25,291,125,3.5555555555555554
854,3,3,0,882813099,882813143,44,125,825,2.914285714285714
854,3,2,-1,882813143,882813179,36,825,925,3.0
854,2,4,2,882813179,882813248,69,925,220,3.433333333333333
854,4,4,0,882813248,882813315,67,220,979,3.1
854,4,2,-2,882813315,882813316,1,979,823,2.75
854,2,2,0,882813316,882813364,48,823,840,3.090909090909091
854,2,2,0,882813364,882813421,57,840,409,2.9615384615384617
854,2,2,0,882813421,882813453,32,409,620,3.0
854,2,3,1,882813453,882813574,121,620,174,4.253521126760563
854,3,4,1,882813574,882813601,27,174,604,3.8181818181818183
854,4,4,0,882813601,882813623,22,604,507,3.6285714285714286
854,4,5,1,882813623,882813648,25,507,238,3.888888888888889
854,5,3,-2,882813648,882813726,78,238,431,3.422222222222222
854,3,3,0,882813726,882813797,71,431,537,3.5
854,3,3,0,882813797,882813825,28,537,58,3.543859649122807
854,3,4,1,882813825,882813877,52,58,616,3.1052631578947367
854,4,3,-1,882813877,882813907,30,616,1077,3.3333333333333335
854,3,4,1,882813907,882813963,56,1077,423,3.7016129032258065
854,4,4,0,882813963,882813990,27,423,487,4.043478260869565
854,4,3,-1,882813990,882814028,38,487,216,3.8454545454545452
854,3,4,1,882814028,882814063,35,216,87,3.9
854,4,4,0,882814063,882814091,28,87,664,3.15
854,4,5,1,882814091,882814121,30,664,64,4.373737373737374
854,5,2,-3,882814121,882814189,68,64,522,3.8461538461538463
854,2,4,2,882814189,882814235,46,522,357,4.063291139240507
854,4,3,-1,882814235,882814298,63,357,799,3.0
854,3,4,1,882814298,882814333,35,799,171,4.090909090909091
854,4,3,-1,882814333,882814395,62,171,463,3.6818181818181817
854,3,4,1,882814395,882814435,40,463,168,4.0476190476190474
854,4,3,-1,882814435,882814436,1,168,86,3.869565217391304
854,3,3,0,882814436,882814467,31,86,96,3.9130434782608696
854,3,5,2,882814467,882814570,103,96,9,3.8878504672897196
854,5,5,0,882814570,882814571,1,9,288,3.5214285714285714
854,5,4,-1,882814571,882814665,94,288,49,3.3
850,5,5,0,883194737,883194810,73,318,480,4.283018867924528
850,5,5,0,883194810,883194859,49,480,204,3.6744186046511627
850,5,5,0,883194859,883194908,49,204,969,3.8947368421052633
850,5,5,0,883194908,883194950,42,969,82,3.6741573033707864
850,5,5,0,883194950,883194973,23,82,208,3.8125
850,5,5,0,883194973,883195055,82,208,121,3.521212121212121
850,5,5,0,883195055,883195099,44,121,385,3.6129032258064515
850,5,5,0,883195099,883195118,19,385,71,3.6575342465753424
850,5,3,-2,883195118,883195168,50,71,494,3.8333333333333335
850,3,1,-2,883195168,883195192,24,494,98,4.240875912408759
850,1,5,4,883195192,883195214,22,98,28,3.923076923076923
850,5,5,0,883195214,883195236,22,28,132,3.929411764705882
850,5,5,0,883195236,883195256,20,132,566,3.543859649122807
850,5,3,-2,883195256,883195301,45,566,162,3.4651162790697674
850,3,5,2,883195301,883195394,93,162,228,3.7246376811594204
850,5,5,0,883195394,883195456,62,228,168,4.0476190476190474
850,5,5,0,883195456,883195479,23,168,88,3.433734939759036
858,3,4,1,879459504,880932449,1472945,327,1368,3.0
858,4,3,-1,880932449,880932746,297,1368,100,4.0162162162162165
858,3,4,1,880932746,880932911,165,100,515,4.202898550724638
858,4,5,1,880932911,880932912,1,515,127,4.162790697674419
858,5,4,-1,880932912,880933013,101,127,333,3.546666666666667
858,4,4,0,880933013,880933072,59,333,334,3.4210526315789473
853,4,2,-2,879364669,879364744,75,302,690,3.260869565217391
853,2,4,2,879364744,879364822,78,690,270,3.7804878048780486
853,4,4,0,879364822,879364823,1,270,682,3.0476190476190474
853,4,2,-2,879364823,879364882,59,682,877,2.619047619047619
853,2,3,1,879364882,879364883,1,877,322,3.0476190476190474
853,3,3,0,879364883,879364955,72,322,327,3.5076923076923077
853,3,1,-2,879364955,879365035,80,327,358,2.6551724137931036
853,1,1,0,879365035,879365091,56,358,330,2.625
853,1,4,3,879365091,879365092,1,330,299,3.0
853,4,3,-1,879365092,879365169,77,299,264,2.65
853,3,4,1,879365169,879365170,1,264,678,2.8181818181818183
855,4,4,0,879825383,879825488,105,475,855,3.590909090909091
855,4,3,-1,879825488,879825528,40,855,179,3.8823529411764706
855,3,4,1,879825528,879825578,50,179,166,4.0
855,4,4,0,879825578,879825613,35,166,529,4.142857142857143
855,4,3,-1,879825613,879825614,1,529,531,3.7435897435897436
824,4,2,-2,877020927,877020965,38,259,323,3.0
824,2,3,1,877020965,877021002,37,323,294,3.1052631578947367
824,3,1,-2,877021002,877021077,75,294,748,3.1043478260869564
845,3,4,1,885409493,885409789,296,346,909,4.0
841,3,5,2,889066880,889066959,79,751,302,4.133333333333334
841,5,5,0,889066959,889066999,40,302,331,3.5517241379310347
841,5,4,-1,889066999,889067045,46,331,754,3.5789473684210527
841,4,3,-1,889067045,889067046,1,754,288,3.5214285714285714
841,3,5,2,889067046,889067152,106,288,307,3.6031746031746033
841,5,3,-2,889067152,889067182,30,307,892,2.9615384615384617
841,3,4,1,889067182,889067216,34,892,271,3.3134328358208953
841,4,5,1,889067216,889067253,37,271,689,3.1538461538461537
841,5,4,-1,889067253,889067313,60,689,678,2.8181818181818183
841,4,5,1,889067313,889067432,119,678,888,3.0
841,5,5,0,889067432,889067507,75,888,1294,5.0
859,3,5,2,885774828,885774867,39,275,535,3.380952380952381
859,5,3,-2,885774867,885775193,326,535,118,3.2764227642276422
859,3,3,0,885775193,885775218,25,118,294,3.1052631578947367
859,3,4,1,885775218,885775251,33,294,1315,3.4444444444444446
859,4,4,0,885775251,885775277,26,1315,1009,3.2962962962962963
859,4,2,-2,885775277,885775330,53,1009,257,3.7154471544715446
859,2,5,3,885775330,885775358,28,257,287,3.4516129032258065
859,5,5,0,885775358,885775437,79,287,762,3.3962264150943398
859,5,3,-2,885775437,885775473,36,762,928,3.142857142857143
859,3,3,0,885775473,885775513,40,928,1132,2.588235294117647
859,3,4,1,885775513,885775564,51,1132,1014,3.1
859,4,5,1,885775564,885775612,48,1014,846,3.1052631578947367
859,5,5,0,885775612,885775727,115,846,476,3.1216216216216215
859,5,3,-2,885775727,885775880,153,476,368,1.8823529411764706
859,3,4,1,885775880,885776056,176,368,293,3.630434782608696
859,4,5,1,885776056,885776384,328,293,421,3.462962962962963
862,4,3,-1,879302614,879302910,296,678,252,2.911392405063291
862,3,4,1,879302910,879302944,34,252,546,2.9789473684210526
862,4,4,0,879302944,879302990,46,546,24,3.3728813559322033
862,4,5,1,879302990,879303079,89,24,276,3.6036036036036037
862,5,5,0,879303079,879303158,79,276,250,3.4698795180722892
862,5,5,0,879303158,879303207,49,250,257,3.7154471544715446
862,5,4,-1,879303207,879303249,42,257,845,3.661290322580645
862,4,5,1,879303249,879303298,49,845,742,3.5555555555555554
862,5,3,-2,879303298,879303346,48,742,105,2.6176470588235294
862,3,5,2,879303346,879303409,63,105,979,3.1
862,5,5,0,879303409,879303505,96,979,472,2.984375
862,5,4,-1,879303505,879303542,37,472,928,3.142857142857143
862,4,3,-1,879303542,879303591,49,928,978,2.357142857142857
862,3,5,2,879303591,879303668,77,978,825,2.914285714285714
862,5,3,-2,879303668,879303697,29,825,597,3.2771084337349397
862,3,2,-1,879303697,879303729,32,597,1199,2.6666666666666665
862,2,4,2,879303729,879303774,45,1199,820,3.0444444444444443
862,4,4,0,879303774,879303807,33,820,767,3.0
862,4,4,0,879303807,879303869,62,767,823,2.75
862,4,4,0,879303869,879303952,83,823,413,2.5652173913043477
862,4,3,-1,879303952,879303953,1,413,120,2.3421052631578947
862,3,2,-1,879303953,879304113,160,120,974,3.125
862,2,5,3,879304113,879304196,83,974,7,3.76056338028169
862,5,5,0,879304196,879304244,48,7,61,4.190476190476191
862,5,4,-1,879304244,879304282,38,61,205,3.717391304347826
862,4,5,1,879304282,879304326,44,205,64,4.373737373737374
862,5,5,0,879304326,879304410,84,64,485,3.717948717948718
862,5,4,-1,879304410,879304445,35,485,433,3.8035714285714284
862,4,5,1,879304445,879304484,39,433,198,4.04
862,5,5,0,879304484,879304526,42,198,429,3.742857142857143
862,5,3,-2,879304526,879304571,45,429,566,3.543859649122807
862,3,5,2,879304571,879304624,53,566,202,3.730337078651685
862,5,5,0,879304624,879304672,48,202,176,3.967032967032967
862,5,4,-1,879304672,879304721,49,176,45,4.130434782608695
862,4,5,1,879304721,879304761,40,45,199,4.191489361702128
862,5,5,0,879304761,879304799,38,199,196,3.9404761904761907
862,5,5,0,879304799,879304834,35,196,183,3.951219512195122
862,5,5,0,879304834,879304865,31,183,98,4.240875912408759
862,5,5,0,879304865,879304902,37,98,496,4.094594594594595
862,5,5,0,879304902,879304941,39,496,789,3.7777777777777777
862,5,5,0,879304941,879304980,39,789,200,3.8157894736842106
862,5,5,0,879304980,879305016,36,200,655,3.7857142857142856
862,5,5,0,879305016,879305051,35,655,92,3.7142857142857144
862,5,5,0,879305051,879305097,46,92,180,3.9473684210526314
862,5,4,-1,879305097,879305143,46,180,467,4.071428571428571
862,4,5,1,879305143,879305204,61,467,59,4.0
862,5,4,-1,879305204,879305237,33,59,141,3.4827586206896552
862,4,3,-1,879305237,879305273,36,141,230,3.3518518518518516
862,3,5,2,879305273,879305386,113,230,1110,2.85
856,5,4,-1,891489250,891489356,106,750,258,3.7547169811320753
856,4,4,0,891489356,891489386,30,258,300,3.6861313868613137
856,4,3,-1,891489386,891489412,26,300,270,3.7804878048780486
856,3,4,1,891489412,891489478,66,270,327,3.5076923076923077
856,4,4,0,891489478,891489502,24,327,294,3.1052631578947367
856,4,1,-3,891489502,891489525,23,294,289,2.988888888888889
856,1,5,4,891489525,891489547,22,289,316,4.285714285714286
856,5,3,-2,891489547,891489638,91,316,748,3.1043478260869564
856,3,3,0,891489638,891489666,28,748,678,2.8181818181818183
820,3,5,2,887954853,887954878,25,258,333,3.546666666666667
820,5,5,0,887954878,887954934,56,333,288,3.5214285714285714
820,5,1,-4,887954934,887954972,38,288,358,2.6551724137931036
820,1,3,2,887954972,887955020,48,358,324,3.2291666666666665
820,3,2,-1,887955020,887955046,26,324,895,3.142857142857143
820,2,2,0,887955046,887955079,33,895,328,3.4895833333333335
820,2,3,1,887955079,887955180,101,328,264,2.65
820,3,1,-2,887955180,887955223,43,264,748,3.1043478260869564
863,4,3,-1,889288911,889288943,32,288,270,3.7804878048780486
863,3,1,-2,889288943,889288972,29,270,901,2.0
863,1,1,0,889288972,889288973,1,901,898,3.0869565217391304
863,1,3,2,889288973,889289067,94,898,754,3.5789473684210527
863,3,4,1,889289067,889289122,55,754,305,3.5789473684210527
863,4,2,-2,889289122,889289123,1,305,319,3.0408163265306123
863,2,5,3,889289123,889289157,34,319,307,3.6031746031746033
863,5,2,-3,889289157,889289191,34,307,330,2.625
863,2,1,-1,889289191,889289240,49,330,259,2.492063492063492
863,1,4,3,889289240,889289277,37,259,1243,3.6666666666666665
863,4,4,0,889289277,889289278,1,1243,331,3.5517241379310347
863,4,5,1,889289278,889289328,50,331,343,3.0
863,5,5,0,889289328,889289353,25,343,334,3.4210526315789473
863,5,2,-3,889289353,889289385,32,334,299,3.0
863,2,4,2,889289385,889289419,34,299,355,2.75
863,4,4,0,889289419,889289456,37,355,344,4.0
863,4,2,-2,889289456,889289457,1,344,876,3.0
863,2,1,-1,889289457,889289491,34,876,352,1.8333333333333333
863,1,2,1,889289491,889289569,78,352,1022,3.727272727272727
863,2,1,-1,889289569,889289570,1,1022,1678,1.0
863,1,3,2,889289570,889289617,47,1678,1296,3.2222222222222223
863,3,2,-1,889289617,889289618,1,1296,1434,2.5
863,2,3,1,889289618,889289619,1,1434,1024,3.0
860,3,2,-1,876074177,880829226,4755049,333,301,3.2465753424657535
860,2,4,2,880829226,885145375,4316149,301,313,4.323076923076923
860,4,4,0,885145375,885990901,845526,313,216,3.8454545454545452
860,4,4,0,885990901,885990932,31,216,202,3.730337078651685
860,4,4,0,885990932,885990965,33,202,153,3.7865168539325844
860,4,4,0,885990965,885990998,33,153,283,3.901639344262295
860,4,5,1,885990998,885991040,42,283,514,4.033333333333333
860,5,4,-1,885991040,885991075,35,514,100,4.0162162162162165
860,4,4,0,885991075,885991076,1,100,508,3.6923076923076925
860,4,3,-1,885991076,885991101,25,508,663,3.948717948717949
860,3,3,0,885991101,885991163,62,663,949,3.392857142857143
860,3,4,1,885991163,885991198,35,949,715,3.257142857142857
860,4,3,-1,885991198,885991407,209,715,287,3.4516129032258065
860,3,2,-1,885991407,885991563,156,287,1047,2.6923076923076925
860,2,1,-1,885991563,891536049,5544486,1047,1059,2.764705882352941
857,1,5,4,883432170,883432193,23,348,258,3.7547169811320753
857,5,3,-2,883432193,883432251,58,258,300,3.6861313868613137
857,3,3,0,883432251,883432301,50,300,328,3.4895833333333335
857,3,4,1,883432301,883432352,51,328,321,3.0172413793103448
857,4,2,-2,883432352,883432423,71,321,988,2.5555555555555554
857,2,1,-1,883432423,883432470,47,988,687,2.1481481481481484
857,1,3,2,883432470,883432515,45,687,892,2.9615384615384617
857,3,4,1,883432515,883432633,118,892,19,3.9615384615384617
857,4,5,1,883432633,883432663,30,19,475,3.956043956043956
857,5,3,-2,883432663,883432688,25,475,20,3.375
864,5,4,-1,877214085,878179411,965326,50,993,3.4838709677419355
864,4,4,0,878179411,878179445,34,993,742,3.5555555555555554
864,4,5,1,878179445,878179555,110,742,273,3.5238095238095237
864,5,4,-1,878179555,887686388,9506833,273,349,2.5714285714285716
864,4,5,1,887686388,887686456,68,349,328,3.4895833333333335
864,5,3,-2,887686456,887686497,41,328,892,2.9615384615384617
864,3,4,1,887686497,887686545,48,892,678,2.8181818181818183
864,4,4,0,887686545,888886882,1200337,678,216,3.8454545454545452
864,4,3,-1,888886882,888886913,31,216,182,3.842857142857143
864,3,5,2,888886913,888886945,32,182,48,4.055555555555555
864,5,4,-1,888886945,888886946,1,48,789,3.7777777777777777
864,4,5,1,888886946,888886984,38,789,12,4.358974358974359
864,5,5,0,888886984,888887013,29,12,134,4.174603174603175
864,5,5,0,888887013,888887045,32,134,95,3.8194444444444446
864,5,5,0,888887045,888887071,26,95,318,4.5046728971962615
864,5,5,0,888887071,888887097,26,318,56,4.051724137931035
864,5,4,-1,888887097,888887128,31,56,655,3.7857142857142856
864,4,5,1,888887128,888887172,44,655,201,3.75
864,5,4,-1,888887172,888887216,44,201,127,4.162790697674419
864,4,3,-1,888887216,888887247,31,127,418,3.825
864,3,4,1,888887247,888887248,1,418,178,4.378378378378378
864,4,5,1,888887248,888887289,41,178,176,3.967032967032967
864,5,5,0,888887289,888887354,65,176,174,4.253521126760563
864,5,5,0,888887354,888887402,48,174,8,3.903225806451613
864,5,5,0,888887402,888887403,1,8,87,3.9
864,5,4,-1,888887403,888887469,66,87,88,3.433734939759036
864,4,5,1,888887469,888887502,33,88,47,3.5869565217391304
864,5,4,-1,888887502,888887658,156,47,186,3.905263157894737
864,4,3,-1,888887658,888887703,45,186,433,3.8035714285714284
864,3,5,2,888887703,888887739,36,433,423,3.7016129032258065
864,5,5,0,888887739,888887794,55,423,357,4.063291139240507
864,5,5,0,888887794,888887795,1,357,172,4.225225225225225
864,5,4,-1,888887795,888887869,74,172,191,4.168674698795181
864,4,4,0,888887869,888887914,45,191,196,3.9404761904761907
864,4,5,1,888887914,888887944,30,196,496,4.094594594594595
864,5,5,0,888887944,888888025,81,496,736,4.083333333333333
864,5,5,0,888888025,888888067,42,736,228,3.7246376811594204
864,5,2,-3,888888067,888888115,48,228,710,3.41025641025641
864,2,4,2,888888115,888888168,53,710,693,3.6285714285714286
864,4,4,0,888888168,888888202,34,693,31,3.642857142857143
864,4,3,-1,888888202,888888282,80,31,629,3.3333333333333335
864,3,4,1,888888282,888888680,398,629,163,3.53125
864,4,5,1,888888680,888888862,182,163,471,3.5714285714285716
864,5,4,-1,888888862,888888937,75,471,561,3.1515151515151514
864,4,5,1,888888937,888888994,57,561,73,3.588235294117647
864,5,4,-1,888888994,888889035,41,73,62,3.048780487804878
864,4,4,0,888889035,888889162,127,62,125,3.5555555555555554
864,4,4,0,888889162,888889268,106,125,356,3.2
864,4,3,-1,888889268,888889327,59,356,1217,3.4166666666666665
864,3,3,0,888889327,888889389,62,1217,71,3.6575342465753424
864,3,5,2,888889389,888889466,77,71,151,3.6544117647058822
864,5,4,-1,888889466,888889510,44,151,660,3.71875
864,4,4,0,888889510,888889563,53,660,451,3.207792207792208
864,4,4,0,888889563,888889601,38,451,566,3.543859649122807
864,4,4,0,888889601,888889657,56,566,2,3.0851063829787235
864,4,3,-1,888889657,888889744,87,2,380,3.4878048780487805
864,3,4,1,888889744,888889784,40,380,526,3.909090909090909
864,4,3,-1,888889784,888889948,164,526,93,3.5641025641025643
864,3,4,1,888889948,888890001,53,93,596,3.180327868852459
864,4,4,0,888890001,888890052,51,596,470,3.72
864,4,4,0,888890052,888890102,50,470,939,3.6333333333333333
864,4,4,0,888890102,888890144,42,939,44,3.1333333333333333
864,4,3,-1,888890144,888890273,129,44,673,3.393939393939394
864,3,5,2,888890273,888890316,43,673,367,3.4242424242424243
864,5,3,-2,888890316,888890380,64,367,747,3.5526315789473686
864,3,3,0,888890380,888890432,52,747,394,3.5714285714285716
864,3,2,-1,888890432,888890475,43,394,972,3.375
864,2,4,2,888890475,888890547,72,972,86,3.869565217391304
864,4,3,-1,888890547,888890548,1,86,1119,3.5185185185185186
864,3,4,1,888890548,888890594,46,1119,123,3.297872340425532
864,4,4,0,888890594,888890639,45,123,443,3.8421052631578947
864,4,3,-1,888890639,888890690,51,443,1531,3.5
864,3,3,0,888890690,888890730,40,1531,549,3.4871794871794872
864,3,2,-1,888890730,888890731,1,549,1208,2.6666666666666665
864,2,4,2,888890731,888890775,44,1208,184,3.393939393939394
864,4,2,-2,888890775,888891097,322,184,1112,2.9
864,2,4,2,888891097,888891190,93,1112,67,3.106382978723404
864,4,3,-1,888891190,888891238,48,67,720,3.2
864,3,4,1,888891238,888891288,50,720,72,3.175438596491228
864,4,3,-1,888891288,888891322,34,72,770,3.25
864,3,4,1,888891322,888891423,101,770,94,2.8823529411764706
864,4,2,-2,888891423,888891473,50,94,1033,3.0
864,2,4,2,888891473,888891524,51,1033,217,3.1538461538461537
864,4,4,0,888891524,888891627,103,217,77,3.3857142857142857
864,4,3,-1,888891627,888891628,1,77,38,2.784313725490196
864,3,5,2,888891628,888891794,166,38,235,3.106382978723404
864,5,3,-2,888891794,888891836,42,235,501,3.289473684210526
864,3,3,0,888891836,888891900,64,501,1284,2.5454545454545454
864,3,4,1,888891900,888892015,115,1284,546,2.9789473684210526
864,4,3,-1,888892015,888892016,1,546,140,3.238095238095238
864,3,2,-1,888892016,888892091,75,140,722,2.9642857142857144
864,2,3,1,888892091,888892128,37,722,402,3.3076923076923075
864,3,4,1,888892128,888892230,102,402,145,2.3636363636363638
864,4,3,-1,888892230,888892300,70,145,665,2.72972972972973
864,3,3,0,888892300,888892375,75,665,1228,2.5
864,3,1,-2,888892375,888892461,86,1228,1412,1.5
864,1,1,0,888892461,888892491,30,1412,1140,2.1666666666666665
864,1,3,2,888892491,888892539,48,1140,563,2.0
864,3,2,-1,888892539,888892667,128,563,541,2.9473684210526314
864,2,4,2,888892667,888892841,174,541,542,2.888888888888889
864,4,3,-1,888892841,888892874,33,542,734,3.0
864,3,3,0,888892874,888892917,43,734,577,1.7058823529411764
864,3,2,-1,888892917,888892968,51,577,780,3.08
864,2,3,1,888892968,888893088,120,780,63,3.125
864,3,4,1,888893088,888893224,136,63,391,2.4285714285714284
864,4,4,0,888893224,891044192,2150968,391,257,3.7154471544715446
865,4,1,-3,880142652,880142778,126,268,271,3.3134328358208953
865,1,3,2,880142778,880142857,79,271,328,3.4895833333333335
865,3,5,2,880142857,880143385,528,328,408,4.4772727272727275
865,5,5,0,880143385,880143386,1,408,847,3.7333333333333334
865,5,1,-4,880143386,880143424,38,847,1,3.902439024390244
865,1,2,1,880143424,880143482,58,1,222,3.578125
865,2,4,2,880143482,880143612,130,222,24,3.3728813559322033
865,4,1,-3,880143612,880143680,68,24,108,3.107142857142857
865,1,5,4,880143680,880143713,33,108,919,4.0
865,5,1,-4,880143713,880143917,204,919,546,2.9789473684210526
865,1,4,3,880143917,880144024,107,546,744,3.5714285714285716
865,4,1,-3,880144024,880144123,99,744,825,2.914285714285714
865,1,2,1,880144123,880144153,30,825,676,3.3142857142857145
865,2,3,1,880144153,880144194,41,676,148,3.2131147540983607
865,3,1,-2,880144194,880144265,71,148,1047,2.6923076923076925
865,1,1,0,880144265,880144368,103,1047,928,3.142857142857143
865,1,1,0,880144368,880144405,37,928,456,2.2
865,1,1,0,880144405,880144480,75,456,831,2.6097560975609757
865,1,1,0,880144480,880144504,24,831,743,1.9545454545454546
865,1,3,2,880144504,880144539,35,743,122,2.282608695652174
865,3,1,-2,880144539,880235099,90560,122,946,3.1153846153846154
865,1,4,3,880235099,880235263,164,946,294,3.1052631578947367
868,4,2,-2,877103039,877103098,59,327,358,2.6551724137931036
868,2,4,2,877103098,877103195,97,358,433,3.8035714285714284
868,4,4,0,877103195,877103248,53,433,176,3.967032967032967
868,4,5,1,877103248,877103249,1,176,651,3.8627450980392157
868,5,4,-1,877103249,877103280,31,651,480,4.283018867924528
868,4,4,0,877103280,877103371,91,480,98,4.240875912408759
868,4,5,1,877103371,877103410,39,98,455,3.1702127659574466
868,5,4,-1,877103410,877103679,269,455,427,4.2025316455696204
868,4,2,-2,877103679,877103714,35,427,662,3.4583333333333335
868,2,4,2,877103714,877103757,43,662,59,4.0
868,4,2,-2,877103757,877103834,77,59,385,3.6129032258064515
868,2,2,0,877103834,877104212,378,385,65,3.511111111111111
868,2,2,0,877104212,877104264,52,65,201,3.75
868,2,4,2,877104264,877104414,150,201,160,3.4
868,4,2,-2,877104414,877105916,1502,160,153,3.7865168539325844
868,2,3,1,877105916,877106470,554,153,509,3.7058823529411766
868,3,5,2,877106470,877106505,35,509,55,4.051282051282051
868,5,3,-2,877106505,877107143,638,55,191,4.168674698795181
868,3,3,0,877107143,877107189,46,191,200,3.8157894736842106
868,3,5,2,877107189,877107320,131,200,174,4.253521126760563
868,5,4,-1,877107320,877107373,53,174,81,3.2857142857142856
868,4,5,1,877107373,877107416,43,81,1098,3.533333333333333
868,5,4,-1,877107416,877107446,30,1098,89,3.9615384615384617
868,4,3,-1,877107446,877107539,93,89,154,3.6031746031746033
868,3,2,-1,877107539,877107597,58,154,496,4.094594594594595
868,2,1,-1,877107597,877107817,220,496,1035,3.03125
868,1,1,0,877107817,877107847,30,1035,568,3.5853658536585367
868,1,3,2,877107847,877107924,77,568,239,3.423076923076923
868,3,4,1,877107924,877107961,37,239,173,4.1441441441441444
868,4,4,0,877107961,877107996,35,173,655,3.7857142857142856
868,4,1,-3,877107996,877108087,91,655,417,3.0588235294117645
868,1,5,4,877108087,877108123,36,417,128,3.45
868,5,1,-4,877108123,877108220,97,128,73,3.588235294117647
868,1,3,2,877108220,877108302,82,73,265,3.710144927536232
868,3,5,2,877108302,877108352,50,265,206,3.0
868,5,2,-3,877108352,877108385,33,206,24,3.3728813559322033
868,2,3,1,877108385,877108742,357,24,658,3.393939393939394
868,3,1,-2,877108742,877109082,340,658,232,3.0789473684210527
868,1,4,3,877109082,877109197,115,232,709,4.171428571428572
868,4,2,-2,877109197,877109234,37,709,186,3.905263157894737
868,2,2,0,877109234,877109375,141,186,778,3.5925925925925926
868,2,5,3,877109375,877109435,60,778,646,3.9285714285714284
868,5,3,-2,877109435,877109505,70,646,162,3.4651162790697674
868,3,1,-2,877109505,877109535,30,162,1031,2.6
868,1,3,2,877109535,877109597,62,1031,67,3.106382978723404
868,3,3,0,877109597,877109748,151,67,679,3.2432432432432434
868,3,1,-2,877109748,877109814,66,679,94,2.8823529411764706
868,1,4,3,877109814,877109874,60,94,382,3.764705882352941
868,4,2,-2,877109874,877109895,21,382,217,3.1538461538461537
868,2,2,0,877109895,877109926,31,217,1285,3.1
868,2,4,2,877109926,877109996,70,1285,101,3.4827586206896552
868,4,3,-1,877109996,877110060,64,101,556,2.7142857142857144
868,3,1,-2,877110060,877110191,131,556,167,2.8181818181818183
868,1,2,1,877110191,877110277,86,167,727,3.5517241379310347
868,2,2,0,877110277,877110332,55,727,117,3.689189189189189
868,2,2,0,877110332,877110401,69,117,448,3.466666666666667
868,2,1,-1,877110401,877111328,927,448,158,2.7027027027027026
868,1,1,0,877111328,877111453,125,158,225,3.0714285714285716
868,1,2,1,877111453,877111542,89,225,121,3.521212121212121
868,2,2,0,877111542,877111623,81,121,155,3.0588235294117645
868,2,1,-1,877111623,877111932,309,155,1480,2.0
868,1,2,1,877111932,877112001,69,1480,82,3.6741573033707864
868,2,3,1,877112001,877112033,32,82,1206,2.8333333333333335
868,3,2,-1,877112033,877112063,30,1206,451,3.207792207792208
868,2,1,-1,877112063,877112141,78,451,1183,2.5
868,1,4,3,877112141,877112184,43,1183,755,3.085714285714286
868,4,2,-2,877112184,877112290,106,755,2,3.0851063829787235
868,2,3,1,877112290,877112349,59,2,230,3.3518518518518516
868,3,4,1,877112349,877112393,44,230,550,3.272727272727273
868,4,2,-2,877112393,877112439,46,550,578,3.066666666666667
868,2,2,0,877112439,877112440,1,578,562,3.2941176470588234
868,2,3,1,877112440,877112559,119,562,547,3.6666666666666665
868,3,1,-2,877112559,877113481,922,547,783,2.388888888888889
868,1,3,2,877113481,877113540,59,783,449,2.9069767441860463
868,3,3,0,877113540,877113586,46,449,122,2.282608695652174
867,5,3,-2,880077780,880077831,51,270,294,3.1052631578947367
867,3,5,2,880077831,880077855,24,294,328,3.4895833333333335
867,5,5,0,880077855,880077950,95,328,289,2.988888888888889
867,5,4,-1,880077950,880077951,1,289,748,3.1043478260869564
867,4,4,0,880077951,880078069,118,748,295,3.769230769230769
867,4,4,0,880078069,880078090,21,295,257,3.7154471544715446
867,4,4,0,880078090,880078091,1,257,250,3.4698795180722892
867,4,2,-2,880078091,880078110,19,250,1608,2.25
867,2,2,0,880078110,880078179,69,1608,252,2.911392405063291
867,2,4,2,880078179,880078371,192,252,528,4.241379310344827
867,4,4,0,880078371,880078401,30,528,498,4.290909090909091
867,4,5,1,880078401,880078452,51,498,603,4.315789473684211
867,5,3,-2,880078452,880078484,32,603,144,3.9545454545454546
867,3,4,1,880078484,880078521,37,144,1,3.902439024390244
867,4,5,1,880078521,880078574,53,1,496,4.094594594594595
867,5,5,0,880078574,880078604,30,496,7,3.76056338028169
867,5,3,-2,880078604,880078629,25,7,132,3.929411764705882
867,3,5,2,880078629,880078656,27,132,96,3.9130434782608696
867,5,5,0,880078656,880078745,89,96,652,3.9642857142857144
867,5,5,0,880078745,880078769,24,652,172,4.225225225225225
867,5,4,-1,880078769,880078796,27,172,188,3.625
867,4,5,1,880078796,880078818,22,188,175,3.8354430379746836
867,5,5,0,880078818,880078840,22,175,474,4.172413793103448
867,5,3,-2,880078840,880078863,23,474,183,3.951219512195122
867,3,3,0,880078863,880078887,24,183,588,3.8358208955223883
867,3,5,2,880078887,880078937,50,588,186,3.905263157894737
867,5,4,-1,880078937,880078958,21,186,204,3.6744186046511627
867,4,3,-1,880078958,880078991,33,204,423,3.7016129032258065
867,3,1,-2,880078991,880079020,29,423,276,3.6036036036036037
867,1,3,2,880079020,880079043,23,276,216,3.8454545454545452
867,3,5,2,880079043,880079065,22,216,135,3.7974683544303796
867,5,4,-1,880079065,880079094,29,135,222,3.578125
867,4,5,1,880079094,880079117,23,222,191,4.168674698795181
867,5,3,-2,880079117,880079142,25,191,51,3.5277777777777777
861,4,5,1,881274529,881274612,83,531,275,4.087912087912088
861,5,5,0,881274612,881274630,18,275,86,3.869565217391304
861,5,4,-1,881274630,881274698,68,86,462,3.7954545454545454
861,4,5,1,881274698,881274718,20,462,529,4.142857142857143
861,5,3,-2,881274718,881274739,21,529,10,3.85
861,3,3,0,881274739,881274760,21,10,475,3.956043956043956
861,3,5,2,881274760,881274780,20,475,382,3.764705882352941
861,5,2,-3,881274780,881274796,16,382,582,3.7457627118644066
861,2,4,2,881274796,881274857,61,582,20,3.375
861,4,3,-1,881274857,881274883,26,20,737,3.12
861,3,4,1,881274883,881274899,16,737,714,3.6
861,4,3,-1,881274899,881274913,14,714,1148,3.0
861,3,4,1,881274913,881274936,23,1148,1227,2.6
861,4,4,0,881274936,881274937,1,1227,949,3.392857142857143
870,3,2,-1,875050410,875050439,29,328,988,2.5555555555555554
870,2,4,2,875050439,875050524,85,988,641,4.5
870,4,4,0,875050524,875050559,35,641,653,4.0
870,4,4,0,875050559,875050602,43,653,195,3.9072164948453607
870,4,4,0,875050602,875050603,1,195,697,2.7777777777777777
870,4,5,1,875050603,875050637,34,697,170,4.242424242424242
870,5,4,-1,875050637,875050697,60,170,134,4.174603174603175
870,4,4,0,875050697,875050698,1,134,171,4.090909090909091
870,4,5,1,875050698,875050723,25,171,603,4.315789473684211
870,5,5,0,875050723,875050748,25,603,1073,3.6315789473684212
870,5,5,0,875050748,875050774,26,1073,523,4.159090909090909
870,5,5,0,875050774,875050801,27,523,479,4.25
870,5,5,0,875050801,875050826,25,479,56,4.051724137931035
870,5,4,-1,875050826,875050827,1,56,177,3.875
870,4,4,0,875050827,875050865,38,177,238,3.888888888888889
870,4,3,-1,875050865,875051043,178,238,244,2.9411764705882355
870,3,4,1,875051043,875051072,29,244,7,3.76056338028169
870,4,5,1,875051072,875051100,28,7,475,3.956043956043956
870,5,4,-1,875051100,875051101,1,475,813,4.055555555555555
870,4,4,0,875051101,875679767,628666,813,772,3.3333333333333335
870,4,4,0,875679767,875679768,1,772,367,3.4242424242424243
870,4,3,-1,875679768,875679795,27,367,521,3.787878787878788
870,3,3,0,875679795,875679860,65,521,180,3.9473684210526314
870,3,4,1,875679860,875679861,1,180,92,3.7142857142857144
870,4,4,0,875679861,875679992,131,92,658,3.393939393939394
870,4,3,-1,875679992,875680045,53,658,135,3.7974683544303796
870,3,4,1,875680045,875680070,25,135,31,3.642857142857143
870,4,4,0,875680070,875680098,28,31,203,3.826923076923077
870,4,4,0,875680098,875680099,1,203,461,3.3333333333333335
870,4,4,0,875680099,875680119,20,461,181,3.98974358974359
870,4,5,1,875680119,875680142,23,181,480,4.283018867924528
870,5,4,-1,875680142,875680186,44,480,186,3.905263157894737
870,4,3,-1,875680186,875680212,26,186,710,3.41025641025641
870,3,4,1,875680212,875680258,46,710,642,3.4285714285714284
870,4,4,0,875680258,875680311,53,642,6,4.333333333333333
870,4,4,0,875680311,875680472,161,6,168,4.0476190476190474
870,4,4,0,875680472,875680493,21,168,66,3.4705882352941178
870,4,4,0,875680493,875680520,27,66,216,3.8454545454545452
870,4,3,-1,875680520,875680568,48,216,382,3.764705882352941
870,3,2,-1,875680568,875680597,29,382,517,3.625
870,2,4,2,875680597,876319137,638540,517,13,3.5454545454545454
870,4,4,0,876319137,876319311,174,13,154,3.6031746031746033
870,4,2,-2,876319311,878737915,2418604,154,841,2.772727272727273
870,2,4,2,878737915,878737979,64,841,223,4.108695652173913
870,4,4,0,878737979,879270313,532334,223,79,3.956989247311828
870,4,3,-1,879270313,879270400,87,79,746,3.7560975609756095
870,3,5,2,879270400,879376967,106567,746,9,3.8878504672897196
870,5,1,-4,879376967,879377028,61,9,458,3.0588235294117645
870,1,2,1,879377028,879539965,162937,458,421,3.462962962962963
870,2,4,2,879539965,879713899,173934,421,503,3.6363636363636362
870,4,4,0,879713899,879713935,36,503,499,4.0
870,4,4,0,879713935,879713953,18,499,447,3.46875
870,4,4,0,879713953,879714039,86,447,945,3.4
870,4,3,-1,879714039,879714103,64,945,77,3.3857142857142857
870,3,3,0,879714103,879714181,78,77,202,3.730337078651685
870,3,3,0,879714181,879714310,129,202,1046,3.3529411764705883
870,3,2,-1,879714310,879714351,41,1046,2,3.0851063829787235
870,2,2,0,879714351,879714435,84,2,1412,1.5
870,2,2,0,879714435,879714458,23,1412,54,3.3714285714285714
870,2,4,2,879714458,879714588,130,54,568,3.5853658536585367
870,4,3,-1,879714588,879714608,20,568,38,2.784313725490196
870,3,2,-1,879714608,879714631,23,38,569,2.4285714285714284
870,2,2,0,879714631,879714681,50,569,570,3.526315789473684
870,2,3,1,879714681,879714763,82,570,802,3.076923076923077
870,3,2,-1,879714763,879714772,9,802,1044,3.2777777777777777
870,2,2,0,879714772,879714800,28,1044,554,2.9555555555555557
870,2,3,1,879714800,879714883,83,554,810,2.9473684210526314
870,3,2,-1,879714883,879714902,19,810,1112,2.9
870,2,3,1,879714902,879715002,100,1112,856,4.142857142857143
870,3,3,0,879715002,879901727,186725,856,470,3.72
870,3,3,0,879901727,879901879,152,470,433,3.8035714285714284
870,3,2,-1,879901879,879901998,119,433,1230,1.8888888888888888
870,2,3,1,879901998,879901999,1,1230,395,2.5714285714285716
870,3,4,1,879901999,879902059,60,395,763,3.347826086956522
870,4,2,-2,879902059,879902127,68,763,1042,3.625
870,2,2,0,879902127,879902161,34,1042,579,2.727272727272727
870,2,4,2,879902161,880584516,682355,579,427,4.2025316455696204
870,4,4,0,880584516,880584534,18,427,589,4.384615384615385
870,4,3,-1,880584534,880584548,14,589,111,3.5106382978723403
870,3,3,0,880584548,880584549,1,111,435,3.8933333333333335
870,3,3,0,880584549,880584584,35,435,401,2.6774193548387095
870,3,4,1,880584584,880584752,168,401,386,2.769230769230769
870,4,2,-2,880584752,882123618,1538866,386,566,3.543859649122807
870,2,2,0,882123618,882123665,47,566,644,3.7
870,2,3,1,882123665,882123736,71,644,443,3.8421052631578947
871,3,5,2,888192315,888192349,34,690,271,3.3134328358208953
871,5,3,-2,888192349,888192743,394,271,359,3.8
871,3,3,0,888192743,888192745,2,359,908,2.5714285714285716
871,3,3,0,888192745,888192858,113,908,242,3.5217391304347827
871,3,2,-1,888192858,888192859,1,242,272,4.2
871,2,5,3,888192859,888192909,50,272,575,2.619047619047619
871,5,5,0,888192909,888192925,16,575,182,3.842857142857143
871,5,3,-2,888192925,888192970,45,182,262,3.5217391304347827
871,3,4,1,888192970,888192971,1,262,300,3.6861313868613137
871,4,5,1,888192971,888193081,110,300,187,4.215189873417722
871,5,3,-2,888193081,888193136,55,187,813,4.055555555555555
871,3,4,1,888193136,888193176,40,813,515,4.202898550724638
871,4,5,1,888193176,888193177,1,515,226,3.378787878787879
871,5,5,0,888193177,888193274,97,226,195,3.9072164948453607
871,5,3,-2,888193274,888193275,1,195,17,3.032258064516129
871,3,3,0,888193275,888193335,60,17,510,3.823529411764706
871,3,5,2,888193335,888193336,1,510,177,3.875
871,5,5,0,888193336,888193383,47,177,173,4.1441441441441444
871,5,3,-2,888193383,888193384,1,173,216,3.8454545454545452
871,3,3,0,888193384,888193385,1,216,241,3.5625
871,3,3,0,888193385,888193541,156,241,794,3.6
875,4,3,-1,876464755,876464800,45,288,358,2.6551724137931036
875,3,3,0,876464800,876464801,1,358,332,3.6511627906976742
875,3,4,1,876464801,876464830,29,332,937,3.5
875,4,4,0,876464830,876464873,43,937,327,3.5076923076923077
875,4,5,1,876464873,876464967,94,327,180,3.9473684210526314
875,5,4,-1,876464967,876465025,58,180,478,4.161290322580645
875,4,3,-1,876465025,876465072,47,478,8,3.903225806451613
875,3,5,2,876465072,876465111,39,8,173,4.1441441441441444
875,5,4,-1,876465111,876465112,1,173,176,3.967032967032967
875,4,5,1,876465112,876465188,76,176,772,3.3333333333333335
875,5,4,-1,876465188,876465229,41,772,131,3.731707317073171
875,4,3,-1,876465229,876465274,45,131,1422,2.5
875,3,5,2,876465274,876465275,1,1422,64,4.373737373737374
875,5,2,-3,876465275,876465336,61,64,71,3.6575342465753424
875,2,5,3,876465336,876465370,34,71,171,4.090909090909091
875,5,4,-1,876465370,876465408,38,171,28,3.923076923076923
876,3,2,-1,879428101,879428253,152,288,878,2.0
876,2,5,3,879428253,879428378,125,878,523,4.159090909090909
876,5,5,0,879428378,879428406,28,523,527,3.823529411764706
876,5,4,-1,879428406,879428421,15,527,435,3.8933333333333335
872,2,5,3,888478743,888478766,23,347,300,3.6861313868613137
872,5,5,0,888478766,888478786,20,300,313,4.323076923076923
872,5,4,-1,888478786,888478822,36,313,354,3.6923076923076925
872,4,3,-1,888478822,888478840,18,354,350,3.2
872,3,1,-2,888478840,888478864,24,350,268,3.9838709677419355
872,1,3,2,888478864,888478882,18,268,294,3.1052631578947367
872,3,4,1,888478882,888478902,20,294,893,2.625
872,4,4,0,888478902,888479034,132,893,905,3.357142857142857
872,4,3,-1,888479034,888479052,18,905,892,2.9615384615384617
872,3,3,0,888479052,888479151,99,892,1,3.902439024390244
872,3,3,0,888479151,888479206,55,1,278,3.0357142857142856
872,3,3,0,888479206,888479253,47,278,591,3.7169811320754715
872,3,3,0,888479253,888479274,21,591,273,3.5238095238095237
872,3,3,0,888479274,888479313,39,273,845,3.661290322580645
872,3,1,-2,888479313,888479333,20,845,1011,3.1
872,1,4,3,888479333,888479348,15,1011,685,3.2666666666666666
872,4,3,-1,888479348,888479369,21,685,284,3.1547619047619047
872,3,4,1,888479369,888479370,1,284,756,2.6885245901639343
872,4,3,-1,888479370,888479434,64,756,1028,2.857142857142857
872,3,4,1,888479434,888479498,64,1028,932,2.5
872,4,4,0,888479498,888479516,18,932,926,2.7857142857142856
872,4,2,-2,888479516,888479537,21,926,1165,1.8
872,2,4,2,888479537,888479560,23,1165,118,3.2764227642276422
872,4,2,-2,888479560,888479582,22,118,928,3.142857142857143
872,2,4,2,888479582,888479603,21,928,1047,2.6923076923076925
872,4,3,-1,888479603,888479624,21,1047,106,2.8125
872,3,3,0,888479624,888479654,30,106,930,2.793103448275862
872,3,3,0,888479654,888479677,23,930,409,2.9615384615384617
872,3,4,1,888479677,888479701,24,409,974,3.125
872,4,4,0,888479701,888479737,36,974,476,3.1216216216216215
872,4,1,-3,888479737,888479894,157,476,334,3.4210526315789473
872,1,2,1,888479894,888480019,125,334,323,3.0
866,2,3,1,891221006,891221165,159,896,887,3.5789473684210527
866,3,4,1,891221165,891221206,41,887,315,4.15
877,4,4,0,882676054,882676098,44,270,690,3.260869565217391
877,4,3,-1,882676098,882676190,92,690,307,3.6031746031746033
877,3,4,1,882676190,882676259,69,307,333,3.546666666666667
877,4,2,-2,882676259,882676366,107,333,328,3.4895833333333335
877,2,4,2,882676366,882676507,141,328,271,3.3134328358208953
877,4,4,0,882676507,882676533,26,271,538,3.25
877,4,5,1,882676533,882677048,515,538,14,4.101694915254237
877,5,5,0,882677048,882677128,80,14,531,3.7435897435897436
877,5,4,-1,882677128,882677183,55,531,275,4.087912087912088
877,4,5,1,882677183,882677244,61,275,61,4.190476190476191
877,5,2,-3,882677244,882677311,67,61,640,2.75
877,2,4,2,882677311,882677345,34,640,381,3.2758620689655173
877,4,4,0,882677345,882677386,41,381,971,4.0
877,4,4,0,882677386,882677507,121,971,52,3.727272727272727
877,4,5,1,882677507,882677640,133,52,515,4.202898550724638
877,5,4,-1,882677640,882677715,75,515,557,3.090909090909091
877,4,1,-3,882677715,882677749,34,557,737,3.12
877,1,4,3,882677749,882677827,78,737,216,3.8454545454545452
877,4,4,0,882677827,882677898,71,216,732,3.6266666666666665
877,4,5,1,882677898,882677936,38,732,662,3.4583333333333335
877,5,3,-2,882677936,882677967,31,662,111,3.5106382978723403
877,3,2,-1,882677967,882677997,30,111,155,3.0588235294117645
877,2,4,2,882677997,882678105,108,155,739,3.391304347826087
877,4,4,0,882678105,882678194,89,739,241,3.5625
877,4,4,0,882678194,882678387,193,241,185,3.9726027397260273
877,4,4,0,882678387,882678427,40,185,203,3.826923076923077
877,4,5,1,882678427,882678483,56,203,56,4.051724137931035
877,5,2,-3,882678483,882678484,1,56,222,3.578125
873,2,4,2,891392092,891392238,146,269,300,3.6861313868613137
873,4,3,-1,891392238,891392303,65,300,750,4.027777777777778
873,3,3,0,891392303,891392360,57,750,307,3.6031746031746033
873,3,4,1,891392360,891392656,296,307,326,3.262295081967213
873,4,1,-3,891392656,891392698,42,326,259,2.492063492063492
873,1,4,3,891392698,891392756,58,259,328,3.4895833333333335
873,4,3,-1,891392756,891392818,62,328,258,3.7547169811320753
873,3,3,0,891392818,891392871,53,258,339,2.7058823529411766
880,3,4,1,880166475,880166557,82,327,328,3.4895833333333335
880,4,4,0,880166557,880166577,20,328,689,3.1538461538461537
880,4,4,0,880166577,880166662,85,689,948,2.2962962962962963
880,4,5,1,880166662,880166770,108,948,273,3.5238095238095237
880,5,2,-3,880166770,880166799,29,273,628,3.573529411764706
880,2,4,2,880166799,880166827,28,628,298,3.779220779220779
880,4,4,0,880166827,880166847,20,298,742,3.5555555555555554
880,4,4,0,880166847,880166938,91,742,25,3.3185840707964602
880,4,4,0,880166938,880166939,1,25,1059,2.764705882352941
880,4,5,1,880166939,880166966,27,1059,100,4.0162162162162165
880,5,3,-2,880166966,880166990,24,100,235,3.106382978723404
880,3,3,0,880166990,880167008,18,235,283,3.901639344262295
880,3,2,-1,880167008,880167030,22,283,148,3.2131147540983607
880,2,5,3,880167030,880167066,36,148,127,4.162790697674419
880,5,4,-1,880167066,880167083,17,127,685,3.2666666666666666
880,4,4,0,880167083,880167114,31,685,109,3.282608695652174
880,4,3,-1,880167114,880167132,18,109,473,2.9166666666666665
880,3,4,1,880167132,880167151,19,473,240,3.0350877192982457
880,4,3,-1,880167151,880167175,24,240,24,3.3728813559322033
880,3,3,0,880167175,880167200,25,24,845,3.661290322580645
880,3,4,1,880167200,880167223,23,845,1016,3.559322033898305
880,4,3,-1,880167223,880167247,24,1016,763,3.347826086956522
880,3,3,0,880167247,880167288,41,763,1620,3.6666666666666665
880,3,3,0,880167288,880167306,18,1620,412,2.272727272727273
880,3,4,1,880167306,880167328,22,412,405,3.25
880,4,4,0,880167328,880167355,27,405,1277,3.5555555555555554
880,4,3,-1,880167355,880167410,55,1277,546,2.9789473684210526
880,3,3,0,880167410,880167411,1,546,841,2.772727272727273
880,3,3,0,880167411,880167435,24,841,823,2.75
880,3,3,0,880167435,880167454,19,823,1151,2.6666666666666665
880,3,5,2,880167454,880167521,67,1151,257,3.7154471544715446
880,5,3,-2,880167521,880167551,30,257,118,3.2764227642276422
880,3,3,0,880167551,880167569,18,118,986,2.5555555555555554
880,3,1,-2,880167569,880167599,30,986,1215,2.0714285714285716
880,1,4,3,880167599,880167670,71,1215,195,3.9072164948453607
880,4,5,1,880167670,880167671,1,195,187,4.215189873417722
880,5,4,-1,880167671,880167695,24,187,22,4.215909090909091
880,4,4,0,880167695,880167731,36,22,39,3.107142857142857
880,4,4,0,880167731,880167778,47,39,435,3.8933333333333335
880,4,3,-1,880167778,880167806,28,435,82,3.6741573033707864
880,3,4,1,880167806,880167842,36,82,188,3.625
880,4,4,0,880167842,880174652,6810,188,732,3.6266666666666665
880,4,4,0,880174652,880174677,25,732,70,3.5833333333333335
880,4,3,-1,880174677,880174705,28,70,88,3.433734939759036
880,3,4,1,880174705,880174730,25,88,367,3.4242424242424243
880,4,1,-3,880174730,880174749,19,367,721,3.4583333333333335
880,1,3,2,880174749,880174780,31,721,173,4.1441441441441444
880,3,4,1,880174780,880174834,54,173,201,3.75
880,4,3,-1,880174834,880174858,24,201,90,3.0
880,3,4,1,880174858,880174879,21,90,824,2.590909090909091
880,4,3,-1,880174879,880174904,25,824,722,2.9642857142857144
880,3,3,0,880174904,880174926,22,722,393,3.5125
880,3,2,-1,880174926,880174961,35,393,791,3.0
880,2,1,-1,880174961,880174995,34,791,1185,2.111111111111111
880,1,4,3,880174995,880175023,28,1185,731,3.4
880,4,3,-1,880175023,880175050,27,731,790,2.8518518518518516
880,3,3,0,880175050,880175097,47,790,94,2.8823529411764706
880,3,2,-1,880175097,880175128,31,94,158,2.7027027027027026
880,2,3,1,880175128,880175157,29,158,940,2.4
880,3,2,-1,880175157,880175187,30,940,571,2.5
880,2,3,1,880175187,880175208,21,571,122,2.282608695652174
880,3,3,0,880175208,880175239,31,122,376,2.9166666666666665
880,3,3,0,880175239,880175240,1,376,734,3.0
880,3,3,0,880175240,880175270,30,734,456,2.2
880,3,3,0,880175270,880175368,98,456,1258,2.3333333333333335
880,3,2,-1,880175368,880175405,37,1258,1023,2.5714285714285716
880,2,3,1,880175405,880175444,39,1023,476,3.1216216216216215
880,3,2,-1,880175444,880175468,24,476,818,2.769230769230769
880,2,2,0,880175468,880175527,59,818,1165,1.8
880,2,3,1,880175527,880175577,50,1165,1423,2.25
880,3,5,2,880175577,880175597,20,1423,191,4.168674698795181
880,5,5,0,880175597,880175622,25,191,12,4.358974358974359
880,5,4,-1,880175622,880175666,44,12,461,3.3333333333333335
880,4,5,1,880175666,880175690,24,461,423,3.7016129032258065
880,5,4,-1,880175690,880175735,45,423,179,3.8823529411764706
880,4,4,0,880175735,880241256,65521,179,418,3.825
880,4,5,1,880241256,880241327,71,418,98,4.240875912408759
880,5,5,0,880241327,880241355,28,98,185,3.9726027397260273
880,5,3,-2,880241355,880241379,24,185,5,3.1481481481481484
880,3,4,1,880241379,880241434,55,5,379,3.35
880,4,3,-1,880241434,880241492,58,379,769,2.2222222222222223
880,3,5,2,880241492,880241609,117,769,1134,2.888888888888889
880,5,5,0,880241609,880241746,137,1134,318,4.5046728971962615
880,5,4,-1,880241746,880241821,75,318,467,4.071428571428571
880,4,5,1,880241821,880241822,1,467,180,3.9473684210526314
880,5,4,-1,880241822,880241913,91,180,87,3.9
880,4,4,0,880241913,880241943,30,87,527,3.823529411764706
880,4,4,0,880241943,880241977,34,527,65,3.511111111111111
880,4,3,-1,880241977,880242028,51,65,1119,3.5185185185185186
880,3,4,1,880242028,880242094,66,1119,81,3.2857142857142856
880,4,4,0,880242094,880242139,45,81,1468,4.0
880,4,5,1,880242139,880242191,52,1468,693,3.6285714285714286
880,5,2,-3,880242191,880242257,66,693,366,3.4285714285714284
880,2,3,1,880242257,880242281,24,366,380,3.4878048780487805
880,3,4,1,880242281,880242306,25,380,470,3.72
880,4,4,0,880242306,880242356,50,470,1267,2.909090909090909
880,4,3,-1,880242356,880242380,24,1267,956,3.5714285714285716
880,3,3,0,880242380,880242451,71,956,556,2.7142857142857144
880,3,3,0,880242451,880242503,52,556,54,3.3714285714285714
880,3,4,1,880242503,880242528,25,54,284,3.1547619047619047
880,4,3,-1,880242528,880242547,19,284,1478,2.7
880,3,4,1,880242547,880242577,30,1478,1139,2.611111111111111
880,4,3,-1,880242577,880242632,55,1139,1224,2.6666666666666665
880,3,3,0,880242632,880242660,28,1224,1053,3.3846153846153846
880,3,3,0,880242660,880242781,121,1053,1181,2.6
880,3,2,-1,880242781,880242848,67,1181,768,3.238095238095238
880,2,4,2,880242848,880242933,85,768,625,3.25
880,4,4,0,880242933,880243001,68,625,140,3.238095238095238
880,4,2,-2,880243001,880243204,203,140,421,3.462962962962963
880,2,2,0,880243204,880243230,26,421,451,3.207792207792208
880,2,4,2,880243230,880243265,35,451,794,3.6
880,4,4,0,880243265,880243410,145,794,728,3.05
880,4,4,0,880243410,880243499,89,728,619,3.4782608695652173
880,4,1,-3,880243499,880243541,42,619,595,2.9166666666666665
880,1,3,2,880243541,880243564,23,595,931,2.2758620689655173
880,3,2,-1,880243564,880243588,24,931,976,1.6666666666666667
880,2,4,2,880243588,880243629,41,976,31,3.642857142857143
880,4,4,0,880243629,880243712,83,31,44,3.1333333333333333
880,4,4,0,880243712,880243790,78,44,1210,2.7142857142857144
880,4,4,0,880243790,880243817,27,1210,1157,3.142857142857143
880,4,3,-1,880243817,880243848,31,1157,771,2.5714285714285716
880,3,3,0,880243848,880243882,34,771,579,2.727272727272727
880,3,4,1,880243882,892958090,12714208,579,269,4.085106382978723
880,4,5,1,892958090,892958128,38,269,316,4.285714285714286
880,5,5,0,892958128,892958175,47,316,315,4.15
880,5,4,-1,892958175,892958301,126,315,902,3.9444444444444446
880,4,2,-2,892958301,892958350,49,902,245,3.056179775280899
880,2,4,2,892958350,892958376,26,245,876,3.0
880,4,4,0,892958376,892958401,25,876,881,2.769230769230769
880,4,4,0,892958401,892958484,83,881,260,2.4716981132075473
880,4,4,0,892958484,892958517,33,260,299,3.0
880,4,2,-2,892958517,892958608,91,299,243,2.357142857142857
880,2,4,2,892958608,892958799,191,243,1664,2.5
880,4,5,1,892958799,892958837,38,1664,246,4.0
880,5,5,0,892958837,892958887,50,246,295,3.769230769230769
880,5,4,-1,892958887,892959014,127,295,992,4.0
880,4,4,0,892959014,892959041,27,992,1014,3.1
880,4,4,0,892959041,892959246,205,1014,746,3.7560975609756095
880,4,4,0,892959246,893028814,69568,746,815,3.135135135135135
878,2,4,2,880865230,880865469,239,690,275,4.087912087912088
878,4,4,0,880865469,880865562,93,275,9,3.8878504672897196
878,4,3,-1,880865562,880865770,208,9,181,3.98974358974359
878,3,5,2,880865770,880865865,95,181,14,4.101694915254237
878,5,4,-1,880865865,880865900,35,14,515,4.202898550724638
878,4,3,-1,880865900,880865940,40,515,126,3.8620689655172415
878,3,5,2,880865940,880866013,73,126,318,4.5046728971962615
878,5,4,-1,880866013,880866054,41,318,317,3.774193548387097
878,4,3,-1,880866054,880866103,49,317,485,3.717948717948718
878,3,4,1,880866103,880866134,31,485,482,3.9444444444444446
878,4,5,1,880866134,880866177,43,482,153,3.7865168539325844
878,5,4,-1,880866177,880866241,64,153,165,3.9130434782608696
878,4,4,0,880866241,880866288,47,165,509,3.7058823529411766
878,4,3,-1,880866288,880866369,81,509,154,3.6031746031746033
878,3,2,-1,880866369,880866409,40,154,707,3.909090909090909
878,2,5,3,880866409,880866446,37,707,64,4.373737373737374
878,5,4,-1,880866446,880866509,63,64,462,3.7954545454545454
878,4,2,-2,880866509,880866564,55,462,531,3.7435897435897436
878,2,4,2,880866564,880866626,62,531,179,3.8823529411764706
878,4,3,-1,880866626,880866687,61,179,923,4.142857142857143
878,3,4,1,880866687,880866810,123,923,511,4.096153846153846
878,4,2,-2,880866810,880866883,73,511,650,3.1363636363636362
878,2,2,0,880866883,880866918,35,650,22,4.215909090909091
878,2,3,1,880866918,880866971,53,22,642,3.4285714285714284
878,3,5,2,880866971,880867387,416,642,496,4.094594594594595
878,5,3,-2,880867387,880867444,57,496,1092,2.5714285714285716
878,3,4,1,880867444,880867485,41,1092,170,4.242424242424242
878,4,4,0,880867485,880867665,180,170,921,3.611111111111111
878,4,5,1,880867665,880867709,44,921,512,3.888888888888889
878,5,1,-4,880867709,880867751,42,512,640,2.75
878,1,3,2,880867751,880867803,52,640,855,3.590909090909091
878,3,3,0,880867803,880867854,51,855,213,3.943396226415094
878,3,3,0,880867854,880867987,133,213,212,3.230769230769231
878,3,3,0,880867987,880868035,48,212,283,3.901639344262295
878,3,5,2,880868035,880868819,784,283,474,4.172413793103448
878,5,4,-1,880868819,880868820,1,474,1149,3.857142857142857
878,4,3,-1,880868820,880868955,135,1149,237,3.7315436241610738
878,3,3,0,880868955,880869003,48,237,274,3.5609756097560976
878,3,3,0,880869003,880869090,87,274,97,3.7282608695652173
878,3,2,-1,880869090,880869135,45,97,451,3.207792207792208
878,2,4,2,880869135,880869191,56,451,692,3.56
878,4,3,-1,880869191,880869239,48,692,371,3.0
878,3,4,1,880869239,880869302,63,371,732,3.6266666666666665
878,4,3,-1,880869302,880869303,1,732,553,3.5
878,3,3,0,880869303,880869354,51,553,66,3.4705882352941178
878,3,3,0,880869354,880869418,64,66,155,3.0588235294117645
878,3,2,-1,880869418,880869473,55,155,796,2.923076923076923
878,2,2,0,880869473,880869638,165,796,116,3.6666666666666665
878,2,2,0,880869638,880870048,410,116,588,3.8358208955223883
878,2,4,2,880870048,880870130,82,588,99,3.8392857142857144
878,4,1,-3,880870130,880870609,479,99,151,3.6544117647058822
878,1,3,2,880870609,880870765,156,151,225,3.0714285714285716
878,3,5,2,880870765,880870854,89,225,416,3.3846153846153846
878,5,5,0,880870854,880872394,1540,416,427,4.2025316455696204
878,5,2,-3,880872394,880872395,1,427,497,3.35
869,2,3,1,884490097,884490151,54,242,294,3.1052631578947367
869,3,2,-1,884490151,884490251,100,294,312,3.0
869,2,3,1,884490251,884490332,81,312,315,4.15
869,3,3,0,884490332,884490825,493,315,181,3.98974358974359
869,3,4,1,884490825,884490892,67,181,116,3.6666666666666665
869,4,4,0,884490892,884490936,44,116,275,4.087912087912088
869,4,3,-1,884490936,884490987,51,275,282,3.610526315789474
869,3,4,1,884490987,884491082,95,282,276,3.6036036036036037
869,4,3,-1,884491082,884491199,117,276,13,3.5454545454545454
869,3,2,-1,884491199,884491767,568,13,25,3.3185840707964602
869,2,1,-1,884491767,884491966,199,25,284,3.1547619047619047
869,1,1,0,884491966,884491993,27,284,15,3.725663716814159
869,1,1,0,884491993,884492338,345,15,118,3.2764227642276422
869,1,1,0,884492338,884492377,39,118,1061,2.9166666666666665
869,1,1,0,884492377,884492445,68,1061,1134,2.888888888888889
869,1,2,1,884492445,884492571,126,1134,1047,2.6923076923076925
869,2,4,2,884492571,884492828,257,1047,411,2.911764705882353
869,4,1,-3,884492828,884492906,78,411,1132,2.588235294117647
869,1,2,1,884492906,884493021,115,1132,696,3.138888888888889
869,2,3,1,884493021,884493060,39,696,122,2.282608695652174
881,3,2,-1,876535599,876535663,64,259,243,2.357142857142857
881,2,2,0,876535663,876535695,32,243,678,2.8181818181818183
881,2,5,3,876535695,876535796,101,678,117,3.689189189189189
881,5,3,-2,876535796,876535927,131,117,50,4.306532663316583
881,3,4,1,876535927,876535967,40,50,515,4.202898550724638
881,4,4,0,876535967,876536012,45,515,546,2.9789473684210526
881,4,5,1,876536012,876536040,28,546,257,3.7154471544715446
881,5,5,0,876536040,876536079,39,257,222,3.578125
881,5,4,-1,876536079,876536107,28,222,477,3.1666666666666665
881,4,4,0,876536107,876536164,57,477,7,3.76056338028169
881,4,3,-1,876536164,876536198,34,7,9,3.8878504672897196
881,3,2,-1,876536198,876536241,43,9,151,3.6544117647058822
881,2,4,2,876536241,876536332,91,151,118,3.2764227642276422
881,4,4,0,876536332,876536364,32,118,13,3.5454545454545454
881,4,5,1,876536364,876536391,27,13,121,3.521212121212121
881,5,4,-1,876536391,876536414,23,121,100,4.0162162162162165
881,4,3,-1,876536414,876536439,25,100,281,3.2
881,3,2,-1,876536439,876536636,197,281,473,2.9166666666666665
881,2,3,1,876536636,876536667,31,473,21,2.9210526315789473
881,3,1,-2,876536667,876536745,78,21,103,2.2
881,1,4,3,876536745,876536773,28,103,282,3.610526315789474
881,4,3,-1,876536773,876536850,77,282,274,3.5609756097560976
881,3,2,-1,876536850,876536877,27,274,685,3.2666666666666666
881,2,2,0,876536877,876536978,101,685,112,2.7
881,2,1,-1,876536978,876537011,33,112,1089,2.1363636363636362
881,1,3,2,876537011,876537056,45,1089,1028,2.857142857142857
881,3,1,-2,876537056,876537106,50,1028,1164,1.0
881,1,3,2,876537106,876537177,71,1164,291,3.2
881,3,4,1,876537177,876537285,108,291,472,2.984375
881,4,4,0,876537285,876537404,119,472,943,3.6666666666666665
881,4,5,1,876537404,876537418,14,943,185,3.9726027397260273
881,5,5,0,876537418,876537419,1,185,511,4.096153846153846
881,5,3,-2,876537419,876537512,93,511,178,4.378378378378378
881,3,5,2,876537512,876537577,65,178,31,3.642857142857143
881,5,5,0,876537577,876537612,35,31,28,3.923076923076923
881,5,3,-2,876537612,876537613,1,28,97,3.7282608695652173
881,3,4,1,876537613,876537718,105,97,133,3.7777777777777777
881,4,5,1,876537718,876537752,34,133,495,3.65
881,5,3,-2,876537752,876537825,73,495,432,3.719298245614035
881,3,4,1,876537825,876537870,45,432,430,4.136363636363637
881,4,3,-1,876537870,876537900,30,430,527,3.823529411764706
881,3,3,0,876537900,876537933,33,527,69,3.8015873015873014
881,3,3,0,876537933,876537995,62,69,228,3.7246376811594204
881,3,3,0,876537995,876538027,32,228,588,3.8358208955223883
881,3,5,2,876538027,876538028,1,588,22,4.215909090909091
881,5,5,0,876538028,876538063,35,22,180,3.9473684210526314
881,5,3,-2,876538063,876538098,35,180,208,3.8125
881,3,3,0,876538098,876538131,33,208,217,3.1538461538461537
881,3,5,2,876538131,876538155,24,217,392,3.5555555555555554
881,5,2,-3,876538155,876538185,30,392,200,3.8157894736842106
881,2,5,3,876538185,876538251,66,200,580,3.625
881,5,4,-1,876538251,876538322,71,580,214,3.272727272727273
881,4,3,-1,876538322,876538400,78,214,226,3.378787878787879
881,3,4,1,876538400,876538506,106,226,204,3.6744186046511627
881,4,5,1,876538506,876538536,30,204,528,4.241379310344827
881,5,4,-1,876538536,876538537,1,528,136,3.764705882352941
881,4,3,-1,876538537,876538595,58,136,465,3.75
881,3,4,1,876538595,876538665,70,465,188,3.625
881,4,3,-1,876538665,876538666,1,188,81,3.2857142857142856
881,3,5,2,876538666,876538691,25,81,419,3.8208955223880596
881,5,3,-2,876538691,876538726,35,419,132,3.929411764705882
881,3,3,0,876538726,876538763,37,132,38,2.784313725490196
881,3,3,0,876538763,876538824,61,38,576,3.125
881,3,4,1,876538824,876538853,29,576,63,3.125
881,4,2,-2,876538853,876538889,36,63,434,3.588235294117647
881,2,4,2,876538889,876538922,33,434,755,3.085714285714286
881,4,4,0,876538922,876538953,31,755,447,3.46875
881,4,5,1,876538953,876538986,33,447,520,4.136363636363637
881,5,4,-1,876538986,876539020,34,520,506,3.566666666666667
881,4,2,-2,876539020,876539051,31,506,849,2.5625
881,2,4,2,876539051,876539091,40,849,393,3.5125
881,4,5,1,876539091,876539128,37,393,143,3.56
881,5,4,-1,876539128,876539156,28,143,654,4.119047619047619
881,4,5,1,876539156,876539186,30,654,601,3.857142857142857
881,5,4,-1,876539186,876539187,1,601,630,3.25
881,4,1,-3,876539187,876539260,73,630,401,2.6774193548387095
881,1,3,2,876539260,876539261,1,401,550,3.272727272727273
881,3,4,1,876539261,876539291,30,550,230,3.3518518518518516
881,4,2,-2,876539291,876539330,39,230,575,2.619047619047619
881,2,2,0,876539330,876539360,30,575,1133,3.076923076923077
881,2,4,2,876539360,876539387,27,1133,54,3.3714285714285714
881,4,2,-2,876539387,876539418,31,54,795,2.4
881,2,3,1,876539418,876539477,59,795,356,3.2
881,3,3,0,876539477,876539505,28,356,768,3.238095238095238
881,3,2,-1,876539505,876539595,90,768,1411,2.4615384615384617
881,2,4,2,876539595,876539636,41,1411,195,3.9072164948453607
881,4,4,0,876539636,879051511,2511875,195,322,3.0476190476190474
881,4,1,-3,879051511,879052109,598,322,826,2.5555555555555554
881,1,4,3,879052109,879052141,32,826,129,3.744186046511628
881,4,2,-2,879052141,879052198,57,129,620,3.0
881,2,1,-1,879052198,879052291,93,620,456,2.2
881,1,3,2,879052291,879052317,26,456,763,3.347826086956522
881,3,3,0,879052317,879052376,59,763,411,2.911764705882353
881,3,3,0,879052376,879052402,26,411,108,3.107142857142857
881,3,4,1,879052402,879052545,143,108,409,2.9615384615384617
879,4,2,-2,887760823,887760879,56,292,751,3.3896103896103895
879,2,3,1,887760879,887760951,72,751,294,3.1052631578947367
879,3,4,1,887760951,887761088,137,294,181,3.98974358974359
879,4,4,0,887761088,887761156,68,181,255,3.2027027027027026
879,4,5,1,887761156,887761174,18,255,125,3.5555555555555554
879,5,2,-3,887761174,887761229,55,125,597,3.2771084337349397
879,2,2,0,887761229,887761380,151,597,596,3.180327868852459
879,2,5,3,887761380,887761425,45,596,763,3.347826086956522
879,5,4,-1,887761425,887761460,35,763,222,3.578125
883,4,5,1,891691388,891691410,22,882,302,4.133333333333334
883,5,4,-1,891691410,891691436,26,302,270,3.7804878048780486
883,4,3,-1,891691436,891691465,29,270,345,3.4782608695652173
883,3,3,0,891691465,891691485,20,345,750,4.027777777777778
883,3,4,1,891691485,891691505,20,750,311,3.761904761904762
883,4,4,0,891691505,891691534,29,311,902,3.9444444444444446
883,4,4,0,891691534,891691559,25,902,347,3.59375
883,4,3,-1,891691559,891691560,1,347,319,3.0408163265306123
883,3,5,2,891691560,891691654,94,319,900,4.2
883,5,4,-1,891691654,891692116,462,900,342,2.64
883,4,5,1,891692116,891692168,52,342,748,3.1043478260869564
883,5,3,-2,891692168,891692285,117,748,313,4.323076923076923
883,3,4,1,891692285,891692683,398,313,224,3.4545454545454546
883,4,5,1,891692683,891692713,30,224,256,3.5
883,5,4,-1,891692713,891692742,29,256,283,3.901639344262295
883,4,4,0,891692742,891692765,23,283,1115,3.3846153846153846
883,4,5,1,891692765,891692786,21,1115,116,3.6666666666666665
883,5,4,-1,891692786,891692811,25,116,1009,3.2962962962962963
883,4,3,-1,891692811,891692874,63,1009,634,3.6
883,3,5,2,891692874,891692982,108,634,59,4.0
883,5,3,-2,891692982,891693012,30,59,207,3.4761904761904763
883,3,3,0,891693012,891693058,46,207,463,3.6818181818181817
883,3,5,2,891693058,891693085,27,463,462,3.7954545454545454
883,5,5,0,891693085,891693110,25,462,694,4.277777777777778
883,5,3,-2,891693110,891693139,29,694,707,3.909090909090909
883,3,3,0,891693139,891693169,30,707,70,3.5833333333333335
883,3,3,0,891693169,891693200,31,70,584,3.5238095238095237
883,3,3,0,891693200,891693387,187,584,582,3.7457627118644066
883,3,3,0,891693387,891693497,110,582,863,3.727272727272727
883,3,3,0,891693497,891693675,178,863,14,4.101694915254237
883,3,3,0,891693675,891693702,27,14,1121,3.5
883,3,4,1,891693702,891693723,21,1121,20,3.375
883,4,4,0,891693723,891694218,495,20,238,3.888888888888889
883,4,3,-1,891694218,891694249,31,238,712,3.0434782608695654
883,3,5,2,891694249,891694276,27,712,523,4.159090909090909
883,5,5,0,891694276,891694311,35,523,715,3.257142857142857
883,5,5,0,891694311,891694312,1,715,175,3.8354430379746836
883,5,4,-1,891694312,891694340,28,175,208,3.8125
883,4,4,0,891694340,891694372,32,208,516,4.055555555555555
883,4,3,-1,891694372,891694401,29,516,239,3.423076923076923
883,3,3,0,891694401,891694431,30,239,414,3.3076923076923075
883,3,3,0,891694431,891694544,113,414,372,3.6666666666666665
883,3,3,0,891694544,891694636,92,372,66,3.4705882352941178
883,3,4,1,891694636,891695193,557,66,338,2.75
883,4,5,1,891695193,891695588,395,338,867,4.0
883,5,3,-2,891695588,891695666,78,867,98,4.240875912408759
883,3,5,2,891695666,891695692,26,98,185,3.9726027397260273
883,5,2,-3,891695692,891695743,51,185,396,2.84
883,2,4,2,891695743,891696714,971,396,241,3.5625
883,4,2,-2,891696714,891696715,1,241,739,3.391304347826087
883,2,3,1,891696715,891696750,35,739,727,3.5517241379310347
883,3,4,1,891696750,891696782,32,727,553,3.5
883,4,3,-1,891696782,891696823,41,553,530,4.125
883,3,4,1,891696823,891696824,1,530,228,3.7246376811594204
883,4,4,0,891696824,891696864,40,228,39,3.107142857142857
883,4,4,0,891696864,891696895,31,39,435,3.8933333333333335
883,4,4,0,891696895,891696930,35,435,229,3.185185185185185
883,4,4,0,891696930,891696957,27,229,770,3.25
883,4,5,1,891696957,891717319,20362,770,647,4.142857142857143
883,5,4,-1,891717319,891717356,37,647,12,4.358974358974359
883,4,3,-1,891717356,891717380,24,12,58,3.543859649122807
883,3,2,-1,891717380,891717419,39,58,147,3.3142857142857145
883,2,5,3,891717419,891717533,114,147,464,3.8
883,5,3,-2,891717533,891717908,375,464,28,3.923076923076923
883,3,3,0,891717908,891717963,55,28,237,3.7315436241610738
883,3,4,1,891717963,891717988,25,237,64,4.373737373737374
883,4,4,0,891717988,891723323,5335,64,805,3.909090909090909
883,4,4,0,891723323,891723351,28,805,13,3.5454545454545454
883,4,5,1,891723351,891754985,31634,13,589,4.384615384615385
883,5,5,0,891754985,891755017,32,589,479,4.25
883,5,5,0,891755017,891755088,71,479,129,3.744186046511628
883,5,5,0,891755088,891914522,159434,129,408,4.4772727272727275
883,5,5,0,891914522,891914545,23,408,477,3.1666666666666665
883,5,5,0,891914545,891914605,60,477,257,3.7154471544715446
883,5,4,-1,891914605,891916411,1806,257,455,3.1702127659574466
883,4,3,-1,891916411,891916961,550,455,405,3.25
883,3,3,0,891916961,892439468,522507,405,250,3.4698795180722892
883,3,5,2,892439468,892439523,55,250,151,3.6544117647058822
882,4,4,0,879860936,879861325,389,294,243,2.357142857142857
882,4,5,1,879861325,879861385,60,243,988,2.5555555555555554
882,5,4,-1,879861385,879861492,107,988,117,3.689189189189189
882,4,5,1,879861492,879861678,186,117,275,4.087912087912088
882,5,4,-1,879861678,879862217,539,275,290,3.108108108108108
882,4,5,1,879862217,879862327,110,290,237,3.7315436241610738
882,5,4,-1,879862327,879862936,609,237,291,3.2
882,4,4,0,879862936,879863031,95,291,409,2.9615384615384617
882,4,1,-3,879863031,879863176,145,409,929,2.8421052631578947
882,1,3,2,879863176,879863257,81,929,369,2.5714285714285716
882,3,3,0,879863257,879863560,303,369,235,3.106382978723404
882,3,3,0,879863560,879863735,175,235,105,2.6176470588235294
882,3,1,-2,879863735,879863909,174,105,841,2.772727272727273
882,1,3,2,879863909,879863969,60,841,820,3.0444444444444443
882,3,4,1,879863969,879864642,673,820,526,3.909090909090909
882,4,5,1,879864642,879864697,55,526,204,3.6744186046511627
882,5,4,-1,879864697,879864789,92,204,183,3.951219512195122
882,4,5,1,879864789,879864917,128,183,69,3.8015873015873014
882,5,5,0,879864917,879864970,53,69,132,3.929411764705882
882,5,4,-1,879864970,879865163,193,132,746,3.7560975609756095
882,4,4,0,879865163,879865307,144,746,180,3.9473684210526314
882,4,5,1,879865307,879865750,443,180,98,4.240875912408759
882,5,5,0,879865750,879867430,1680,98,181,3.98974358974359
882,5,4,-1,879867430,879867431,1,181,211,3.958904109589041
882,4,5,1,879867431,879867508,77,211,199,4.191489361702128
882,5,5,0,879867508,879867568,60,199,195,3.9072164948453607
882,5,5,0,879867568,879867631,63,195,168,4.0476190476190474
882,5,5,0,879867631,879867694,63,168,50,4.306532663316583
882,5,4,-1,879867694,879867816,122,50,470,3.72
882,4,5,1,879867816,879867885,69,470,82,3.6741573033707864
882,5,4,-1,879867885,879867980,95,82,66,3.4705882352941178
882,4,4,0,879867980,879868118,138,66,4,3.5538461538461537
882,4,2,-2,879868118,879868197,79,4,33,3.2941176470588234
882,2,5,3,879868197,879868198,1,33,378,3.6904761904761907
882,5,5,0,879868198,879877245,9047,378,185,3.9726027397260273
882,5,3,-2,879877245,879879731,2486,185,660,3.71875
882,3,3,0,879879731,879879807,76,660,101,3.4827586206896552
882,3,4,1,879879807,879879868,61,101,227,3.169811320754717
882,4,4,0,879879868,879880132,264,227,393,3.5125
884,4,4,0,876857845,876858877,1032,275,127,4.162790697674419
884,4,4,0,876858877,876858914,37,127,116,3.6666666666666665
884,4,4,0,876858914,876858946,32,116,14,4.101694915254237
884,4,2,-2,876858946,876859024,78,14,1009,3.2962962962962963
884,2,5,3,876859024,876859070,46,1009,463,3.6818181818181817
884,5,4,-1,876859070,876859090,20,463,509,3.7058823529411766
884,4,3,-1,876859090,876859109,19,509,923,4.142857142857143
884,3,4,1,876859109,876859138,29,923,1073,3.6315789473684212
884,4,1,-3,876859138,876859161,23,1073,640,2.75
884,1,4,3,876859161,876859207,46,640,213,3.943396226415094
884,4,3,-1,876859207,876859208,1,213,86,3.869565217391304
884,3,4,1,876859208,876859238,30,86,212,3.230769230769231
884,4,5,1,876859238,876859277,39,212,921,3.611111111111111
884,5,4,-1,876859277,876859301,24,921,638,3.923076923076923
884,4,3,-1,876859301,876859329,28,638,736,4.083333333333333
884,3,5,2,876859329,876859330,1,736,510,3.823529411764706
884,5,5,0,876859330,876859351,21,510,582,3.7457627118644066
884,5,2,-3,876859351,876860514,1163,582,1018,3.0714285714285716
884,2,2,0,876860514,876860604,90,1018,949,3.392857142857143
886,3,5,2,876031173,876031308,135,328,318,4.5046728971962615
886,5,4,-1,876031308,876031309,1,318,184,3.393939393939394
886,4,5,1,876031309,876031330,21,184,7,3.76056338028169
886,5,3,-2,876031330,876031365,35,7,589,4.384615384615385
886,3,5,2,876031365,876031392,27,589,180,3.9473684210526314
886,5,4,-1,876031392,876031413,21,180,156,4.017857142857143
886,4,4,0,876031413,876031433,20,156,1,3.902439024390244
886,4,3,-1,876031433,876031459,26,1,238,3.888888888888889
886,3,3,0,876031459,876031481,22,238,1170,3.1666666666666665
886,3,5,2,876031481,876031501,20,1170,475,3.956043956043956
886,5,1,-4,876031501,876031526,25,475,512,3.888888888888889
886,1,5,4,876031526,876031527,1,512,172,4.225225225225225
886,5,4,-1,876031527,876031551,24,172,128,3.45
886,4,4,0,876031551,876031573,22,128,168,4.0476190476190474
886,4,3,-1,876031573,876031601,28,168,4,3.5538461538461537
886,3,4,1,876031601,876031622,21,4,55,4.051282051282051
886,4,3,-1,876031622,876031656,34,55,789,3.7777777777777777
886,3,5,2,876031656,876031695,39,789,657,4.341463414634147
886,5,3,-2,876031695,876031720,25,657,240,3.0350877192982457
886,3,2,-1,876031720,876031739,19,240,20,3.375
886,2,3,1,876031739,876031764,25,20,208,3.8125
886,3,4,1,876031764,876031850,86,208,209,3.8275862068965516
886,4,4,0,876031850,876031869,19,209,919,4.0
886,4,3,-1,876031869,876031870,1,919,65,3.511111111111111
886,3,2,-1,876031870,876031897,27,65,212,3.230769230769231
886,2,2,0,876031897,876031932,35,212,69,3.8015873015873014
886,2,1,-1,876031932,876031973,41,69,772,3.3333333333333335
886,1,4,3,876031973,876031993,20,772,584,3.5238095238095237
886,4,4,0,876031993,876032029,36,584,425,3.7027027027027026
886,4,3,-1,876032029,876032072,43,425,1267,2.909090909090909
886,3,4,1,876032072,876032103,31,1267,101,3.4827586206896552
886,4,3,-1,876032103,876032126,23,101,233,3.323529411764706
886,3,4,1,876032126,876032143,17,233,176,3.967032967032967
886,4,4,0,876032143,876032187,44,176,49,3.3
886,4,3,-1,876032187,876032225,38,49,692,3.56
886,3,2,-1,876032225,876032247,22,692,231,2.938775510204082
886,2,5,3,876032247,876032248,1,231,42,3.893617021276596
886,5,5,0,876032248,876032274,26,42,9,3.8878504672897196
886,5,3,-2,876032274,876032330,56,9,3,3.0625
886,3,3,0,876032330,876032331,1,3,227,3.169811320754717
886,3,4,1,876032331,876032352,21,227,98,4.240875912408759
886,4,3,-1,876032352,876032353,1,98,419,3.8208955223880596
886,3,3,0,876032353,876032422,69,419,68,3.5714285714285716
886,3,3,0,876032422,876032442,20,68,66,3.4705882352941178
886,3,4,1,876032442,876032472,30,66,127,4.162790697674419
886,4,3,-1,876032472,876032473,1,127,959,3.4583333333333335
886,3,5,2,876032473,876032509,36,959,1067,3.533333333333333
886,5,4,-1,876032509,876032531,22,1067,81,3.2857142857142856
886,4,4,0,876032531,876032553,22,81,1119,3.5185185185185186
886,4,1,-3,876032553,876032577,24,1119,466,3.5
886,1,3,2,876032577,876032596,19,466,1208,2.6666666666666665
886,3,3,0,876032596,876032635,39,1208,239,3.423076923076923
886,3,1,-2,876032635,876032654,19,239,1093,3.0
886,1,3,2,876032654,876032739,85,1093,235,3.106382978723404
886,3,2,-1,876032739,876032776,37,235,217,3.1538461538461537
886,2,4,2,876032776,876032823,47,217,663,3.948717948717949
886,4,5,1,876032823,876032884,61,663,79,3.956989247311828
886,5,3,-2,876032884,876032929,45,79,549,3.4871794871794872
886,3,3,0,876032929,876032973,44,549,568,3.5853658536585367
886,3,3,0,876032973,876033015,42,568,63,3.125
886,3,4,1,876033015,876033053,38,63,164,3.6140350877192984
886,4,1,-3,876033053,876033069,16,164,623,3.0454545454545454
886,1,2,1,876033069,876033106,37,623,230,3.3518518518518516
886,2,2,0,876033106,876033134,28,230,43,3.1
886,2,3,1,876033134,876033181,47,43,393,3.5125
886,3,5,2,876033181,876033200,19,393,108,3.107142857142857
886,5,5,0,876033200,876033228,28,108,762,3.3962264150943398
886,5,3,-2,876033228,876033265,37,762,62,3.048780487804878
886,3,3,0,876033265,876033293,28,62,385,3.6129032258064515
886,3,1,-2,876033293,876033340,47,385,726,2.8
886,1,4,3,876033340,876033368,28,726,761,3.0588235294117645
886,4,1,-3,876033368,876033434,66,761,715,3.257142857142857
886,1,1,0,876033434,876033435,1,715,371,3.0
886,1,5,4,876033435,876033460,25,371,721,3.4583333333333335
886,5,3,-2,876033460,876033461,1,721,566,3.543859649122807
886,3,5,2,876033461,876033478,17,566,161,3.5844155844155843
886,5,1,-4,876033478,876033576,98,161,29,2.5714285714285716
886,1,4,3,876033576,876033602,26,29,1217,3.4166666666666665
886,4,2,-2,876033602,876033624,22,1217,117,3.689189189189189
886,2,4,2,876033624,876033645,21,117,631,3.581818181818182
886,4,4,0,876033645,876033731,86,631,1065,3.1578947368421053
886,4,2,-2,876033731,876033755,24,1065,1046,3.3529411764705883
886,2,3,1,876033755,876033828,73,1046,1231,2.7
886,3,1,-2,876033828,876033850,22,1231,388,2.5833333333333335
886,1,2,1,876033850,876033897,47,388,1095,2.8
886,2,1,-1,876033897,876033987,90,1095,1303,2.857142857142857
886,1,3,2,876033987,876034006,19,1303,364,2.8095238095238093
886,3,1,-2,876034006,876034074,68,364,1489,1.0
886,1,4,3,876034074,876034095,21,1489,790,2.8518518518518516
886,4,2,-2,876034095,876034174,79,790,1421,3.2
886,2,3,1,876034174,876034205,31,1421,801,2.2
886,3,3,0,876034205,876034228,23,801,80,2.967741935483871
886,3,2,-1,876034228,876034255,27,80,940,2.4
886,2,5,3,876034255,876034371,116,940,1014,3.1
885,3,4,1,885712280,885712996,716,181,111,3.5106382978723403
885,4,4,0,885712996,885713062,66,111,476,3.1216216216216215
885,4,2,-2,885713062,885713101,39,476,756,2.6885245901639343
885,2,3,1,885713101,885713102,1,756,866,3.3962264150943398
885,3,2,-1,885713102,885713138,36,866,1061,2.9166666666666665
885,2,3,1,885713138,885713294,156,1061,655,3.7857142857142856
885,3,4,1,885713294,885713357,63,655,173,4.1441441441441444
885,4,3,-1,885713357,885713406,49,173,208,3.8125
885,3,4,1,885713406,885713434,28,208,186,3.905263157894737
885,4,4,0,885713434,885713461,27,186,88,3.433734939759036
885,4,2,-2,885713461,885713502,41,88,209,3.8275862068965516
885,2,5,3,885713502,885713544,42,209,210,3.921259842519685
885,5,3,-2,885713544,885713585,41,210,821,3.076923076923077
885,3,1,-2,885713585,885713631,46,821,72,3.175438596491228
885,1,3,2,885713631,885713680,49,72,393,3.5125
885,3,2,-1,885713680,885713716,36,393,451,3.207792207792208
885,2,3,1,885713716,885713807,91,451,167,2.8181818181818183
885,3,2,-1,885713807,885713833,26,167,94,2.8823529411764706
885,2,2,0,885713833,885713939,106,94,383,2.5
885,2,5,3,885713939,885714093,154,383,318,4.5046728971962615
885,5,5,0,885714093,885714136,43,318,97,3.7282608695652173
885,5,2,-3,885714136,885714159,23,97,135,3.7974683544303796
885,2,4,2,885714159,885714201,42,135,69,3.8015873015873014
885,4,1,-3,885714201,885714226,25,69,179,3.8823529411764706
885,1,3,2,885714226,885714317,91,179,356,3.2
885,3,2,-1,885714317,885714336,19,356,65,3.511111111111111
885,2,3,1,885714336,885714409,73,65,549,3.4871794871794872
885,3,3,0,885714409,885714431,22,549,365,2.95
885,3,4,1,885714431,885714452,21,365,949,3.392857142857143
885,4,2,-2,885714452,885714487,35,949,582,3.7457627118644066
885,2,3,1,885714487,885714531,44,582,953,3.076923076923077
885,3,2,-1,885714531,885714582,51,953,1311,2.125
885,2,3,1,885714582,885714641,59,1311,56,4.051724137931035
885,3,3,0,885714641,885714764,123,56,735,3.58
885,3,3,0,885714764,885714820,56,735,501,3.289473684210526
885,3,5,2,885714820,885715151,331,501,237,3.7315436241610738
885,5,3,-2,885715151,885715221,70,237,216,3.8454545454545452
885,3,4,1,885715221,885715241,20,216,739,3.391304347826087
885,4,3,-1,885715241,885715489,248,739,402,3.3076923076923075
885,3,4,1,885715489,885715643,154,402,117,3.689189189189189
885,4,3,-1,885715643,885715671,28,117,685,3.2666666666666666
885,3,5,2,885715671,885715780,109,685,174,4.253521126760563
885,5,4,-1,885715780,885715803,23,174,79,3.956989247311828
885,4,3,-1,885715803,885715888,85,79,172,4.225225225225225
885,3,3,0,885715888,885715889,1,172,233,3.323529411764706
885,3,4,1,885715889,885715907,18,233,82,3.6741573033707864
885,4,3,-1,885715907,885715946,39,82,188,3.625
885,3,3,0,885715946,885716242,296,188,225,3.0714285714285716
885,3,4,1,885716242,885716328,86,225,419,3.8208955223880596
885,4,4,0,885716328,885716344,16,419,143,3.56
885,4,3,-1,885716344,885716369,25,143,417,3.0588235294117645
889,3,3,0,880176550,880176573,23,303,271,3.3134328358208953
889,3,3,0,880176573,880176596,23,271,879,3.2291666666666665
889,3,3,0,880176596,880176620,24,879,300,3.6861313868613137
889,3,1,-2,880176620,880176666,46,300,338,2.75
889,1,4,3,880176666,880176667,1,338,1022,3.727272727272727
889,4,3,-1,880176667,880176686,19,1022,294,3.1052631578947367
889,3,3,0,880176686,880176717,31,294,322,3.0476190476190474
889,3,2,-1,880176717,880176718,1,322,749,3.2777777777777777
889,2,4,2,880176718,880176807,89,749,718,3.8
889,4,3,-1,880176807,880176845,38,718,297,4.142857142857143
889,3,4,1,880176845,880176874,29,297,237,3.7315436241610738
889,4,4,0,880176874,880176896,22,237,9,3.8878504672897196
889,4,3,-1,880176896,880176960,64,9,408,4.4772727272727275
889,3,4,1,880176960,880176984,24,408,248,3.746268656716418
889,4,3,-1,880176984,880177016,32,248,151,3.6544117647058822
889,3,4,1,880177016,880177050,34,151,124,4.052631578947368
889,4,3,-1,880177050,880177070,20,124,1016,3.559322033898305
889,3,3,0,880177070,880177104,34,1016,544,3.185185185185185
889,3,4,1,880177104,880177131,27,544,181,3.98974358974359
889,4,3,-1,880177131,880177154,23,181,762,3.3962264150943398
889,3,3,0,880177154,880177219,65,762,742,3.5555555555555554
889,3,4,1,880177219,880177246,27,742,282,3.610526315789474
889,4,5,1,880177246,880177266,20,282,129,3.744186046511628
889,5,3,-2,880177266,880177352,86,129,533,3.6
889,3,3,0,880177352,880177435,83,533,1048,2.857142857142857
889,3,3,0,880177435,880177472,37,1048,833,2.9444444444444446
889,3,4,1,880177472,880177502,30,833,763,3.347826086956522
889,4,3,-1,880177502,880177503,1,763,252,2.911392405063291
889,3,4,1,880177503,880177540,37,252,818,2.769230769230769
889,4,2,-2,880177540,880177541,1,818,411,2.911764705882353
889,2,2,0,880177541,880177567,26,411,405,3.25
889,2,3,1,880177567,880177648,81,405,235,3.106382978723404
889,3,4,1,880177648,880177664,16,235,3,3.0625
889,4,2,-2,880177664,880177738,74,3,819,2.6666666666666665
889,2,3,1,880177738,880177778,40,819,1152,3.4375
889,3,4,1,880177778,880177857,79,1152,187,4.215189873417722
889,4,4,0,880177857,880177880,23,187,427,4.2025316455696204
889,4,4,0,880177880,880177941,61,427,657,4.341463414634147
889,4,3,-1,880177941,880177970,29,657,646,3.9285714285714284
889,3,2,-1,880177970,880178019,49,646,209,3.8275862068965516
889,2,4,2,880178019,880178078,59,209,523,4.159090909090909
889,4,2,-2,880178078,880178130,52,523,650,3.1363636363636362
889,2,3,1,880178130,880178131,1,650,165,3.9130434782608696
889,3,1,-2,880178131,880178158,27,165,514,4.033333333333333
889,1,4,3,880178158,880178313,155,514,484,4.116279069767442
889,4,4,0,880178313,880178367,54,484,87,3.9
889,4,4,0,880178367,880178411,44,87,430,4.136363636363637
889,4,3,-1,880178411,880178449,38,430,631,3.581818181818182
889,3,4,1,880178449,880178511,62,631,1218,3.2
889,4,3,-1,880178511,880178512,1,1218,654,4.119047619047619
889,3,3,0,880178512,880179536,1024,654,721,3.4583333333333335
889,3,3,0,880179536,880179586,50,721,695,3.0
889,3,2,-1,880179586,880179612,26,695,732,3.6266666666666665
889,2,4,2,880179612,880179648,36,732,134,4.174603174603175
889,4,3,-1,880179648,880179705,57,134,79,3.956989247311828
889,3,4,1,880179705,880179725,20,79,431,3.422222222222222
889,4,4,0,880179725,880179756,31,431,520,4.136363636363637
889,4,4,0,880179756,880179757,1,520,204,3.6744186046511627
889,4,3,-1,880179757,880179785,28,204,69,3.8015873015873014
889,3,4,1,880179785,880179868,83,69,607,4.136363636363637
889,4,5,1,880179868,880179893,25,607,1073,3.6315789473684212
889,5,2,-3,880179893,880180071,178,1073,1103,3.5555555555555554
889,2,4,2,880180071,880180101,30,1103,175,3.8354430379746836
889,4,4,0,880180101,880180122,21,175,603,4.315789473684211
889,4,4,0,880180122,880180191,69,603,86,3.869565217391304
889,4,4,0,880180191,880180265,74,86,318,4.5046728971962615
889,4,4,0,880180265,880180266,1,318,185,3.9726027397260273
889,4,4,0,880180266,880180414,148,185,469,3.6842105263157894
889,4,4,0,880180414,880180554,140,469,239,3.423076923076923
889,4,5,1,880180554,880180612,58,239,196,3.9404761904761907
889,5,4,-1,880180612,880180650,38,196,180,3.9473684210526314
889,4,5,1,880180650,880180707,57,180,462,3.7954545454545454
889,5,3,-2,880180707,880180765,58,462,4,3.5538461538461537
889,3,4,1,880180765,880180784,19,4,381,3.2758620689655173
889,4,4,0,880180784,880180817,33,381,1065,3.1578947368421053
889,4,4,0,880180817,880180849,32,1065,81,3.2857142857142856
889,4,4,0,880180849,880180897,48,81,161,3.5844155844155843
889,4,4,0,880180897,880180945,48,161,160,3.4
889,4,3,-1,880180945,880180979,34,160,1553,3.0
889,3,4,1,880180979,880181015,36,1553,96,3.9130434782608696
889,4,4,0,880181015,880181086,71,96,658,3.393939393939394
889,4,5,1,880181086,880181138,52,658,199,4.191489361702128
889,5,3,-2,880181138,880181159,21,199,461,3.3333333333333335
889,3,2,-1,880181159,880181191,32,461,731,3.4
889,2,4,2,880181191,880181275,84,731,208,3.8125
889,4,3,-1,880181275,880181317,42,208,72,3.175438596491228
889,3,5,2,880181317,880181372,55,72,512,3.888888888888889
889,5,3,-2,880181372,880181434,62,512,550,3.272727272727273
889,3,3,0,880181434,880181455,21,550,642,3.4285714285714284
889,3,3,0,880181455,880181488,33,642,451,3.207792207792208
889,3,3,0,880181488,880181515,27,451,737,3.12
889,3,5,2,880181515,880181563,48,737,186,3.905263157894737
889,5,2,-3,880181563,880181601,38,186,290,3.108108108108108
889,2,4,2,880181601,880181663,62,290,636,3.4146341463414633
889,4,3,-1,880181663,880181911,248,636,562,3.2941176470588234
889,3,3,0,880181911,880181976,65,562,85,3.3157894736842106
889,3,4,1,880181976,880181995,19,85,28,3.923076923076923
889,4,2,-2,880181995,880182016,21,28,226,3.378787878787879
889,2,3,1,880182016,880182017,1,226,755,3.085714285714286
889,3,3,0,880182017,880182103,86,755,959,3.4583333333333335
889,3,1,-2,880182103,880182127,24,959,1069,3.6
889,1,3,2,880182127,880182173,46,1069,944,2.75
889,3,3,0,880182173,880182270,97,944,232,3.0789473684210527
889,3,3,0,880182270,880182295,25,232,159,3.3902439024390243
889,3,3,0,880182295,880182359,64,159,399,3.317073170731707
889,3,3,0,880182359,880182428,69,399,869,3.0
889,3,3,0,880182428,880182444,16,869,1072,3.0
889,3,3,0,880182444,880182460,16,1072,2,3.0851063829787235
889,3,3,0,880182460,880182496,36,2,402,3.3076923076923075
889,3,3,0,880182496,880182517,21,402,739,3.391304347826087
889,3,3,0,880182517,880182541,24,739,576,3.125
889,3,1,-2,880182541,880182582,41,576,1139,2.611111111111111
889,1,3,2,880182582,880182629,47,1139,1267,2.909090909090909
889,3,2,-1,880182629,880182695,66,1267,664,3.15
889,2,3,1,880182695,880182741,46,664,597,3.2771084337349397
889,3,2,-1,880182741,880182784,43,597,1188,2.45
889,2,1,-1,880182784,880182815,31,1188,1239,2.25
889,1,3,2,880182815,880182850,35,1239,575,2.619047619047619
889,3,3,0,880182850,880182871,21,575,1231,2.7
889,3,3,0,880182871,880182943,72,1231,1110,2.85
889,3,2,-1,880182943,880182961,18,1110,771,2.5714285714285716
874,5,3,-2,888632098,888632147,49,302,346,3.5128205128205128
874,3,3,0,888632147,888632194,47,346,340,3.7419354838709675
874,3,3,0,888632194,888632275,81,340,321,3.0172413793103448
874,3,4,1,888632275,888632411,136,321,14,4.101694915254237
874,4,4,0,888632411,888632484,73,14,137,3.9545454545454546
874,4,3,-1,888632484,888632585,101,137,676,3.3142857142857145
874,3,3,0,888632585,888632615,30,676,20,3.375
874,3,5,2,888632615,888633311,696,20,357,4.063291139240507
892,5,5,0,886607568,886607641,73,484,318,4.5046728971962615
892,5,5,0,886607641,886607642,1,318,100,4.0162162162162165
892,5,4,-1,886607642,886607679,37,100,393,3.5125
892,4,5,1,886607679,886607710,31,393,195,3.9072164948453607
892,5,5,0,886607710,886607743,33,195,172,4.225225225225225
892,5,5,0,886607743,886607778,35,172,173,4.1441441441441444
892,5,4,-1,886607778,886607844,66,173,480,4.283018867924528
892,4,5,1,886607844,886607878,34,480,127,4.162790697674419
892,5,4,-1,886607878,886607879,1,127,708,3.3157894736842106
892,4,4,0,886607879,886607912,33,708,705,3.7857142857142856
892,4,4,0,886607912,886607957,45,705,56,4.051724137931035
892,4,5,1,886607957,886607958,1,56,1269,4.25
892,5,3,-2,886607958,886608000,42,1269,385,3.6129032258064515
892,3,5,2,886608000,886608022,22,385,12,4.358974358974359
892,5,4,-1,886608022,886608094,72,12,222,3.578125
892,4,3,-1,886608094,886608095,1,222,228,3.7246376811594204
892,3,4,1,886608095,886608135,40,228,202,3.730337078651685
892,4,5,1,886608135,886608136,1,202,150,3.803921568627451
892,5,5,0,886608136,886608185,49,150,423,3.7016129032258065
892,5,4,-1,886608185,886608237,52,423,15,3.725663716814159
892,4,2,-2,886608237,886608238,1,15,143,3.56
892,2,5,3,886608238,886608263,25,143,516,4.055555555555555
892,5,4,-1,886608263,886608296,33,516,238,3.888888888888889
892,4,3,-1,886608296,886608348,52,238,71,3.6575342465753424
892,3,5,2,886608348,886608380,32,71,515,4.202898550724638
892,5,4,-1,886608380,886608423,43,515,194,4.029411764705882
892,4,5,1,886608423,886608473,50,194,192,4.090909090909091
892,5,4,-1,886608473,886608507,34,192,210,3.921259842519685
892,4,4,0,886608507,886608559,52,210,175,3.8354430379746836
892,4,5,1,886608559,886608591,32,175,134,4.174603174603175
892,5,5,0,886608591,886608616,25,134,479,4.25
892,5,4,-1,886608616,886608681,65,479,659,4.027777777777778
892,4,5,1,886608681,886608682,1,659,187,4.215189873417722
892,5,5,0,886608682,886608714,32,187,613,4.1
892,5,5,0,886608714,886608743,29,613,684,3.847826086956522
892,5,4,-1,886608743,886608770,27,684,95,3.8194444444444446
892,4,4,0,886608770,886608771,1,95,526,3.909090909090909
892,4,4,0,886608771,886608802,31,526,237,3.7315436241610738
892,4,3,-1,886608802,886608942,140,237,213,3.943396226415094
892,3,5,2,886608942,886608977,35,213,425,3.7027027027027026
892,5,4,-1,886608977,886609006,29,425,2,3.0851063829787235
892,4,5,1,886609006,886609028,22,2,216,3.8454545454545452
892,5,5,0,886609028,886609029,1,216,157,3.5714285714285716
892,5,3,-2,886609029,886609149,120,157,82,3.6741573033707864
892,3,4,1,886609149,886609180,31,82,380,3.4878048780487805
892,4,4,0,886609180,886609218,38,380,495,3.65
892,4,5,1,886609218,886609263,45,495,87,3.9
892,5,3,-2,886609263,886609264,1,87,401,2.6774193548387095
892,3,4,1,886609264,886609295,31,401,465,3.75
892,4,4,0,886609295,886609330,35,465,151,3.6544117647058822
892,4,4,0,886609330,886609365,35,151,136,3.764705882352941
892,4,5,1,886609365,886609390,25,136,203,3.826923076923077
892,5,2,-3,886609390,886609435,45,203,155,3.0588235294117645
892,2,4,2,886609435,886609469,34,155,578,3.066666666666667
892,4,3,-1,886609469,886609520,51,578,419,3.8208955223880596
892,3,5,2,886609520,886609622,102,419,500,4.285714285714286
892,5,4,-1,886609622,886609792,170,500,1224,2.6666666666666665
892,4,4,0,886609792,886609793,1,1224,230,3.3518518518518516
892,4,4,0,886609793,886609828,35,230,25,3.3185840707964602
892,4,4,0,886609828,886609829,1,25,121,3.521212121212121
892,4,4,0,886609829,886609884,55,121,636,3.4146341463414633
892,4,4,0,886609884,886609939,55,636,72,3.175438596491228
892,4,4,0,886609939,886609977,38,72,470,3.72
892,4,3,-1,886609977,886610011,34,470,229,3.185185185185185
892,3,5,2,886610011,886610048,37,229,69,3.8015873015873014
892,5,5,0,886610048,886610049,1,69,233,3.323529411764706
892,5,2,-3,886610049,886610078,29,233,90,3.0
892,2,4,2,886610078,886610137,59,90,781,3.4166666666666665
892,4,4,0,886610137,886610173,36,781,49,3.3
892,4,4,0,886610173,886610174,1,49,845,3.661290322580645
892,4,3,-1,886610174,886610201,27,845,226,3.378787878787879
892,3,3,0,886610201,886610267,66,226,1454,3.0
892,3,4,1,886610267,886610318,51,1454,566,3.543859649122807
892,4,4,0,886610318,886610451,133,566,274,3.5609756097560976
892,4,4,0,886610451,886610480,29,274,67,3.106382978723404
892,4,3,-1,886610480,886610523,43,67,110,2.25
892,3,3,0,886610523,886610565,42,110,625,3.25
892,3,3,0,886610565,886610566,1,625,1078,2.625
892,3,4,1,886610566,886610626,60,1078,288,3.5214285714285714
892,4,4,0,886610626,886610649,23,288,118,3.2764227642276422
892,4,4,0,886610649,886610682,33,118,27,3.235294117647059
892,4,3,-1,886610682,886610996,314,27,946,3.1153846153846154
892,3,3,0,886610996,886611023,27,946,501,3.289473684210526
892,3,3,0,886611023,886611079,56,501,820,3.0444444444444443
892,3,4,1,886611079,886611161,82,820,117,3.689189189189189
892,4,4,0,886611161,886611162,1,117,68,3.5714285714285716
892,4,4,0,886611162,886611354,192,68,5,3.1481481481481484
890,5,5,0,882402238,882402301,63,479,185,3.9726027397260273
890,5,5,0,882402301,882402478,177,185,514,4.033333333333333
890,5,5,0,882402478,882402518,40,514,515,4.202898550724638
890,5,4,-1,882402518,882402633,115,515,200,3.8157894736842106
890,4,4,0,882402633,882402739,106,200,7,3.76056338028169
890,4,4,0,882402739,882402826,87,7,489,4.076923076923077
890,4,3,-1,882402826,882402949,123,489,1065,3.1578947368421053
890,3,4,1,882402949,882402975,26,1065,1,3.902439024390244
890,4,5,1,882402975,882403045,70,1,136,3.764705882352941
890,5,4,-1,882403045,882403122,77,136,1039,3.9583333333333335
890,4,5,1,882403122,882403299,177,1039,179,3.8823529411764706
890,5,3,-2,882403299,882403345,46,179,153,3.7865168539325844
890,3,4,1,882403345,882403379,34,153,524,4.166666666666667
890,4,4,0,882403379,882403446,67,524,89,3.9615384615384617
890,4,5,1,882403446,882403477,31,89,480,4.283018867924528
890,5,4,-1,882403477,882403587,110,480,434,3.588235294117647
890,4,4,0,882403587,882404093,506,434,324,3.2291666666666665
890,4,5,1,882404093,882404541,448,324,675,3.625
890,5,5,0,882404541,882404571,30,675,671,3.4285714285714284
890,5,3,-2,882404571,882404610,39,671,637,2.888888888888889
890,3,2,-1,882404610,882404652,42,637,667,2.4285714285714284
890,2,2,0,882404652,882404723,71,667,452,2.6129032258064515
890,2,5,3,882404723,882404851,128,452,654,4.119047619047619
890,5,3,-2,882404851,882404879,28,654,636,3.4146341463414633
890,3,3,0,882404879,882404917,38,636,183,3.951219512195122
890,3,3,0,882404917,882404947,30,183,230,3.3518518518518516
890,3,5,2,882404947,882405546,599,230,135,3.7974683544303796
890,5,5,0,882405546,882405586,40,135,427,4.2025316455696204
890,5,5,0,882405586,882405807,221,427,50,4.306532663316583
890,5,4,-1,882405807,882405808,1,50,181,3.98974358974359
890,4,5,1,882405808,882574437,168629,181,435,3.8933333333333335
890,5,3,-2,882574437,882575104,667,435,625,3.25
890,3,4,1,882575104,882575167,63,625,173,4.1441441441441444
890,4,3,-1,882575167,882575209,42,173,237,3.7315436241610738
890,3,2,-1,882575209,882575274,65,237,451,3.207792207792208
890,2,3,1,882575274,882575303,29,451,662,3.4583333333333335
890,3,3,0,882575303,882915818,340515,662,655,3.7857142857142856
890,3,3,0,882915818,882915942,124,655,484,4.116279069767442
890,3,2,-1,882915942,882916276,334,484,186,3.905263157894737
890,2,4,2,882916276,882916356,80,186,215,3.662921348314607
890,4,5,1,882916356,882916460,104,215,496,4.094594594594595
890,5,2,-3,882916460,882916537,77,496,516,4.055555555555555
890,2,5,3,882916537,882916538,1,516,632,3.9523809523809526
890,5,4,-1,882916538,882916588,50,632,214,3.272727272727273
890,4,3,-1,882916588,882916650,62,214,843,2.933333333333333
890,3,5,2,882916650,882916704,54,843,168,4.0476190476190474
890,5,2,-3,882916704,882917026,322,168,660,3.71875
890,2,3,1,882917026,882917152,126,660,737,3.12
893,3,4,1,874827526,874827623,97,288,298,3.779220779220779
893,4,5,1,874827623,874827725,102,298,1,3.902439024390244
893,5,3,-2,874827725,874827789,64,1,294,3.1052631578947367
893,3,5,2,874827789,874827818,29,294,69,3.8015873015873014
893,5,3,-2,874827818,874827960,142,69,259,2.492063492063492
893,3,3,0,874827960,874828163,203,259,1012,3.2916666666666665
893,3,3,0,874828163,874828296,133,1012,264,2.65
893,3,4,1,874828296,874828384,88,264,286,3.442857142857143
893,4,4,0,874828384,874828649,265,286,24,3.3728813559322033
893,4,3,-1,874828649,874828772,123,24,845,3.661290322580645
893,3,2,-1,874828772,874828812,40,845,1245,2.3333333333333335
893,2,4,2,874828812,874828864,52,1245,240,3.0350877192982457
893,4,1,-3,874828864,874828981,117,240,976,1.6666666666666667
893,1,3,2,874828981,874829035,54,976,235,3.106382978723404
893,3,3,0,874829035,874829129,94,235,928,3.142857142857143
893,3,3,0,874829129,874829161,32,928,820,3.0444444444444443
893,3,4,1,874829161,874829230,69,820,597,3.2771084337349397
893,4,2,-2,874829230,874829249,19,597,122,2.282608695652174
893,2,3,1,874829249,874829287,38,122,148,3.2131147540983607
893,3,3,0,874829287,874829355,68,148,819,2.6666666666666665
893,3,4,1,874829355,874829427,72,819,151,3.6544117647058822
893,4,5,1,874829427,874829733,306,151,56,4.051724137931035
893,5,4,-1,874829733,874829753,20,56,11,3.8904109589041096
893,4,5,1,874829753,874829883,130,11,172,4.225225225225225
893,5,3,-2,874829883,874829968,85,172,246,4.0
893,3,4,1,874829968,874830101,133,246,144,3.9545454545454546
893,4,5,1,874830101,874830122,21,144,161,3.5844155844155843
893,5,3,-2,874830122,874830137,15,161,759,2.6
893,3,4,1,874830137,874830313,176,759,121,3.521212121212121
893,4,4,0,874830313,874830314,1,121,96,3.9130434782608696
893,4,3,-1,874830314,874830338,24,96,1218,3.2
893,3,3,0,874830338,874830372,34,1218,849,2.5625
887,1,2,1,881377812,881377854,42,718,100,4.0162162162162165
887,2,1,-1,881377854,881377893,39,100,258,3.7547169811320753
887,1,5,4,881377893,881377933,40,258,1015,5.0
887,5,5,0,881377933,881377972,39,1015,1,3.902439024390244
887,5,4,-1,881377972,881378040,68,1,410,3.0434782608695654
887,4,1,-3,881378040,881378153,113,410,1012,3.2916666666666665
887,1,5,4,881378153,881378251,98,1012,993,3.4838709677419355
887,5,5,0,881378251,881378289,38,993,118,3.2764227642276422
887,5,5,0,881378289,881378439,150,118,1120,3.1
887,5,1,-4,881378439,881378478,39,1120,274,3.5609756097560976
887,1,2,1,881378478,881378537,59,274,25,3.3185840707964602
887,2,5,3,881378537,881378570,33,25,1060,3.235294117647059
887,5,5,0,881378570,881378620,50,1060,455,3.1702127659574466
887,5,4,-1,881378620,881378669,49,455,284,3.1547619047619047
887,4,4,0,881378669,881378773,104,284,1051,3.625
887,4,5,1,881378773,881378896,123,1051,1283,2.9
887,5,4,-1,881378896,881378971,75,1283,409,2.9615384615384617
887,4,4,0,881378971,881378972,1,409,252,2.911392405063291
887,4,3,-1,881378972,881379009,37,252,931,2.2758620689655173
887,3,4,1,881379009,881379094,85,931,225,3.0714285714285716
887,4,4,0,881379094,881379145,51,225,254,2.7419354838709675
887,4,4,0,881379145,881379188,43,254,934,3.0294117647058822
887,4,1,-3,881379188,881379239,51,934,826,2.5555555555555554
887,1,3,2,881379239,881379345,106,826,98,4.240875912408759
887,3,5,2,881379345,881379346,1,98,202,3.730337078651685
887,5,1,-4,881379346,881379449,103,202,183,3.951219512195122
887,1,5,4,881379449,881379522,73,183,28,3.923076923076923
887,5,2,-3,881379522,881379566,44,28,491,3.55
887,2,1,-1,881379566,881379609,43,491,655,3.7857142857142856
887,1,5,4,881379609,881379649,40,655,318,4.5046728971962615
887,5,5,0,881379649,881379718,69,318,427,4.2025316455696204
887,5,5,0,881379718,881379781,63,427,143,3.56
887,5,5,0,881379781,881379988,207,143,432,3.719298245614035
887,5,4,-1,881379988,881380025,37,432,8,3.903225806451613
887,4,5,1,881380025,881380067,42,8,204,3.6744186046511627
887,5,4,-1,881380067,881380139,72,204,164,3.6140350877192984
887,4,4,0,881380139,881380176,37,164,1413,3.75
887,4,4,0,881380176,881380177,1,1413,180,3.9473684210526314
887,4,5,1,881380177,881380335,158,180,87,3.9
887,5,4,-1,881380335,881380403,68,87,96,3.9130434782608696
887,4,4,0,881380403,881380438,35,96,195,3.9072164948453607
887,4,4,0,881380438,881380502,64,195,385,3.6129032258064515
887,4,5,1,881380502,881380539,37,385,99,3.8392857142857144
887,5,1,-4,881380539,881380623,84,99,697,2.7777777777777777
887,1,5,4,881380623,881380654,31,697,692,3.56
887,5,5,0,881380654,881380739,85,692,1540,3.25
887,5,3,-2,881380739,881380773,34,1540,470,3.72
887,3,5,2,881380773,881380813,40,470,720,3.2
887,5,4,-1,881380813,881380883,70,720,443,3.8421052631578947
887,4,4,0,881380883,881380884,1,443,501,3.289473684210526
887,4,4,0,881380884,881381071,187,501,404,3.6578947368421053
887,4,4,0,881381071,881381114,43,404,84,3.0
887,4,5,1,881381114,881381207,93,84,378,3.6904761904761907
887,5,5,0,881381207,881381307,100,378,465,3.75
887,5,4,-1,881381307,881381348,41,465,946,3.1153846153846154
887,4,5,1,881381348,881381382,34,946,673,3.393939393939394
887,5,5,0,881381382,881381425,43,673,755,3.085714285714286
887,5,5,0,881381425,881381503,78,755,38,2.784313725490196
887,5,1,-4,881381503,881381555,52,38,548,2.0
887,1,5,4,881381555,881381610,55,548,1116,3.5714285714285716
887,5,3,-2,881381610,881381679,69,1116,1239,2.25
887,3,5,2,881381679,881381740,61,1239,1035,3.03125
891,4,4,0,883429918,883430128,210,756,531,3.7435897435897436
891,4,5,1,883430128,883489497,59369,531,866,3.3962264150943398
891,5,3,-2,883489497,883489521,24,866,1028,2.857142857142857
891,3,5,2,883489521,883489605,84,1028,476,3.1216216216216215
891,5,3,-2,883489605,883489646,41,476,405,3.25
891,3,3,0,883489646,883489668,22,405,595,2.9166666666666665
891,3,5,2,883489668,883489709,41,595,1278,3.8333333333333335
891,5,4,-1,883489709,883489728,19,1278,717,2.9696969696969697
891,4,3,-1,883489728,883489783,55,717,1040,2.2666666666666666
891,3,3,0,883489783,883489806,23,1040,323,3.0
891,3,5,2,883489806,891638601,8148795,323,126,3.8620689655172415
891,5,5,0,891638601,891638757,156,126,285,4.181818181818182
891,5,3,-2,891638757,891639552,795,285,116,3.6666666666666665
891,3,5,2,891639552,891639737,185,116,924,3.3703703703703702
891,5,5,0,891639737,891639793,56,924,148,3.2131147540983607
891,5,5,0,891639793,891639920,127,148,281,3.2
894,2,4,2,879896109,879896141,32,289,879,3.2291666666666665
894,4,3,-1,879896141,879896200,59,879,299,3.0
894,3,3,0,879896200,879896233,33,299,748,3.1043478260869564
894,3,3,0,879896233,879896267,34,748,322,3.0476190476190474
894,3,3,0,879896267,879896268,1,322,1295,3.0
894,3,3,0,879896268,879896309,41,1295,264,2.65
894,3,4,1,879896309,879896466,157,264,300,3.6861313868613137
894,4,4,0,879896466,879896654,188,300,1251,3.5
894,4,3,-1,879896654,879896673,19,1251,298,3.779220779220779
894,3,3,0,879896673,879896704,31,298,256,3.5
894,3,4,1,879896704,879896756,52,256,303,3.75
894,4,3,-1,879896756,879896815,59,303,935,3.0
894,3,4,1,879896815,879896836,21,935,248,3.746268656716418
894,4,3,-1,879896836,879896872,36,248,249,3.3275862068965516
894,3,3,0,879896872,879896897,25,249,252,2.911392405063291
894,3,4,1,879896897,879896898,1,252,250,3.4698795180722892
894,4,3,-1,879896898,879896949,51,250,1258,2.3333333333333335
894,3,3,0,879896949,879896985,36,1258,1315,3.4444444444444446
894,3,5,2,879896985,879897100,115,1315,190,4.233333333333333
894,5,4,-1,879897100,879897149,49,190,223,4.108695652173913
894,4,5,1,879897149,879897168,19,223,318,4.5046728971962615
894,5,4,-1,879897168,879897198,30,318,134,4.174603174603175
894,4,5,1,879897198,879897235,37,134,1194,4.181818181818182
894,5,3,-2,879897235,879982820,85585,1194,336,2.4
894,3,3,0,879982820,880415855,433035,336,1038,2.6
894,3,3,0,880415855,880415885,30,1038,883,3.5
894,3,3,0,880415885,880415951,66,883,330,2.625
894,3,4,1,880415951,880416008,57,330,50,4.306532663316583
894,4,4,0,880416008,880416039,31,50,9,3.8878504672897196
894,4,3,-1,880416039,880416072,33,9,1007,4.117647058823529
894,3,4,1,880416072,880416136,64,1007,285,4.181818181818182
894,4,3,-1,880416136,880416137,1,285,148,3.2131147540983607
894,3,3,0,880416137,880416176,39,148,475,3.956043956043956
894,3,4,1,880416176,880416177,1,475,713,3.5
894,4,3,-1,880416177,880416219,42,713,117,3.689189189189189
894,3,3,0,880416219,880416220,1,117,284,3.1547619047619047
894,3,4,1,880416220,880416253,33,284,129,3.744186046511628
894,4,2,-2,880416253,880416285,32,129,290,3.108108108108108
894,2,4,2,880416285,880416286,1,290,1,3.902439024390244
894,4,5,1,880416286,880416314,28,1,276,3.6036036036036037
894,5,3,-2,880416314,880416315,1,276,676,3.3142857142857145
894,3,3,0,880416315,880416340,25,676,15,3.725663716814159
894,3,4,1,880416340,880416341,1,15,277,3.6
894,4,4,0,880416341,880416380,39,277,297,4.142857142857143
894,4,4,0,880416380,880416381,1,297,10,3.85
894,4,4,0,880416381,880416419,38,10,278,3.0357142857142856
894,4,4,0,880416419,880416473,54,278,116,3.6666666666666665
894,4,2,-2,880416473,880993335,576862,116,271,3.3134328358208953
894,2,4,2,880993335,880993374,39,271,887,3.5789473684210527
894,4,3,-1,880993374,880993390,16,887,689,3.1538461538461537
894,3,3,0,880993390,880993614,224,689,16,3.411764705882353
894,3,4,1,880993614,880993661,47,16,1048,2.857142857142857
894,4,4,0,880993661,880993662,1,1048,1010,3.611111111111111
894,4,3,-1,880993662,880993709,47,1010,107,3.45
894,3,3,0,880993709,880993730,21,107,472,2.984375
894,3,3,0,880993730,882403414,1409684,472,877,2.619047619047619
894,3,4,1,882403414,882404250,836,877,45,4.130434782608695
894,4,5,1,882404250,882404278,28,45,923,4.142857142857143
894,5,4,-1,882404278,882404306,28,923,166,4.0
894,4,4,0,882404306,882404329,23,166,170,4.242424242424242
894,4,4,0,882404329,882404397,68,170,1073,3.6315789473684212
894,4,5,1,882404397,882404430,33,1073,639,4.083333333333333
894,5,4,-1,882404430,882404484,54,639,113,4.25
894,4,4,0,882404484,882404507,23,113,52,3.727272727272727
894,4,3,-1,882404507,882404536,29,52,1404,3.875
894,3,5,2,882404536,882404572,36,1404,960,3.0
894,5,3,-2,882404572,882404641,69,960,1403,3.0
894,3,3,0,882404641,882404642,1,1403,1462,3.0
894,3,4,1,882404642,882404669,27,1462,698,3.3333333333333335
894,4,4,0,882404669,882404768,99,698,702,2.764705882352941
894,4,4,0,882404768,883518875,1114107,702,750,4.027777777777778
894,4,2,-2,883518875,883518895,20,750,343,3.0
894,2,3,1,883518895,883518949,54,343,312,3.0
894,3,4,1,883518949,884036815,517866,312,345,3.4782608695652173
894,4,3,-1,884036815,885427971,1391156,345,751,3.3896103896103895
894,3,4,1,885427971,885428012,41,751,315,4.15
894,4,3,-1,885428012,885428159,147,315,1281,3.0
894,3,4,1,885428159,885428233,74,1281,221,3.6923076923076925
894,4,3,-1,885428233,885428261,28,221,125,3.5555555555555554
894,3,3,0,885428261,887044109,1615848,125,905,3.357142857142857
894,3,2,-1,887044109,887044250,141,905,885,2.3333333333333335
894,2,3,1,887044250,888280083,1235833,885,752,3.6666666666666665
894,3,4,1,888280083,888280105,22,752,316,4.285714285714286
896,2,5,3,887157234,887157258,24,302,258,3.7547169811320753
896,5,3,-2,887157258,887157322,64,258,872,3.0
896,3,1,-2,887157322,887157732,410,872,325,2.625
896,1,4,3,887157732,887157924,192,325,182,3.842857142857143
896,4,4,0,887157924,887157925,1,182,234,3.7674418604651163
896,4,3,-1,887157925,887157978,53,234,55,4.051282051282051
896,3,3,0,887157978,887158029,51,55,515,4.202898550724638
896,3,5,2,887158029,887158164,135,515,525,4.0
896,5,3,-2,887158164,887158185,21,525,480,4.283018867924528
896,3,5,2,887158185,887158265,80,480,588,3.8358208955223883
896,5,4,-1,887158265,887158266,1,588,9,3.8878504672897196
896,4,4,0,887158266,887158295,29,9,87,3.9
896,4,4,0,887158295,887158332,37,87,210,3.921259842519685
896,4,4,0,887158332,887158333,1,210,144,3.9545454545454546
896,4,3,-1,887158333,887158359,26,144,76,3.1875
896,3,4,1,887158359,887158384,25,76,603,4.315789473684211
896,4,2,-2,887158384,887158555,171,603,282,3.610526315789474
896,2,3,1,887158555,887158579,24,282,132,3.929411764705882
896,3,4,1,887158579,887158604,25,132,191,4.168674698795181
896,4,3,-1,887158604,887158635,31,191,836,4.142857142857143
896,3,4,1,887158635,887158636,1,836,198,4.04
896,4,5,1,887158636,887158660,24,198,180,3.9473684210526314
896,5,5,0,887158660,887158683,23,180,173,4.1441441441441444
896,5,3,-2,887158683,887158713,30,173,479,4.25
896,3,5,2,887158713,887158714,1,479,237,3.7315436241610738
896,5,4,-1,887158714,887158738,24,237,168,4.0476190476190474
896,4,2,-2,887158738,887158739,1,168,39,3.107142857142857
896,2,5,3,887158739,887158829,90,39,181,3.98974358974359
896,5,3,-2,887158829,887158830,1,181,31,3.642857142857143
896,3,3,0,887158830,887158866,36,31,709,4.171428571428572
896,3,3,0,887158866,887158900,34,709,201,3.75
896,3,4,1,887158900,887158926,26,201,64,4.373737373737374
896,4,5,1,887158926,887158927,1,64,71,3.6575342465753424
896,5,4,-1,887158927,887158958,31,71,651,3.8627450980392157
896,4,4,0,887158958,887158959,1,651,684,3.847826086956522
896,4,3,-1,887158959,887159011,52,684,188,3.625
896,3,4,1,887159011,887159012,1,188,952,3.3529411764705883
896,4,3,-1,887159012,887159068,56,952,82,3.6741573033707864
896,3,4,1,887159068,887159069,1,82,317,3.774193548387097
896,4,4,0,887159069,887159109,40,317,222,3.578125
896,4,2,-2,887159109,887159110,1,222,425,3.7027027027027026
896,2,4,2,887159110,887159145,35,425,7,3.76056338028169
896,4,3,-1,887159145,887159146,1,7,1098,3.533333333333333
896,3,3,0,887159146,887159172,26,1098,423,3.7016129032258065
896,3,4,1,887159172,887159173,1,423,402,3.3076923076923075
896,4,2,-2,887159173,887159211,38,402,19,3.9615384615384617
896,2,3,1,887159211,887159234,23,19,518,3.5833333333333335
896,3,2,-1,887159234,887159261,27,518,632,3.9523809523809526
896,2,5,3,887159261,887159262,1,632,89,3.9615384615384617
896,5,4,-1,887159262,887159302,40,89,484,4.116279069767442
896,4,4,0,887159302,887159321,19,484,128,3.45
896,4,5,1,887159321,887159343,22,128,8,3.903225806451613
896,5,4,-1,887159343,887159344,1,8,24,3.3728813559322033
896,4,3,-1,887159344,887159368,24,24,73,3.588235294117647
896,3,2,-1,887159368,887159369,1,73,91,3.6
896,2,2,0,887159369,887159426,57,91,596,3.180327868852459
896,2,1,-1,887159426,887159464,38,596,742,3.5555555555555554
896,1,2,1,887159464,887159502,38,742,133,3.7777777777777777
896,2,2,0,887159502,887159531,29,133,470,3.72
896,2,5,3,887159531,887159554,23,470,83,4.204081632653061
896,5,4,-1,887159554,887159555,1,83,157,3.5714285714285716
896,4,3,-1,887159555,887159578,23,157,184,3.393939393939394
896,3,2,-1,887159578,887159630,52,184,713,3.5
896,2,5,3,887159630,887159658,28,713,216,3.8454545454545452
896,5,5,0,887159658,887159674,16,216,489,4.076923076923077
896,5,2,-3,887159674,887159723,49,489,371,3.0
896,2,2,0,887159723,887159805,82,371,379,3.35
896,2,4,2,887159805,887159854,49,379,597,3.2771084337349397
896,4,5,1,887159854,887159872,18,597,660,3.71875
896,5,3,-2,887159872,887159895,23,660,715,3.257142857142857
896,3,3,0,887159895,887159950,55,715,1134,2.888888888888889
896,3,2,-1,887159950,887159951,1,1134,51,3.5277777777777777
896,2,3,1,887159951,887159972,21,51,471,3.5714285714285716
896,3,3,0,887159972,887159973,1,471,774,3.0
896,3,3,0,887159973,887160000,27,774,2,3.0851063829787235
896,3,3,0,887160000,887160040,40,2,1119,3.5185185185185186
896,3,2,-1,887160040,887160041,1,1119,637,2.888888888888889
896,2,3,1,887160041,887160070,29,637,101,3.4827586206896552
896,3,4,1,887160070,887160086,16,101,70,3.5833333333333335
896,4,2,-2,887160086,887160165,79,70,1267,2.909090909090909
896,2,2,0,887160165,887160187,22,1267,1248,3.0
896,2,4,2,887160187,887160209,22,1248,942,3.4545454545454546
896,4,3,-1,887160209,887160247,38,942,160,3.4
896,3,2,-1,887160247,887160270,23,160,405,3.25
896,2,1,-1,887160270,887160296,26,405,92,3.7142857142857144
896,1,3,2,887160296,887160339,43,92,1208,2.6666666666666665
896,3,2,-1,887160339,887160399,60,1208,1351,2.5
896,2,4,2,887160399,887160426,27,1351,385,3.6129032258064515
896,4,3,-1,887160426,887160427,1,385,232,3.0789473684210527
896,3,2,-1,887160427,887160446,19,232,674,2.6875
896,2,4,2,887160446,887160465,19,674,721,3.4583333333333335
896,4,3,-1,887160465,887160500,35,721,219,2.735294117647059
896,3,3,0,887160500,887160529,29,219,662,3.4583333333333335
896,3,2,-1,887160529,887160582,53,662,212,3.230769230769231
896,2,2,0,887160582,887160583,1,212,1046,3.3529411764705883
896,2,2,0,887160583,887160606,23,1046,148,3.2131147540983607
896,2,2,0,887160606,887160631,25,148,1423,2.25
896,2,3,1,887160631,887160653,22,1423,616,3.1052631578947367
896,3,3,0,887160653,887160702,49,616,591,3.7169811320754715
896,3,2,-1,887160702,887160750,48,591,46,3.6666666666666665
896,2,3,1,887160750,887160795,45,46,291,3.2
896,3,2,-1,887160795,887160842,47,291,411,2.911764705882353
896,2,2,0,887160842,887160860,18,411,384,2.7941176470588234
896,2,2,0,887160860,887160916,56,384,29,2.5714285714285716
896,2,2,0,887160916,887160938,22,29,80,2.967741935483871
896,2,2,0,887160938,887160958,20,80,1284,2.5454545454545454
896,2,2,0,887160958,887160983,25,1284,472,2.984375
896,2,1,-1,887160983,887161033,50,472,1220,2.9166666666666665
896,1,1,0,887161033,887161151,118,1220,399,3.317073170731707
896,1,2,1,887161151,887161172,21,399,802,3.076923076923077
896,2,2,0,887161172,887161198,26,802,217,3.1538461538461537
896,2,2,0,887161198,887161218,20,217,672,2.7222222222222223
896,2,2,0,887161218,887161393,175,672,1222,2.6363636363636362
896,2,1,-1,887161393,887161413,20,1222,145,2.3636363636363638
896,1,3,2,887161413,887161448,35,145,800,3.2222222222222223
896,3,2,-1,887161448,887161488,40,800,62,3.048780487804878
896,2,4,2,887161488,887161518,30,62,1303,2.857142857142857
896,4,1,-3,887161518,887161541,23,1303,824,2.590909090909091
896,1,2,1,887161541,887161564,23,824,801,2.2
896,2,5,3,887161564,887161710,146,801,174,4.253521126760563
896,5,4,-1,887161710,887161728,18,174,230,3.3518518518518516
896,4,4,0,887161728,887235105,73377,230,257,3.7154471544715446
896,4,3,-1,887235105,887235144,39,257,250,3.4698795180722892
896,3,4,1,887235144,887235249,105,250,248,3.746268656716418
896,4,4,0,887235249,887235265,16,248,245,3.056179775280899
896,4,5,1,887235265,887235643,378,245,327,3.5076923076923077
896,5,4,-1,887235643,887235664,21,327,880,2.8421052631578947
896,4,1,-3,887235664,887235690,26,880,343,3.0
896,1,1,0,887235690,887235709,19,343,299,3.0
896,1,1,0,887235709,887235749,40,299,358,2.6551724137931036
896,1,2,1,887235749,887235769,20,358,887,3.5789473684210527
896,2,3,1,887235769,887235788,19,887,288,3.5214285714285714
897,4,4,0,879988868,879990396,1528,323,204,3.6744186046511627
897,4,3,-1,879990396,879990430,34,204,497,3.35
897,3,5,2,879990430,879990465,35,497,177,3.875
897,5,5,0,879990465,879990492,27,177,176,3.967032967032967
897,5,5,0,879990492,879990556,64,176,201,3.75
897,5,3,-2,879990556,879990586,30,201,95,3.8194444444444446
897,3,3,0,879990586,879990587,1,95,651,3.8627450980392157
897,3,3,0,879990587,879990744,157,651,8,3.903225806451613
897,3,4,1,879990744,879990779,35,8,238,3.888888888888889
897,4,4,0,879990779,879990813,34,238,203,3.826923076923077
897,4,3,-1,879990813,879990843,30,203,135,3.7974683544303796
897,3,5,2,879990843,879990877,34,135,521,3.787878787878788
897,5,3,-2,879990877,879990923,46,521,550,3.272727272727273
897,3,5,2,879990923,879991007,84,550,180,3.9473684210526314
897,5,3,-2,879991007,879991069,62,180,179,3.8823529411764706
897,3,2,-1,879991069,879991226,157,179,708,3.3157894736842106
897,2,3,1,879991226,879991258,32,708,196,3.9404761904761907
897,3,3,0,879991258,879991341,83,196,168,4.0476190476190474
897,3,5,2,879991341,879991434,93,168,200,3.8157894736842106
897,5,4,-1,879991434,879991524,90,200,506,3.566666666666667
897,4,5,1,879991524,879991566,42,506,71,3.6575342465753424
897,5,4,-1,879991566,879991607,41,71,230,3.3518518518518516
897,4,4,0,879991607,879991630,23,230,660,3.71875
897,4,5,1,879991630,879991666,36,660,443,3.8421052631578947
897,5,5,0,879991666,879991729,63,443,234,3.7674418604651163
897,5,3,-2,879991729,879991921,192,234,483,4.475609756097561
897,3,4,1,879991921,879991933,12,483,1531,3.5
897,4,2,-2,879991933,879991976,43,1531,566,3.543859649122807
897,2,3,1,879991976,879992004,28,566,649,3.625
897,3,5,2,879992004,879992030,26,649,465,3.75
897,5,3,-2,879992030,879992190,160,465,227,3.169811320754717
897,3,5,2,879992190,879992216,26,227,568,3.5853658536585367
897,5,3,-2,879992216,879993164,948,568,273,3.5238095238095237
897,3,3,0,879993164,879993210,46,273,117,3.689189189189189
897,3,5,2,879993210,879993275,65,117,118,3.2764227642276422
897,5,5,0,879993275,879993309,34,118,161,3.5844155844155843
897,5,3,-2,879993309,879993314,5,161,742,3.5555555555555554
897,3,5,2,879993314,879993376,62,742,121,3.521212121212121
897,5,3,-2,879993376,879993404,28,121,763,3.347826086956522
897,3,4,1,879993404,879993457,53,763,290,3.108108108108108
897,4,4,0,879993457,879993489,32,290,546,2.9789473684210526
897,4,5,1,879993489,879993519,30,546,151,3.6544117647058822
897,5,4,-1,879993519,879993553,34,151,974,3.125
897,4,3,-1,879993553,879993577,24,974,406,2.5294117647058822
897,3,5,2,879993577,879993609,32,406,760,2.35
897,5,3,-2,879993609,879993621,12,760,410,3.0434782608695654
897,3,3,0,879993621,879993644,23,410,473,2.9166666666666665
897,3,4,1,879993644,879993674,30,473,926,2.7857142857142856
897,4,4,0,879993674,879993713,39,926,1033,3.0
897,4,3,-1,879993713,879993772,59,1033,455,3.1702127659574466
897,3,5,2,879993772,879993797,25,455,411,2.911764705882353
897,5,4,-1,879993797,879993823,26,411,240,3.0350877192982457
897,4,3,-1,879993823,879993886,63,240,120,2.3421052631578947
897,3,3,0,879993886,879993887,1,120,840,3.090909090909091
897,3,1,-2,879993887,879993912,25,840,717,2.9696969696969697
901,3,4,1,877125532,877125575,43,294,322,3.0476190476190474
901,4,4,0,877125575,877125716,141,322,988,2.5555555555555554
901,4,4,0,877125716,877126576,860,988,50,4.306532663316583
901,4,4,0,877126576,877126648,72,50,222,3.578125
901,4,5,1,877126648,877126743,95,222,1620,3.6666666666666665
901,5,3,-2,877126743,877126757,14,1620,237,3.7315436241610738
901,3,4,1,877126757,877126902,145,237,929,2.8421052631578947
901,4,3,-1,877126902,877126935,33,929,287,3.4516129032258065
901,3,3,0,877126935,877126963,28,287,235,3.106382978723404
901,3,4,1,877126963,877127128,165,235,181,3.98974358974359
901,4,4,0,877127128,877127219,91,181,121,3.521212121212121
901,4,3,-1,877127219,877127250,31,121,252,2.911392405063291
901,3,5,2,877127250,877129870,2620,252,1,3.902439024390244
901,5,3,-2,877129870,877129911,41,1,409,2.9615384615384617
901,3,5,2,877129911,877130439,528,409,15,3.725663716814159
901,5,5,0,877130439,877130473,34,15,1643,5.0
901,5,5,0,877130473,877130999,526,1643,96,3.9130434782608696
901,5,5,0,877130999,877131045,46,96,568,3.5853658536585367
901,5,2,-3,877131045,877131086,41,568,403,3.298507462686567
901,2,3,1,877131086,877131087,1,403,38,2.784313725490196
901,3,5,2,877131087,877131118,31,38,195,3.9072164948453607
901,5,2,-3,877131118,877131147,29,195,636,3.4146341463414633
901,2,4,2,877131147,877131205,58,636,229,3.185185185185185
901,4,5,1,877131205,877131307,102,229,204,3.6744186046511627
901,5,4,-1,877131307,877131342,35,204,211,3.958904109589041
901,4,3,-1,877131342,877131391,49,211,1047,2.6923076923076925
901,3,5,2,877131391,877131416,25,1047,73,3.588235294117647
901,5,5,0,877131416,877131443,27,73,1041,3.3333333333333335
901,5,3,-2,877131443,877131500,57,1041,949,3.392857142857143
901,3,5,2,877131500,877131624,124,949,28,3.923076923076923
901,5,4,-1,877131624,877131654,30,28,71,3.6575342465753424
901,4,4,0,877131654,877131685,31,71,95,3.8194444444444446
901,4,5,1,877131685,877131738,53,95,393,3.5125
901,5,4,-1,877131738,877131739,1,393,142,3.1481481481481484
901,4,5,1,877131739,877131763,24,142,419,3.8208955223880596
901,5,4,-1,877131763,877131793,30,419,623,3.0454545454545454
901,4,4,0,877131793,877131990,197,623,498,4.290909090909091
901,4,3,-1,877131990,877132015,25,498,447,3.46875
901,3,5,2,877132015,877132065,50,447,12,4.358974358974359
901,5,5,0,877132065,877132346,281,12,69,3.8015873015873014
901,5,4,-1,877132346,877132400,54,69,523,4.159090909090909
901,4,4,0,877132400,877132604,204,523,451,3.207792207792208
901,4,4,0,877132604,877132632,28,451,662,3.4583333333333335
901,4,5,1,877132632,877132671,39,662,739,3.391304347826087
901,5,3,-2,877132671,877287910,155239,739,443,3.8421052631578947
901,3,4,1,877287910,877288179,269,443,140,3.238095238095238
901,4,4,0,877288179,877288977,798,140,509,3.7058823529411766
901,4,2,-2,877288977,877289290,313,509,180,3.9473684210526314
901,2,5,3,877289290,877289381,91,180,476,3.1216216216216215
901,5,5,0,877289381,877289441,60,476,864,3.2142857142857144
899,4,3,-1,884119830,884119877,47,742,181,3.98974358974359
899,3,3,0,884119877,884119954,77,181,685,3.2666666666666666
899,3,5,2,884119954,884119973,19,685,258,3.7547169811320753
899,5,4,-1,884119973,884120007,34,258,471,3.5714285714285716
899,4,5,1,884120007,884120077,70,471,740,3.423076923076923
899,5,2,-3,884120077,884120105,28,740,250,3.4698795180722892
899,2,2,0,884120105,884120106,1,250,147,3.3142857142857145
899,2,3,1,884120106,884120149,43,147,1016,3.559322033898305
899,3,5,2,884120149,884120164,15,1016,121,3.521212121212121
899,5,3,-2,884120164,884120185,21,121,125,3.5555555555555554
899,3,4,1,884120185,884120232,47,125,748,3.1043478260869564
899,4,3,-1,884120232,884120249,17,748,25,3.3185840707964602
899,3,2,-1,884120249,884120270,21,25,597,3.2771084337349397
899,2,2,0,884120270,884120317,47,597,546,2.9789473684210526
899,2,4,2,884120317,884120724,407,546,751,3.3896103896103895
899,4,5,1,884120724,884121009,285,751,694,4.277777777777778
899,5,4,-1,884121009,884121051,42,694,190,4.233333333333333
899,4,4,0,884121051,884121089,38,190,172,4.225225225225225
899,4,5,1,884121089,884121125,36,172,174,4.253521126760563
899,5,3,-2,884121125,884121173,48,174,144,3.9545454545454546
899,3,4,1,884121173,884121214,41,144,423,3.7016129032258065
899,4,2,-2,884121214,884121267,53,423,179,3.8823529411764706
899,2,3,1,884121267,884121308,41,179,180,3.9473684210526314
899,3,4,1,884121308,884121342,34,180,463,3.6818181818181817
899,4,5,1,884121342,884121379,37,463,496,4.094594594594595
899,5,2,-3,884121379,884121424,45,496,238,3.888888888888889
899,2,4,2,884121424,884121512,88,238,197,4.112676056338028
899,4,4,0,884121512,884121513,1,197,203,3.826923076923077
899,4,4,0,884121513,884121572,59,203,8,3.903225806451613
899,4,3,-1,884121572,884121612,40,8,474,4.172413793103448
899,3,4,1,884121612,884121647,35,474,89,3.9615384615384617
899,4,4,0,884121647,884121683,36,89,204,3.6744186046511627
899,4,4,0,884121683,884121767,84,204,186,3.905263157894737
899,4,4,0,884121767,884121799,32,186,168,4.0476190476190474
899,4,4,0,884121799,884121884,85,168,195,3.9072164948453607
899,4,5,1,884121884,884121885,1,195,216,3.8454545454545452
899,5,2,-3,884121885,884121911,26,216,658,3.393939393939394
899,2,3,1,884121911,884121946,35,658,239,3.423076923076923
899,3,4,1,884121946,884122016,70,239,470,3.72
899,4,4,0,884122016,884122044,28,470,214,3.272727272727273
899,4,2,-2,884122044,884122087,43,214,356,3.2
899,2,3,1,884122087,884122155,68,356,588,3.8358208955223883
899,3,4,1,884122155,884122178,23,588,433,3.8035714285714284
899,4,2,-2,884122178,884122228,50,433,414,3.3076923076923075
899,2,2,0,884122228,884122254,26,414,229,3.185185185185185
899,2,5,3,884122254,884122278,24,229,79,3.956989247311828
899,5,4,-1,884122278,884122279,1,79,291,3.2
899,4,1,-3,884122279,884122387,108,291,51,3.5277777777777777
899,1,4,3,884122387,884122419,32,51,202,3.730337078651685
899,4,5,1,884122419,884122420,1,202,154,3.6031746031746033
899,5,3,-2,884122420,884122501,81,154,684,3.847826086956522
899,3,3,0,884122501,884122535,34,684,566,3.543859649122807
899,3,3,0,884122535,884122563,28,566,2,3.0851063829787235
899,3,4,1,884122563,884122564,1,2,660,3.71875
899,4,3,-1,884122564,884122619,55,660,710,3.41025641025641
899,3,1,-2,884122619,884122645,26,710,431,3.422222222222222
899,1,4,3,884122645,884122674,29,431,234,3.7674418604651163
899,4,4,0,884122674,884122698,24,234,213,3.943396226415094
899,4,5,1,884122698,884122776,78,213,724,3.64
899,5,3,-2,884122776,884122844,68,724,403,3.298507462686567
899,3,2,-1,884122844,884122845,1,403,254,2.7419354838709675
903,5,3,-2,891031144,891031178,34,127,147,3.3142857142857145
903,3,5,2,891031178,891031203,25,147,100,4.0162162162162165
903,5,4,-1,891031203,891031226,23,100,293,3.630434782608696
903,4,4,0,891031226,891031259,33,293,25,3.3185840707964602
903,4,4,0,891031259,891031309,50,25,181,3.98974358974359
903,4,5,1,891031309,891031329,20,181,50,4.306532663316583
903,5,4,-1,891031329,891031384,55,50,282,3.610526315789474
903,4,2,-2,891031384,891031412,28,282,1067,3.533333333333333
903,2,1,-1,891031412,891031450,38,1067,845,3.661290322580645
903,1,2,1,891031450,891031470,20,845,544,3.185185185185185
903,2,3,1,891031470,891031505,35,544,1008,3.5
903,3,5,2,891031505,891031632,127,1008,13,3.5454545454545454
903,5,4,-1,891031632,891031677,45,13,410,3.0434782608695654
903,4,4,0,891031677,891031678,1,410,405,3.25
903,4,4,0,891031678,891031697,19,405,324,3.2291666666666665
903,4,2,-2,891031697,891031714,17,324,595,2.9166666666666665
903,2,3,1,891031714,891031715,1,595,252,2.911392405063291
903,3,4,1,891031715,891031730,15,252,240,3.0350877192982457
903,4,2,-2,891031730,891031749,19,240,928,3.142857142857143
903,2,4,2,891031749,891031768,19,928,820,3.0444444444444443
903,4,3,-1,891031768,891031794,26,820,105,2.6176470588235294
903,3,1,-2,891031794,891031810,16,105,977,2.473684210526316
903,1,3,2,891031810,891031833,23,977,824,2.590909090909091
903,3,4,1,891031833,891031864,31,824,1381,3.75
903,4,4,0,891031864,891031906,42,1381,1048,2.857142857142857
903,4,3,-1,891031906,891031949,43,1048,1132,2.588235294117647
903,3,2,-1,891031949,891032038,89,1132,931,2.2758620689655173
903,2,2,0,891032038,891032077,39,931,412,2.272727272727273
903,2,2,0,891032077,891032101,24,412,120,2.3421052631578947
903,2,4,2,891032101,891032760,659,120,175,3.8354430379746836
903,4,5,1,891032760,891032793,33,175,651,3.8627450980392157
903,5,3,-2,891032793,891032842,49,651,1073,3.6315789473684212
903,3,5,2,891032842,891032872,30,1073,191,4.168674698795181
903,5,4,-1,891032872,891032911,39,191,520,4.136363636363637
903,4,4,0,891032911,891032981,70,520,87,3.9
903,4,5,1,891032981,891033005,24,87,91,3.6
903,5,4,-1,891033005,891033048,43,91,60,4.105263157894737
903,4,4,0,891033048,891033070,22,60,79,3.956989247311828
903,4,4,0,891033070,891033123,53,79,46,3.6666666666666665
903,4,4,0,891033123,891033278,155,46,529,4.142857142857143
903,4,5,1,891033278,891033354,76,529,223,4.108695652173913
903,5,4,-1,891033354,891033380,26,223,509,3.7058823529411766
903,4,4,0,891033380,891033430,50,509,157,3.5714285714285716
903,4,5,1,891033430,891033502,72,157,238,3.888888888888889
903,5,5,0,891033502,891033522,20,238,47,3.5869565217391304
903,5,5,0,891033522,891033541,19,47,23,3.9047619047619047
903,5,3,-2,891033541,891033564,23,23,582,3.7457627118644066
903,3,5,2,891033564,891033585,21,582,180,3.9473684210526314
903,5,5,0,891033585,891033606,21,180,523,4.159090909090909
903,5,5,0,891033606,891033628,22,523,192,4.090909090909091
903,5,5,0,891033628,891033754,126,192,187,4.215189873417722
903,5,5,0,891033754,891033755,1,187,443,3.8421052631578947
903,5,4,-1,891033755,891033828,73,443,1101,3.793103448275862
903,4,4,0,891033828,891380461,346633,1101,302,4.133333333333334
903,4,3,-1,891380461,891380488,27,302,421,3.462962962962963
903,3,4,1,891380488,891380524,36,421,721,3.4583333333333335
903,4,3,-1,891380524,891466551,86027,721,52,3.727272727272727
904,2,5,3,879735136,879735177,41,328,289,2.988888888888889
904,5,4,-1,879735177,879735316,139,289,9,3.8878504672897196
904,4,3,-1,879735316,879735362,46,9,181,3.98974358974359
904,3,5,2,879735362,879735461,99,181,275,4.087912087912088
904,5,3,-2,879735461,879735499,38,275,709,4.171428571428572
904,3,5,2,879735499,879735551,52,709,237,3.7315436241610738
904,5,4,-1,879735551,879735584,33,237,451,3.207792207792208
904,4,4,0,879735584,879735616,32,451,724,3.64
904,4,2,-2,879735616,879735617,1,724,762,3.3962264150943398
904,2,4,2,879735617,879735678,61,762,739,3.391304347826087
904,4,4,0,879735678,879735679,1,739,402,3.3076923076923075
904,4,2,-2,879735679,879735710,31,402,1041,3.3333333333333335
904,2,2,0,879735710,879735731,21,1041,90,3.0
904,2,5,3,879735731,879735772,41,90,421,3.462962962962963
904,5,4,-1,879735772,879735843,71,421,603,4.315789473684211
907,2,5,3,880158425,880158448,23,340,326,3.262295081967213
907,5,5,0,880158448,880158476,28,326,288,3.5214285714285714
907,5,4,-1,880158476,880158502,26,288,294,3.1052631578947367
907,4,5,1,880158502,880158537,35,294,748,3.1043478260869564
907,5,4,-1,880158537,880158556,19,748,245,3.056179775280899
907,4,4,0,880158556,880158692,136,245,50,4.306532663316583
907,4,5,1,880158692,880158712,20,50,1,3.902439024390244
907,5,5,0,880158712,880158730,18,1,19,3.9615384615384617
907,5,5,0,880158730,880158770,40,19,813,4.055555555555555
907,5,5,0,880158770,880158794,24,813,277,3.6
907,5,5,0,880158794,880158861,67,277,15,3.725663716814159
907,5,5,0,880158861,880158883,22,15,111,3.5106382978723403
907,5,4,-1,880158883,880158913,30,111,287,3.4516129032258065
907,4,5,1,880158913,880158939,26,287,1016,3.559322033898305
907,5,5,0,880158939,880158960,21,1016,685,3.2666666666666666
907,5,5,0,880158960,880158986,26,685,274,3.5609756097560976
907,5,4,-1,880158986,880159015,29,274,596,3.180327868852459
907,4,5,1,880159015,880159016,1,596,278,3.0357142857142856
907,5,2,-3,880159016,880159038,22,278,619,3.4782608695652173
907,2,5,3,880159038,880159059,21,619,237,3.7315436241610738
907,5,5,0,880159059,880159081,22,237,696,3.138888888888889
907,5,5,0,880159081,880159113,32,696,25,3.3185840707964602
907,5,4,-1,880159113,880159134,21,25,476,3.1216216216216215
907,4,4,0,880159134,880159151,17,476,409,2.9615384615384617
907,4,5,1,880159151,880159172,21,409,117,3.689189189189189
907,5,4,-1,880159172,880159198,26,117,756,2.6885245901639343
907,4,5,1,880159198,880159240,42,756,924,3.3703703703703702
907,5,4,-1,880159240,880159259,19,924,125,3.5555555555555554
907,4,4,0,880159259,880159360,101,125,118,3.2764227642276422
907,4,5,1,880159360,880159361,1,118,828,3.0
907,5,5,0,880159361,880159381,20,828,1244,2.7777777777777777
907,5,3,-2,880159381,880159404,23,1244,825,2.914285714285714
907,3,4,1,880159404,880159442,38,825,123,3.297872340425532
907,4,5,1,880159442,880159473,31,123,978,2.357142857142857
907,5,5,0,880159473,880159496,23,978,762,3.3962264150943398
907,5,4,-1,880159496,880159512,16,762,1326,3.6666666666666665
907,4,5,1,880159512,880159530,18,1326,1051,3.625
907,5,4,-1,880159530,880159562,32,1051,120,2.3421052631578947
907,4,3,-1,880159562,880159598,36,120,1054,2.5454545454545454
907,3,5,2,880159598,880159619,21,1054,699,3.736842105263158
907,5,5,0,880159619,880159642,23,699,724,3.64
907,5,4,-1,880159642,880159666,24,724,496,4.094594594594595
907,4,3,-1,880159666,880159688,22,496,8,3.903225806451613
907,3,4,1,880159688,880159778,90,8,686,3.9
907,4,4,0,880159778,880159801,23,686,185,3.9726027397260273
907,4,5,1,880159801,880159821,20,185,427,4.2025316455696204
907,5,5,0,880159821,880159844,23,427,182,3.842857142857143
907,5,5,0,880159844,880159911,67,182,71,3.6575342465753424
907,5,4,-1,880159911,880159957,46,71,42,3.893617021276596
907,4,5,1,880159957,880160009,52,42,393,3.5125
907,5,5,0,880160009,880160056,47,393,553,3.5
907,5,5,0,880160056,880160080,24,553,1221,3.4285714285714284
907,5,4,-1,880160080,880160140,60,1221,173,4.1441441441441444
907,4,5,1,880160140,880160162,22,173,198,4.04
907,5,4,-1,880160162,885860288,5700126,198,268,3.9838709677419355
907,4,5,1,885860288,885860416,128,268,312,3.0
907,5,2,-3,885860416,885860511,95,312,260,2.4716981132075473
907,2,5,3,885860511,885862211,1700,260,1157,3.142857142857143
907,5,5,0,885862211,885862428,217,1157,129,3.744186046511628
905,4,3,-1,884982870,884983034,164,313,326,3.262295081967213
905,3,3,0,884983034,884983273,239,326,245,3.056179775280899
905,3,3,0,884983273,884983396,123,245,873,2.7586206896551726
905,3,4,1,884983396,884983556,160,873,300,3.6861313868613137
905,4,3,-1,884983556,884983627,71,300,879,3.2291666666666665
905,3,3,0,884983627,884983889,262,879,282,3.610526315789474
905,3,4,1,884983889,884983951,62,282,591,3.7169811320754715
905,4,4,0,884983951,884983952,1,591,471,3.5714285714285716
905,4,4,0,884983952,884984009,57,471,129,3.744186046511628
905,4,4,0,884984009,884984066,57,129,508,3.6923076923076925
905,4,3,-1,884984066,884984148,82,508,137,3.9545454545454546
905,3,1,-2,884984148,884984149,1,137,717,2.9696969696969697
905,1,2,1,884984149,884984329,180,717,1051,3.625
905,2,3,1,884984329,884984382,53,1051,1011,3.1
902,2,3,1,879463212,879463310,98,294,326,3.262295081967213
902,3,4,1,879463310,879463485,175,326,879,3.2291666666666665
902,4,3,-1,879463485,879463582,97,879,307,3.6031746031746033
902,3,3,0,879463582,879464783,1201,307,181,3.98974358974359
902,3,3,0,879464783,879464964,181,181,257,3.7154471544715446
902,3,2,-1,879464964,879465016,52,257,298,3.779220779220779
902,2,2,0,879465016,879465128,112,298,295,3.769230769230769
902,2,2,0,879465128,879465336,208,295,989,3.142857142857143
902,2,4,2,879465336,879465448,112,989,483,4.475609756097561
902,4,3,-1,879465448,879465523,75,483,134,4.174603174603175
902,3,4,1,879465523,879465583,60,134,479,4.25
902,4,4,0,879465583,879465894,311,479,275,4.087912087912088
902,4,5,1,879465894,879465952,58,275,79,3.956989247311828
898,3,2,-1,888294407,888294408,1,258,286,3.442857142857143
898,2,3,1,888294408,888294441,33,286,539,2.6666666666666665
898,3,3,0,888294441,888294485,44,539,347,3.59375
898,3,4,1,888294485,888294567,82,347,302,4.133333333333334
898,4,4,0,888294567,888294621,54,302,324,3.2291666666666665
898,4,1,-3,888294621,888294707,86,324,243,2.357142857142857
898,1,3,2,888294707,888294842,135,243,689,3.1538461538461537
898,3,4,1,888294842,888294942,100,689,1296,3.2222222222222223
895,4,4,0,879437727,879437748,21,294,328,3.4895833333333335
895,4,3,-1,879437748,879437845,97,328,988,2.5555555555555554
895,3,2,-1,879437845,879437868,23,988,885,2.3333333333333335
895,2,5,3,879437868,879437950,82,885,13,3.5454545454545454
895,5,5,0,879437950,879438011,61,13,275,4.087912087912088
895,5,4,-1,879438011,879438028,17,275,283,3.901639344262295
895,4,3,-1,879438028,879438062,34,283,284,3.1547619047619047
895,3,3,0,879438062,879438082,20,284,117,3.689189189189189
895,3,5,2,879438082,879438101,19,117,151,3.6544117647058822
895,5,4,-1,879438101,879438123,22,151,742,3.5555555555555554
906,3,3,0,879434378,879434410,32,307,991,2.4545454545454546
906,3,4,1,879434410,879434436,26,991,321,3.0172413793103448
906,4,4,0,879434436,879434471,35,321,270,3.7804878048780486
906,4,4,0,879434471,879434882,411,270,273,3.5238095238095237
906,4,3,-1,879434882,879435253,371,273,475,3.956043956043956
906,3,3,0,879435253,879435278,25,475,742,3.5555555555555554
906,3,5,2,879435278,879435299,21,742,276,3.6036036036036037
906,5,4,-1,879435299,879435339,40,276,10,3.85
906,4,4,0,879435339,879435365,26,10,221,3.6923076923076925
906,4,4,0,879435365,879435415,50,221,740,3.423076923076923
906,4,3,-1,879435415,879435469,54,740,277,3.6
906,3,4,1,879435469,879435524,55,277,744,3.5714285714285716
906,4,5,1,879435524,879435551,27,744,628,3.573529411764706
906,5,4,-1,879435551,879435574,23,628,117,3.689189189189189
906,4,4,0,879435574,879435758,184,117,696,3.138888888888889
900,4,4,0,877832803,877832837,34,237,124,4.052631578947368
900,4,2,-2,877832837,877832868,31,124,9,3.8878504672897196
900,2,4,2,877832868,877832904,36,9,100,4.0162162162162165
900,4,2,-2,877832904,877833000,96,100,864,3.2142857142857144
900,2,2,0,877833000,877833029,29,864,117,3.689189189189189
900,2,2,0,877833029,877833195,166,117,696,3.138888888888889
900,2,2,0,877833195,877833259,64,696,471,3.5714285714285716
900,2,2,0,877833259,877833326,67,471,410,3.0434782608695654
900,2,2,0,877833326,877833364,38,410,280,3.103448275862069
900,2,1,-1,877833364,877833443,79,280,871,2.3823529411764706
900,1,1,0,877833443,877833512,69,871,130,1.8461538461538463
900,1,4,3,877833512,877833603,91,130,480,4.283018867924528
900,4,5,1,877833603,877833631,28,480,589,4.384615384615385
900,5,2,-3,877833631,877833632,1,589,200,3.8157894736842106
900,2,4,2,877833632,877833672,40,200,318,4.5046728971962615
900,4,4,0,877833672,877833747,75,318,661,4.133333333333334
900,4,3,-1,877833747,877833781,34,661,183,3.951219512195122
900,3,2,-1,877833781,877833923,142,183,478,4.161290322580645
900,2,2,0,877833923,877833924,1,478,654,4.119047619047619
900,2,4,2,877833924,877833957,33,654,618,3.5
900,4,2,-2,877833957,877833995,38,618,31,3.642857142857143
900,2,1,-1,877833995,877834025,30,31,602,3.533333333333333
908,4,2,-2,879722097,879722169,72,288,322,3.0476190476190474
908,2,3,1,879722169,879722206,37,322,264,2.65
908,3,5,2,879722206,879722300,94,264,98,4.240875912408759
908,5,4,-1,879722300,879722333,33,98,648,3.9545454545454546
908,4,3,-1,879722333,879722334,1,648,7,3.76056338028169
908,3,4,1,879722334,879722397,63,7,528,4.241379310344827
908,4,4,0,879722397,879722427,30,528,183,3.951219512195122
908,4,2,-2,879722427,879722489,62,183,192,4.090909090909091
908,2,4,2,879722489,879722490,1,192,709,4.171428571428572
908,4,3,-1,879722490,879722603,113,709,156,4.017857142857143
908,3,3,0,879722603,879722642,39,156,174,4.253521126760563
908,3,3,0,879722642,879722694,52,174,124,4.052631578947368
908,3,5,2,879722694,879722717,23,124,318,4.5046728971962615
908,5,4,-1,879722717,879722718,1,318,483,4.475609756097561
908,4,4,0,879722718,879722754,36,483,195,3.9072164948453607
908,4,3,-1,879722754,879722780,26,195,172,4.225225225225225
908,3,4,1,879722780,879722822,42,172,185,3.9726027397260273
908,4,4,0,879722822,879722850,28,185,79,3.956989247311828
908,4,4,0,879722850,879722875,25,79,419,3.8208955223880596
908,4,3,-1,879722875,879722901,26,419,173,4.1441441441441444
908,3,2,-1,879722901,879722932,31,173,147,3.3142857142857145
908,2,4,2,879722932,879722953,21,147,223,4.108695652173913
908,4,4,0,879722953,879722996,43,223,591,3.7169811320754715
908,4,4,0,879722996,879723022,26,591,479,4.25
908,4,4,0,879723022,879723073,51,479,28,3.923076923076923
908,4,3,-1,879723073,879723095,22,28,47,3.5869565217391304
908,3,4,1,879723095,879723128,33,47,631,3.581818181818182
916,5,3,-2,880843093,880843185,92,268,271,3.3134328358208953
916,3,2,-1,880843185,880843249,64,271,748,3.1043478260869564
916,2,5,3,880843249,880843288,39,748,100,4.0162162162162165
916,5,5,0,880843288,880843318,30,100,246,4.0
916,5,3,-2,880843318,880843334,16,246,298,3.779220779220779
916,3,3,0,880843334,880843361,27,298,273,3.5238095238095237
916,3,5,2,880843361,880843378,17,273,9,3.8878504672897196
916,5,4,-1,880843378,880843401,23,9,244,2.9411764705882355
916,4,3,-1,880843401,880843419,18,244,237,3.7315436241610738
916,3,5,2,880843419,880843465,46,237,919,4.0
916,5,4,-1,880843465,880843482,17,919,236,3.2666666666666666
916,4,2,-2,880843482,880843509,27,236,117,3.689189189189189
916,2,3,1,880843509,880843524,15,117,123,3.297872340425532
916,3,3,0,880843524,880843551,27,123,256,3.5
916,3,3,0,880843551,880843578,27,256,151,3.6544117647058822
916,3,3,0,880843578,880843579,1,151,762,3.3962264150943398
916,3,4,1,880843579,880843594,15,762,221,3.6923076923076925
916,4,3,-1,880843594,880843636,42,221,713,3.5
916,3,2,-1,880843636,880843666,30,713,284,3.1547619047619047
916,2,3,1,880843666,880843683,17,284,1014,3.1
916,3,3,0,880843683,880843697,14,1014,472,2.984375
916,3,3,0,880843697,880843727,30,472,281,3.2
916,3,3,0,880843727,880843749,22,281,235,3.106382978723404
916,3,3,0,880843749,880843750,1,235,125,3.5555555555555554
916,3,2,-1,880843750,880843775,25,125,476,3.1216216216216215
916,2,2,0,880843775,880843811,36,476,1079,2.1923076923076925
916,2,3,1,880843811,880843838,27,1079,824,2.590909090909091
916,3,1,-2,880843838,880843864,26,824,831,2.6097560975609757
916,1,2,1,880843864,880843892,28,831,148,3.2131147540983607
916,2,2,0,880843892,880843906,14,148,369,2.5714285714285716
916,2,2,0,880843906,880843934,28,369,930,2.793103448275862
916,2,1,-1,880843934,880843949,15,930,978,2.357142857142857
916,1,5,4,880843949,880843996,47,978,64,4.373737373737374
916,5,5,0,880843996,880844016,20,64,156,4.017857142857143
916,5,3,-2,880844016,880844017,1,156,209,3.8275862068965516
916,3,4,1,880844017,880844058,41,209,462,3.7954545454545454
916,4,3,-1,880844058,880844123,65,462,182,3.842857142857143
916,3,4,1,880844123,880844156,33,182,484,4.116279069767442
916,4,4,0,880844156,880844157,1,484,203,3.826923076923077
916,4,3,-1,880844157,880844202,45,203,961,3.4545454545454546
916,3,4,1,880844202,880844223,21,961,91,3.6
916,4,3,-1,880844223,880844262,39,91,746,3.7560975609756095
916,3,5,2,880844262,880844291,29,746,421,3.462962962962963
916,5,4,-1,880844291,880844331,40,421,531,3.7435897435897436
916,4,4,0,880844331,880844332,1,531,173,4.1441441441441444
916,4,4,0,880844332,880844369,37,173,168,4.0476190476190474
916,4,4,0,880844369,880844395,26,168,211,3.958904109589041
916,4,4,0,880844395,880844420,25,211,193,3.883720930232558
916,4,4,0,880844420,880844445,25,193,1073,3.6315789473684212
916,4,4,0,880844445,880844463,18,1073,198,4.04
916,4,4,0,880844463,880844480,17,198,46,3.6666666666666665
916,4,3,-1,880844480,880844511,31,46,160,3.4
916,3,4,1,880844511,880844527,16,160,557,3.090909090909091
916,4,4,0,880844527,880844552,25,557,192,4.090909090909091
916,4,3,-1,880844552,880844569,17,192,792,3.793103448275862
916,3,4,1,880844569,880844612,43,792,170,4.242424242424242
916,4,3,-1,880844612,880844627,15,170,239,3.423076923076923
916,3,4,1,880844627,880844654,27,239,427,4.2025316455696204
916,4,4,0,880844654,880844675,21,427,213,3.943396226415094
916,4,4,0,880844675,880844694,19,213,210,3.921259842519685
916,4,4,0,880844694,880844711,17,210,650,3.1363636363636362
916,4,4,0,880844711,880844728,17,650,582,3.7457627118644066
916,4,5,1,880844728,880844753,25,582,180,3.9473684210526314
916,5,3,-2,880844753,880844767,14,180,558,3.75
916,3,4,1,880844767,880844789,22,558,97,3.7282608695652173
916,4,3,-1,880844789,880844813,24,97,204,3.6744186046511627
916,3,4,1,880844813,880844834,21,204,943,3.6666666666666665
916,4,3,-1,880844834,880844861,27,943,1109,3.4545454545454546
916,3,3,0,880844861,880844862,1,1109,732,3.6266666666666665
916,3,5,2,880844862,880844879,17,732,212,3.230769230769231
916,5,3,-2,880844879,880844897,18,212,232,3.0789473684210527
916,3,4,1,880844897,880844937,40,232,697,2.7777777777777777
916,4,3,-1,880844937,880844958,21,697,214,3.272727272727273
916,3,2,-1,880844958,880844985,27,214,550,3.272727272727273
916,2,4,2,880844985,880845011,26,550,238,3.888888888888889
916,4,3,-1,880845011,880845028,17,238,202,3.730337078651685
916,3,3,0,880845028,880845067,39,202,227,3.169811320754717
916,3,4,1,880845067,880845098,31,227,317,3.774193548387097
916,4,3,-1,880845098,880845099,1,317,109,3.282608695652174
916,3,4,1,880845099,880845157,58,109,640,2.75
916,4,3,-1,880845157,880845177,20,640,402,3.3076923076923075
916,3,3,0,880845177,880845206,29,402,1597,3.0
916,3,3,0,880845206,880845227,21,1597,642,3.4285714285714284
916,3,2,-1,880845227,880845249,22,642,1208,2.6666666666666665
916,2,3,1,880845249,880845264,15,1208,66,3.4705882352941178
916,3,3,0,880845264,880845282,18,66,1220,2.9166666666666665
916,3,3,0,880845282,880845303,21,1220,218,3.5555555555555554
916,3,3,0,880845303,880845327,24,218,65,3.511111111111111
916,3,4,1,880845327,880845328,1,65,387,3.5357142857142856
916,4,4,0,880845328,880845368,40,387,241,3.5625
916,4,3,-1,880845368,880845391,23,241,636,3.4146341463414633
916,3,3,0,880845391,880845415,24,636,1428,3.2857142857142856
916,3,3,0,880845415,880845476,61,1428,80,2.967741935483871
916,3,3,0,880845476,880845505,29,80,1119,3.5185185185185186
916,3,4,1,880845505,880845522,17,1119,767,3.0
916,4,3,-1,880845522,880845543,21,767,549,3.4871794871794872
916,3,3,0,880845543,880845589,46,549,739,3.391304347826087
916,3,2,-1,880845589,880845606,17,739,569,2.4285714285714284
916,2,3,1,880845606,880845620,14,569,77,3.3857142857142857
916,3,3,0,880845620,880845658,38,77,366,3.4285714285714284
916,3,4,1,880845658,880845690,32,366,583,3.4285714285714284
916,4,3,-1,880845690,880845722,32,583,356,3.2
916,3,3,0,880845722,880845738,16,356,381,3.2758620689655173
916,3,3,0,880845738,880845755,17,381,1682,3.0
916,3,4,1,880845755,880845772,17,1682,82,3.6741573033707864
916,4,3,-1,880845772,880845790,18,82,54,3.3714285714285714
916,3,2,-1,880845790,880845808,18,54,155,3.0588235294117645
916,2,3,1,880845808,880845829,21,155,73,3.588235294117647
916,3,4,1,880845829,880845949,120,73,568,3.5853658536585367
911,4,3,-1,892838405,892838538,133,89,427,4.2025316455696204
911,3,4,1,892838538,892838577,39,427,174,4.253521126760563
911,4,4,0,892838577,892838636,59,174,172,4.225225225225225
911,4,3,-1,892838636,892838637,1,172,483,4.475609756097561
911,3,4,1,892838637,892838676,39,483,168,4.0476190476190474
911,4,3,-1,892838676,892838677,1,168,659,4.027777777777778
911,3,5,2,892838677,892838787,110,659,479,4.25
911,5,5,0,892838787,892838823,36,479,478,4.161290322580645
911,5,5,0,892838823,892838864,41,478,190,4.233333333333333
911,5,3,-2,892838864,892838954,90,190,496,4.094594594594595
911,3,2,-1,892838954,892839015,61,496,98,4.240875912408759
911,2,4,2,892839015,892839056,41,98,193,3.883720930232558
911,4,5,1,892839056,892839084,28,193,855,3.590909090909091
911,5,3,-2,892839084,892839140,56,855,215,3.662921348314607
911,3,4,1,892839140,892839289,149,215,507,3.6285714285714286
911,4,3,-1,892839289,892839333,44,507,199,4.191489361702128
911,3,3,0,892839333,892839363,30,199,484,4.116279069767442
911,3,3,0,892839363,892839418,55,484,211,3.958904109589041
911,3,3,0,892839418,892839454,36,211,205,3.717391304347826
911,3,4,1,892839454,892839492,38,205,154,3.6031746031746033
911,4,3,-1,892839492,892839518,26,154,506,3.566666666666667
911,3,3,0,892839518,892839551,33,506,432,3.719298245614035
911,3,5,2,892839551,892839719,168,432,655,3.7857142857142856
911,5,3,-2,892839719,892839745,26,655,210,3.921259842519685
911,3,4,1,892839745,892839929,184,210,194,4.029411764705882
911,4,4,0,892839929,892839970,41,194,208,3.8125
911,4,5,1,892839970,892839993,23,208,435,3.8933333333333335
911,5,4,-1,892839993,892840048,55,435,26,3.36
911,4,5,1,892840048,892840120,72,26,399,3.317073170731707
911,5,2,-3,892840120,892840253,133,399,451,3.207792207792208
911,2,1,-1,892840253,892840297,44,451,240,3.0350877192982457
911,1,3,2,892840297,892840888,591,240,627,3.3823529411764706
911,3,3,0,892840888,892840950,62,627,404,3.6578947368421053
911,3,4,1,892840950,892841033,83,404,1060,3.235294117647059
911,4,3,-1,892841033,892841073,40,1060,548,2.0
911,3,1,-2,892841073,892841118,45,548,374,2.111111111111111
911,1,4,3,892841118,892841220,102,374,443,3.8421052631578947
911,4,4,0,892841220,892841255,35,443,176,3.967032967032967
911,4,4,0,892841255,892842509,1254,176,923,4.142857142857143
911,4,4,0,892842509,892842771,262,923,197,4.112676056338028
912,5,3,-2,875965830,875965906,76,498,653,4.0
912,3,4,1,875965906,875965939,33,653,496,4.094594594594595
912,4,5,1,875965939,875965981,42,496,602,3.533333333333333
912,5,4,-1,875965981,875966027,46,602,64,4.373737373737374
912,4,4,0,875966027,875966107,80,64,479,4.25
912,4,3,-1,875966107,875966202,95,479,186,3.905263157894737
912,3,5,2,875966202,875966320,118,186,655,3.7857142857142856
912,5,4,-1,875966320,875966349,29,655,192,4.090909090909091
912,4,4,0,875966349,875966385,36,192,318,4.5046728971962615
912,4,3,-1,875966385,875966616,231,318,648,3.9545454545454546
912,3,5,2,875966616,875966694,78,648,423,3.7016129032258065
912,5,3,-2,875966694,875966756,62,423,174,4.253521126760563
912,3,4,1,875966756,875966783,27,174,97,3.7282608695652173
912,4,5,1,875966783,875966927,144,97,14,4.101694915254237
912,5,2,-3,875966927,875967072,145,14,246,4.0
914,4,4,0,887122028,887122029,1,197,371,3.0
914,4,2,-2,887122029,887122085,56,371,451,3.207792207792208
914,2,3,1,887122085,887122325,240,451,381,3.2758620689655173
914,3,2,-1,887122325,887123465,1140,381,732,3.6266666666666665
918,1,4,3,891986174,891986609,435,340,656,3.75
918,4,1,-3,891986609,891986634,25,656,135,3.7974683544303796
918,1,5,4,891986634,891986720,86,135,190,4.233333333333333
918,5,4,-1,891986720,891986798,78,190,86,3.869565217391304
918,4,4,0,891986798,891986820,22,86,709,4.171428571428572
918,4,3,-1,891986820,891986846,26,709,199,4.191489361702128
918,3,4,1,891986846,891986904,58,199,132,3.929411764705882
918,4,3,-1,891986904,891986933,29,132,462,3.7954545454545454
918,3,4,1,891986933,891986959,26,462,45,4.130434782608695
918,4,4,0,891986959,891986998,39,45,165,3.9130434782608696
918,4,3,-1,891986998,891986999,1,165,168,4.0476190476190474
918,3,4,1,891986999,891987025,26,168,64,4.373737373737374
918,4,3,-1,891987025,891987059,34,64,658,3.393939393939394
918,3,4,1,891987059,891987132,73,658,606,4.294117647058823
918,4,3,-1,891987132,891987154,22,606,174,4.253521126760563
918,3,4,1,891987154,891987176,22,174,275,4.087912087912088
918,4,2,-2,891987176,891987205,29,275,216,3.8454545454545452
918,2,4,2,891987205,891987238,33,216,166,4.0
918,4,1,-3,891987238,891987267,29,166,133,3.7777777777777777
918,1,3,2,891987267,891987290,23,133,529,4.142857142857143
918,3,1,-2,891987290,891987291,1,529,153,3.7865168539325844
918,1,1,0,891987291,891987317,26,153,204,3.6744186046511627
918,1,3,2,891987317,891987339,22,204,175,3.8354430379746836
918,3,2,-1,891987339,891987387,48,175,197,4.112676056338028
918,2,2,0,891987387,891987411,24,197,154,3.6031746031746033
918,2,5,3,891987411,891987446,35,154,707,3.909090909090909
918,5,4,-1,891987446,891987541,95,707,28,3.923076923076923
918,4,5,1,891987541,891987571,30,28,1639,5.0
918,5,3,-2,891987571,891987689,118,1639,485,3.717948717948718
918,3,4,1,891987689,891987723,34,485,582,3.7457627118644066
918,4,4,0,891987723,891987752,29,582,660,3.71875
918,4,3,-1,891987752,891987846,94,660,488,4.277777777777778
918,3,4,1,891987846,891987914,68,488,664,3.15
918,4,5,1,891987914,891988001,87,664,428,3.744186046511628
918,5,5,0,891988001,891988054,53,428,972,3.375
918,5,4,-1,891988054,891988090,36,972,645,3.5714285714285716
918,4,5,1,891988090,891988123,33,645,381,3.2758620689655173
918,5,3,-2,891988123,891988163,40,381,640,2.75
918,3,4,1,891988163,891988276,113,640,965,3.7142857142857144
918,4,2,-2,891988276,891988337,61,965,179,3.8823529411764706
918,2,4,2,891988337,891988491,154,179,856,4.142857142857143
918,4,2,-2,891988491,891988521,30,856,417,3.0588235294117645
918,2,2,0,891988521,891988559,38,417,289,2.988888888888889
918,2,4,2,891988559,891988560,1,289,16,3.411764705882353
918,4,4,0,891988560,891988586,26,16,1266,3.6666666666666665
918,4,2,-2,891988586,891988646,60,1266,151,3.6544117647058822
918,2,3,1,891988646,891988672,26,151,630,3.25
918,3,3,0,891988672,891988705,33,630,747,3.5526315789473686
919,4,4,0,875288362,875288418,56,260,325,2.625
919,4,2,-2,875288418,875288443,25,325,878,2.0
919,2,5,3,875288443,875288522,79,878,100,4.0162162162162165
919,5,3,-2,875288522,875288523,1,100,246,4.0
919,3,5,2,875288523,875288570,47,246,508,3.6923076923076925
919,5,4,-1,875288570,875288612,42,508,1152,3.4375
919,4,4,0,875288612,875288613,1,1152,1197,3.625
919,4,5,1,875288613,875288748,135,1197,285,4.181818181818182
919,5,3,-2,875288748,875288749,1,285,116,3.6666666666666665
919,3,3,0,875288749,875288848,99,116,7,3.76056338028169
919,3,4,1,875288848,875288898,50,7,221,3.6923076923076925
919,4,3,-1,875288898,875288983,85,221,222,3.578125
919,3,4,1,875288983,875289025,42,222,151,3.6544117647058822
919,4,2,-2,875289025,875289061,36,151,412,2.272727272727273
919,2,4,2,875289061,875289113,52,412,125,3.5555555555555554
919,4,4,0,875289113,875289170,57,125,255,3.2027027027027026
919,4,2,-2,875289170,875289212,42,255,458,3.0588235294117645
919,2,5,3,875289212,875289250,38,458,15,3.725663716814159
919,5,3,-2,875289250,875289280,30,15,284,3.1547619047619047
919,3,4,1,875289280,875289321,41,284,1,3.902439024390244
919,4,2,-2,875289321,875289356,35,1,1134,2.888888888888889
919,2,4,2,875289356,875289499,143,1134,742,3.5555555555555554
919,4,4,0,875289499,875289533,34,742,16,3.411764705882353
919,4,3,-1,875289533,875289566,33,16,1284,2.5454545454545454
919,3,3,0,875289566,875289611,45,1284,240,3.0350877192982457
919,3,3,0,875289611,875289638,27,240,471,3.5714285714285716
919,3,3,0,875289638,875289667,29,471,591,3.7169811320754715
919,3,4,1,875289667,875289887,220,591,1277,3.5555555555555554
919,4,5,1,875289887,875372903,83016,1277,318,4.5046728971962615
919,5,2,-3,875372903,875372947,44,318,85,3.3157894736842106
919,2,3,1,875372947,875372988,41,85,238,3.888888888888889
919,3,1,-2,875372988,875373074,86,238,168,4.0476190476190474
919,1,5,4,875373074,875373214,140,168,582,3.7457627118644066
919,5,4,-1,875373214,875373294,80,582,200,3.8157894736842106
919,4,4,0,875373294,875373416,122,200,527,3.823529411764706
919,4,5,1,875373416,875373470,54,527,1101,3.793103448275862
919,5,2,-3,875373470,875373471,1,1101,193,3.883720930232558
919,2,4,2,875373471,875373521,50,193,794,3.6
919,4,4,0,875373521,875373582,61,794,118,3.2764227642276422
919,4,4,0,875373582,875373669,87,118,217,3.1538461538461537
919,4,2,-2,875373669,875373770,101,217,564,2.0
919,2,3,1,875373770,875373824,54,564,1109,3.4545454545454546
919,3,4,1,875373824,875373888,64,1109,28,3.923076923076923
919,4,4,0,875373888,875373889,1,28,144,3.9545454545454546
919,4,5,1,875373889,875373945,56,144,82,3.6741573033707864
919,5,5,0,875373945,875374269,324,82,419,3.8208955223880596
919,5,4,-1,875374269,875920290,546021,419,333,3.546666666666667
919,4,2,-2,875920290,875920347,57,333,681,2.25
919,2,3,1,875920347,875920823,476,681,1114,3.2
919,3,4,1,875920823,875920887,64,1114,201,3.75
919,4,3,-1,875920887,875921051,164,201,953,3.076923076923077
919,3,4,1,875921051,875921085,34,953,367,3.4242424242424243
919,4,4,0,875921085,875921182,97,367,95,3.8194444444444446
919,4,3,-1,875921182,875921283,101,95,787,2.75
919,3,4,1,875921283,885059422,9138139,787,270,3.7804878048780486
919,4,3,-1,885059422,885059452,30,270,750,4.027777777777778
919,3,4,1,885059452,885059476,24,750,271,3.3134328358208953
919,4,4,0,885059476,885059506,30,271,307,3.6031746031746033
919,4,3,-1,885059506,885059537,31,307,310,3.6666666666666665
919,3,3,0,885059537,885059569,32,310,315,4.15
919,3,3,0,885059569,885059601,32,315,880,2.8421052631578947
919,3,4,1,885059601,885059623,22,880,305,3.5789473684210527
919,4,3,-1,885059623,885059658,35,305,690,3.260869565217391
919,3,3,0,885059658,885059724,66,690,892,2.9615384615384617
919,3,3,0,885059724,885059859,135,892,1173,3.0
921,4,1,-3,879379338,879379361,23,294,245,3.056179775280899
921,1,4,3,879379361,879379601,240,245,845,3.661290322580645
921,4,4,0,879379601,879379621,20,845,15,3.725663716814159
921,4,2,-2,879379621,879379714,93,15,282,3.610526315789474
921,2,5,3,879379714,879379736,22,282,121,3.521212121212121
921,5,3,-2,879379736,879379774,38,121,125,3.5555555555555554
921,3,2,-1,879379774,879379821,47,125,471,3.5714285714285716
921,2,3,1,879379821,879379843,22,471,147,3.3142857142857145
921,3,2,-1,879379843,879379942,99,147,1060,3.235294117647059
921,2,4,2,879379942,879379943,1,1060,284,3.1547619047619047
921,4,4,0,879379943,879379971,28,284,274,3.5609756097560976
921,4,3,-1,879379971,879379994,23,274,151,3.6544117647058822
921,3,1,-2,879379994,879380015,21,151,1047,2.6923076923076925
921,1,2,1,879380015,879380057,42,1047,472,2.984375
921,2,3,1,879380057,879380097,40,472,24,3.3728813559322033
921,3,4,1,879380097,879380142,45,24,1028,2.857142857142857
921,4,2,-2,879380142,879380237,95,1028,762,3.3962264150943398
921,2,3,1,879380237,879380258,21,762,763,3.347826086956522
921,3,3,0,879380258,879380328,70,763,820,3.0444444444444443
921,3,1,-2,879380328,879380401,73,820,1287,1.0
921,1,3,2,879380401,879380457,56,1287,1034,2.6
921,3,3,0,879380457,879380496,39,1034,934,3.0294117647058822
921,3,4,1,879380496,879380656,160,934,96,3.9130434782608696
921,4,4,0,879380656,879380677,21,96,215,3.662921348314607
921,4,3,-1,879380677,879380704,27,215,778,3.5925925925925926
921,3,4,1,879380704,879380806,102,778,136,3.764705882352941
921,4,3,-1,879380806,879380826,20,136,185,3.9726027397260273
921,3,4,1,879380826,879380862,36,185,69,3.8015873015873014
921,4,3,-1,879380862,879380908,46,69,395,2.5714285714285716
921,3,2,-1,879380908,879380957,49,395,410,3.0434782608695654
921,2,2,0,879380957,879380981,24,410,1317,3.0
921,2,1,-1,879380981,879381004,23,1317,276,3.6036036036036037
921,1,4,3,879381004,879381021,17,276,367,3.4242424242424243
921,4,4,0,879381021,879381051,30,367,50,4.306532663316583
921,4,4,0,879381051,879381128,77,50,720,3.2
921,4,4,0,879381128,879381158,30,720,400,2.375
921,4,5,1,879381158,879381199,41,400,1032,2.7142857142857144
921,5,5,0,879381199,879381234,35,1032,419,3.8208955223880596
921,5,5,0,879381234,879381257,23,419,143,3.56
921,5,1,-4,879381257,879381287,30,143,128,3.45
921,1,3,2,879381287,879381299,12,128,728,3.05
921,3,4,1,879381299,884673633,5292334,728,210,3.921259842519685
921,4,2,-2,884673633,884673673,40,210,87,3.9
921,2,3,1,884673673,884673699,26,87,132,3.929411764705882
921,3,5,2,884673699,884673700,1,132,66,3.4705882352941178
921,5,5,0,884673700,884673799,99,66,659,4.027777777777778
921,5,4,-1,884673799,884673823,24,659,172,4.225225225225225
921,4,5,1,884673823,884673843,20,172,133,3.7777777777777777
921,5,3,-2,884673843,884673868,25,133,603,4.315789473684211
921,3,2,-1,884673868,884673891,23,603,97,3.7282608695652173
921,2,4,2,884673891,884673930,39,97,526,3.909090909090909
921,4,3,-1,884673930,884673954,24,526,82,3.6741573033707864
910,4,2,-2,880821098,880821124,26,100,298,3.779220779220779
910,2,1,-1,880821124,880821319,195,298,628,3.573529411764706
910,1,4,3,880821319,880821349,30,628,508,3.6923076923076925
910,4,3,-1,880821349,880821383,34,508,125,3.5555555555555554
910,3,1,-2,880821383,880821492,109,125,121,3.521212121212121
910,1,3,2,880821492,880821676,184,121,134,4.174603174603175
910,3,4,1,880821676,880821696,20,134,182,3.842857142857143
910,4,4,0,880821696,880821718,22,182,12,4.358974358974359
910,4,2,-2,880821718,880821834,116,12,332,3.6511627906976742
910,2,4,2,880821834,880822012,178,332,117,3.689189189189189
910,4,4,0,880822012,880822060,48,117,222,3.578125
910,4,3,-1,880822060,880822203,143,222,25,3.3185840707964602
910,3,3,0,880822203,881420228,598025,25,748,3.1043478260869564
910,3,3,0,881420228,881420491,263,748,289,2.988888888888889
910,3,2,-1,881420491,881420507,16,289,1025,2.95
910,2,3,1,881420507,881420857,350,1025,118,3.2764227642276422
910,3,2,-1,881420857,881421019,162,118,3,3.0625
910,2,2,0,881421019,881421035,16,3,252,2.911392405063291
910,2,1,-1,881421035,881421090,55,252,291,3.2
910,1,1,0,881421090,881421240,150,291,254,2.7419354838709675
910,1,4,3,881421240,881421309,69,254,210,3.921259842519685
910,4,3,-1,881421309,884229194,2807885,210,751,3.3896103896103895
910,3,3,0,884229194,884229224,30,751,288,3.5214285714285714
910,3,4,1,884229224,884229250,26,288,1012,3.2916666666666665
913,2,5,3,880757553,880758348,795,69,408,4.4772727272727275
913,5,3,-2,880758348,880759072,724,408,508,3.6923076923076925
913,3,5,2,880759072,880759221,149,508,176,3.967032967032967
913,5,3,-2,880759221,880824372,65151,176,42,3.893617021276596
913,3,4,1,880824372,880824512,140,42,478,4.161290322580645
913,4,5,1,880824512,880826542,2030,478,173,4.1441441441441444
913,5,2,-3,880826542,880826620,78,173,164,3.6140350877192984
913,2,3,1,880826620,880826706,86,164,184,3.393939393939394
913,3,4,1,880826706,880826766,60,184,95,3.8194444444444446
913,4,4,0,880826766,880946415,119649,95,789,3.7777777777777777
913,4,2,-2,880946415,880946475,60,789,531,3.7435897435897436
913,2,4,2,880946475,880946539,64,531,204,3.6744186046511627
913,4,4,0,880946539,881037004,90465,204,741,3.3043478260869565
913,4,3,-1,881037004,881037047,43,741,276,3.6036036036036037
913,3,4,1,881037047,881037106,59,276,11,3.8904109589041096
913,4,1,-3,881037106,881037229,123,11,260,2.4716981132075473
913,1,5,4,881037229,881366473,329244,260,175,3.8354430379746836
913,5,4,-1,881366473,881366878,405,175,99,3.8392857142857144
913,4,4,0,881366878,881366897,19,99,12,4.358974358974359
913,4,3,-1,881366897,881366974,77,12,25,3.3185840707964602
913,3,3,0,881366974,881367151,177,25,428,3.744186046511628
913,3,4,1,881367151,881367173,22,428,185,3.9726027397260273
913,4,3,-1,881367173,881367312,139,185,436,3.5
913,3,5,2,881367312,881367620,308,436,174,4.253521126760563
913,5,3,-2,881367620,881367770,150,174,15,3.725663716814159
913,3,1,-2,881367770,881368310,540,15,227,3.169811320754717
913,1,4,3,881368310,881368824,514,227,151,3.6544117647058822
913,4,5,1,881368824,881725761,356937,151,657,4.341463414634147
913,5,4,-1,881725761,881725796,35,657,168,4.0476190476190474
913,4,4,0,881725796,881725876,80,168,317,3.774193548387097
913,4,5,1,881725876,881725904,28,317,96,3.9130434782608696
913,5,5,0,881725904,881725938,34,96,269,4.085106382978723
913,5,4,-1,881725938,881725960,22,269,237,3.7315436241610738
913,4,5,1,881725960,881726004,44,237,172,4.225225225225225
913,5,1,-4,881726004,882044453,318449,172,1112,2.9
913,1,1,0,882044453,882544673,500220,1112,117,3.689189189189189
913,1,3,2,882544673,883110406,565733,117,346,3.5128205128205128
915,3,3,0,891030002,891030032,30,321,307,3.6031746031746033
915,3,4,1,891030032,891030070,38,307,750,4.027777777777778
915,4,3,-1,891030070,891030120,50,750,752,3.6666666666666665
915,3,4,1,891030120,891030145,25,752,345,3.4782608695652173
915,4,5,1,891030145,891031477,1332,345,268,3.9838709677419355
922,5,1,-4,891447447,891447628,181,50,56,4.051724137931035
922,1,5,4,891447628,891447665,37,56,98,4.240875912408759
922,5,4,-1,891447665,891447681,16,98,222,3.578125
922,4,4,0,891447681,891447723,42,222,431,3.422222222222222
922,4,4,0,891447723,891447777,54,431,227,3.169811320754717
922,4,4,0,891447777,891447802,25,227,449,2.9069767441860463
922,4,4,0,891447802,891447833,31,449,77,3.3857142857142857
922,4,3,-1,891447833,891447853,20,77,159,3.3902439024390243
922,3,4,1,891447853,891447876,23,159,450,2.2758620689655173
922,4,4,0,891447876,891447944,68,450,406,2.5294117647058822
922,4,3,-1,891447944,891447988,44,406,579,2.727272727272727
922,3,5,2,891447988,891448040,52,579,173,4.1441441441441444
922,5,3,-2,891448040,891448246,206,173,662,3.4583333333333335
922,3,4,1,891448246,891448247,1,662,451,3.207792207792208
922,4,3,-1,891448247,891448348,101,451,371,3.0
922,3,3,0,891448348,891448451,103,371,402,3.3076923076923075
922,3,4,1,891448451,891448473,22,402,421,3.462962962962963
922,4,3,-1,891448473,891448516,43,421,739,3.391304347826087
922,3,5,2,891448516,891448551,35,739,1,3.902439024390244
922,5,4,-1,891448551,891449021,470,1,143,3.56
922,4,3,-1,891449021,891449048,27,143,699,3.736842105263158
922,3,5,2,891449048,891449122,74,699,181,3.98974358974359
922,5,3,-2,891449122,891449123,1,181,82,3.6741573033707864
922,3,5,2,891449123,891449152,29,82,151,3.6544117647058822
922,5,3,-2,891449152,891449363,211,151,63,3.125
922,3,3,0,891449363,891449552,189,63,1035,3.03125
922,3,1,-2,891449552,891449901,349,1035,219,2.735294117647059
922,1,3,2,891449901,891449993,92,219,217,3.1538461538461537
922,3,3,0,891449993,891450368,375,217,210,3.921259842519685
922,3,3,0,891450368,891450401,33,210,161,3.5844155844155843
922,3,3,0,891450401,891450524,123,161,568,3.5853658536585367
922,3,3,0,891450524,891450586,62,568,385,3.6129032258064515
922,3,4,1,891450586,891450688,102,385,455,3.1702127659574466
922,4,4,0,891450688,891450768,80,455,1110,2.85
922,4,3,-1,891450768,891450805,37,1110,403,3.298507462686567
922,3,3,0,891450805,891450840,35,403,391,2.4285714285714284
922,3,3,0,891450840,891450866,26,391,562,3.2941176470588234
922,3,3,0,891450866,891450968,102,562,168,4.0476190476190474
922,3,4,1,891450968,891451037,69,168,153,3.7865168539325844
922,4,3,-1,891451037,891451100,63,153,204,3.6744186046511627
922,3,4,1,891451100,891451143,43,204,433,3.8035714285714284
922,4,3,-1,891451143,891451240,97,433,175,3.8354430379746836
922,3,2,-1,891451240,891451327,87,175,655,3.7857142857142856
922,2,4,2,891451327,891451373,46,655,382,3.764705882352941
922,4,2,-2,891451373,891452407,1034,382,235,3.106382978723404
922,2,3,1,891452407,891452817,410,235,80,2.967741935483871
922,3,4,1,891452817,891452879,62,80,395,2.5714285714285716
922,4,3,-1,891452879,891452928,49,395,67,3.106382978723404
922,3,3,0,891452928,891453106,178,67,69,3.8015873015873014
922,3,4,1,891453106,891453122,16,69,15,3.725663716814159
922,4,3,-1,891453122,891453171,49,15,631,3.581818181818182
922,3,3,0,891453171,891453653,482,631,215,3.662921348314607
922,3,2,-1,891453653,891453820,167,215,135,3.7974683544303796
922,2,3,1,891453820,891453854,34,135,276,3.6036036036036037
922,3,5,2,891453854,891454320,466,276,949,3.392857142857143
922,5,3,-2,891454320,891454445,125,949,43,3.1
922,3,2,-1,891454445,891454552,107,43,375,2.076923076923077
922,2,3,1,891454552,891454587,35,375,191,4.168674698795181
922,3,5,2,891454587,891454625,38,191,919,4.0
922,5,4,-1,891454625,891454681,56,919,258,3.7547169811320753
922,4,4,0,891454681,891455049,368,258,257,3.7154471544715446
922,4,3,-1,891455049,891455250,201,257,249,3.3275862068965516
922,3,1,-2,891455250,891455277,27,249,1079,2.1923076923076925
922,1,1,0,891455277,891455379,102,1079,411,2.911764705882353
923,3,5,2,880387001,880387080,79,689,340,3.7419354838709675
923,5,4,-1,880387080,880387081,1,340,325,2.625
923,4,5,1,880387081,880387129,48,325,334,3.4210526315789473
923,5,4,-1,880387129,880387130,1,334,322,3.0476190476190474
923,4,4,0,880387130,880387172,42,322,338,2.75
923,4,3,-1,880387172,880387199,27,338,264,2.65
923,3,4,1,880387199,880387306,107,264,9,3.8878504672897196
923,4,5,1,880387306,880387363,57,9,181,3.98974358974359
923,5,4,-1,880387363,880387428,65,181,628,3.573529411764706
923,4,5,1,880387428,880387429,1,628,276,3.6036036036036037
923,5,5,0,880387429,880387474,45,276,129,3.744186046511628
923,5,4,-1,880387474,880387507,33,129,546,2.9789473684210526
923,4,5,1,880387507,880387579,72,546,295,3.769230769230769
923,5,4,-1,880387579,880387598,19,295,117,3.689189189189189
923,4,5,1,880387598,880387624,26,117,1012,3.2916666666666665
923,5,4,-1,880387624,880387664,40,1012,411,2.911764705882353
923,4,4,0,880387664,880387707,43,411,3,3.0625
923,4,5,1,880387707,880387792,85,3,741,3.3043478260869565
923,5,4,-1,880387792,880387875,83,741,281,3.2
923,4,5,1,880387875,880387946,71,281,257,3.7154471544715446
923,5,4,-1,880387946,880388021,75,257,249,3.3275862068965516
923,4,3,-1,880388021,880388097,76,249,280,3.103448275862069
923,3,1,-2,880388097,880388173,76,280,1001,2.6666666666666665
923,1,4,3,880388173,880388211,38,1001,831,2.6097560975609757
923,4,4,0,880388211,880388245,34,831,975,3.411764705882353
923,4,4,0,880388245,880388289,44,975,125,3.5555555555555554
923,4,5,1,880388289,880388322,33,125,1277,3.5555555555555554
923,5,4,-1,880388322,880388383,61,1277,823,2.75
923,4,4,0,880388383,880388547,164,823,472,2.984375
923,4,4,0,880388547,880388562,15,472,456,2.2
928,5,3,-2,880935814,880936817,1003,268,176,3.967032967032967
928,3,4,1,880936817,880936863,46,176,173,4.1441441441441444
928,4,5,1,880936863,880937163,300,173,1007,4.117647058823529
928,5,3,-2,880937163,880937258,95,1007,333,3.546666666666667
927,5,4,-1,879176156,879177027,871,300,255,3.2027027027027026
927,4,5,1,879177027,879177177,150,255,222,3.578125
927,5,4,-1,879177177,879177243,66,222,1093,3.0
927,4,4,0,879177243,879177298,55,1093,125,3.5555555555555554
927,4,5,1,879177298,879177353,55,125,257,3.7154471544715446
927,5,3,-2,879177353,879177456,103,257,240,3.0350877192982457
927,3,4,1,879177456,879177508,52,240,237,3.7315436241610738
927,4,5,1,879177508,879177509,1,237,15,3.725663716814159
927,5,1,-4,879177509,879181133,3624,15,278,3.0357142857142856
927,1,4,3,879181133,879181259,126,278,756,2.6885245901639343
927,4,3,-1,879181259,879181694,435,756,535,3.380952380952381
927,3,4,1,879181694,879181749,55,535,763,3.347826086956522
927,4,1,-3,879181749,879181879,130,763,105,2.6176470588235294
927,1,1,0,879181879,879182833,954,105,412,2.272727272727273
927,1,2,1,879182833,879182939,106,412,1095,2.8
927,2,4,2,879182939,879183019,80,1095,928,3.142857142857143
927,4,4,0,879183019,879183164,145,928,8,3.903225806451613
927,4,4,0,879183164,879183245,81,8,195,3.9072164948453607
927,4,5,1,879183245,879183303,58,195,11,3.8904109589041096
927,5,5,0,879183303,879183683,380,11,588,3.8358208955223883
927,5,3,-2,879183683,879184534,851,588,154,3.6031746031746033
927,3,5,2,879184534,879184644,110,154,228,3.7246376811594204
927,5,4,-1,879184644,879184710,66,228,417,3.0588235294117645
927,4,5,1,879184710,879184761,51,417,96,3.9130434782608696
927,5,4,-1,879184761,879190473,5712,96,67,3.106382978723404
927,4,4,0,879190473,879191432,959,67,426,3.1
927,4,5,1,879191432,879191524,92,426,1,3.902439024390244
927,5,3,-2,879191524,879191722,198,1,229,3.185185185185185
927,3,2,-1,879191722,879192052,330,229,1178,2.375
927,2,4,2,879192052,879192123,71,1178,402,3.3076923076923075
927,4,4,0,879192123,879193625,1502,402,385,3.6129032258064515
927,4,5,1,879193625,879193732,107,385,393,3.5125
927,5,5,0,879193732,879193848,116,393,72,3.175438596491228
927,5,4,-1,879193848,879194335,487,72,403,3.298507462686567
927,4,4,0,879194335,879195972,1637,403,768,3.238095238095238
927,4,3,-1,879195972,879196231,259,768,143,3.56
927,3,2,-1,879196231,879196283,52,143,227,3.169811320754717
927,2,4,2,879196283,879196853,570,227,1415,2.8
927,4,4,0,879196853,879196955,102,1415,91,3.6
927,4,4,0,879196955,879197074,119,91,63,3.125
927,4,3,-1,879197074,879197198,124,63,1229,2.4
927,3,2,-1,879197198,879197269,71,1229,82,3.6741573033707864
927,2,3,1,879197269,879197421,152,82,722,2.9642857142857144
927,3,3,0,879197421,879198085,664,722,761,3.0588235294117645
927,3,4,1,879198085,879199030,945,761,1035,3.03125
927,4,4,0,879199030,879199110,80,1035,422,3.25
927,4,5,1,879199110,879199250,140,422,568,3.5853658536585367
924,3,4,1,884337043,884337242,199,286,896,3.6666666666666665
924,4,2,-2,884337242,884337243,1,896,300,3.6861313868613137
924,2,3,1,884337243,884371438,34195,300,127,4.162790697674419
924,3,4,1,884371438,884371495,57,127,283,3.901639344262295
924,4,3,-1,884371495,884371535,40,283,181,3.98974358974359
924,3,4,1,884371535,884371558,23,181,100,4.0162162162162165
924,4,4,0,884371558,884371635,77,100,471,3.5714285714285716
924,4,4,0,884371635,885457858,1086223,471,482,3.9444444444444446
924,4,4,0,885457858,885457922,64,482,701,4.5
924,4,5,1,885457922,885458060,138,701,318,4.5046728971962615
924,5,4,-1,885458060,885458093,33,318,200,3.8157894736842106
924,4,4,0,885458093,885458121,28,200,632,3.9523809523809526
924,4,3,-1,885458121,886065748,607627,632,288,3.5214285714285714
924,3,5,2,886065748,886065785,37,288,195,3.9072164948453607
924,5,4,-1,886065785,886065805,20,195,313,4.323076923076923
924,4,4,0,886065805,886327689,261884,313,153,3.7865168539325844
924,4,3,-1,886327689,886327724,35,153,114,4.3478260869565215
924,3,5,2,886327724,886327748,24,114,923,4.142857142857143
924,5,4,-1,886327748,886327778,30,923,64,4.373737373737374
924,4,4,0,886327778,886327826,48,64,205,3.717391304347826
924,4,2,-2,886327826,886759690,431864,205,1036,3.0
924,2,4,2,886759690,886759691,1,1036,1478,2.7
924,4,4,0,886759691,886759888,197,1478,519,4.291666666666667
924,4,3,-1,886759888,886759965,77,519,402,3.3076923076923075
924,3,3,0,886759965,886759997,32,402,2,3.0851063829787235
924,3,4,1,886759997,886760020,23,2,202,3.730337078651685
924,4,4,0,886760020,889286746,2526726,202,237,3.7315436241610738
924,4,3,-1,889286746,889286765,19,237,277,3.6
924,3,4,1,889286765,889286888,123,277,129,3.744186046511628
929,4,4,0,879640036,879640084,48,12,28,3.923076923076923
929,4,4,0,879640084,879640126,42,28,474,4.172413793103448
929,4,3,-1,879640126,879640184,58,474,136,3.764705882352941
929,3,4,1,879640184,879640225,41,136,429,3.742857142857143
929,4,3,-1,879640225,879640256,31,429,496,4.094594594594595
929,3,3,0,879640256,879640290,34,496,654,4.119047619047619
929,3,5,2,879640290,879640329,39,654,517,3.625
929,5,3,-2,879640329,879640394,65,517,144,3.9545454545454546
929,3,3,0,879640394,880817681,1177287,144,23,3.9047619047619047
929,3,3,0,880817681,880817752,71,23,209,3.8275862068965516
929,3,3,0,880817752,880817753,1,209,435,3.8933333333333335
929,3,3,0,880817753,880817818,65,435,32,3.7222222222222223
929,3,4,1,880817818,880817844,26,32,419,3.8208955223880596
931,4,4,0,891035917,891035946,29,900,347,3.59375
931,4,4,0,891035946,891036003,57,347,690,3.260869565217391
931,4,4,0,891036003,891036026,23,690,306,4.033333333333333
931,4,3,-1,891036026,891036080,54,306,896,3.6666666666666665
931,3,4,1,891036080,891036105,25,896,304,3.5306122448979593
931,4,2,-2,891036105,891036148,43,304,355,2.75
931,2,3,1,891036148,891036247,99,355,678,2.8181818181818183
931,3,4,1,891036247,891036463,216,678,744,3.5714285714285716
931,4,4,0,891036463,891036506,43,744,459,3.875
931,4,4,0,891036506,891036530,24,459,257,3.7154471544715446
931,4,3,-1,891036530,891036552,22,257,137,3.9545454545454546
931,3,4,1,891036552,891036604,52,137,293,3.630434782608696
931,4,3,-1,891036604,891036648,44,293,111,3.5106382978723403
931,3,4,1,891036648,891036673,25,111,297,4.142857142857143
931,4,4,0,891036673,891036696,23,297,508,3.6923076923076925
931,4,3,-1,891036696,891036715,19,508,50,4.306532663316583
931,3,4,1,891036715,891036734,19,50,116,3.6666666666666665
931,4,4,0,891036734,891036755,21,116,255,3.2027027027027026
931,4,4,0,891036755,891036786,31,255,125,3.5555555555555554
931,4,3,-1,891036786,891036849,63,125,546,2.9789473684210526
931,3,3,0,891036849,891036883,34,546,845,3.661290322580645
931,3,4,1,891036883,891036902,19,845,685,3.2666666666666666
931,4,3,-1,891036902,891036974,72,685,476,3.1216216216216215
931,3,3,0,891036974,891037046,72,476,220,3.433333333333333
931,3,3,0,891037046,891037070,24,220,252,2.911392405063291
931,3,4,1,891037070,891037177,107,252,1152,3.4375
931,4,5,1,891037177,891037577,400,1152,315,4.15
917,4,2,-2,882910457,882910604,147,289,879,3.2291666666666665
917,2,2,0,882910604,882910627,23,879,312,3.0
917,2,3,1,882910627,882910888,261,312,1,3.902439024390244
917,3,4,1,882910888,882910971,83,1,246,4.0
917,4,4,0,882910971,882911099,128,246,471,3.5714285714285716
917,4,4,0,882911099,882911122,23,471,285,4.181818181818182
917,4,3,-1,882911122,882911158,36,285,255,3.2027027027027026
917,3,4,1,882911158,882911185,27,255,287,3.4516129032258065
917,4,3,-1,882911185,882911215,30,287,405,3.25
917,3,4,1,882911215,882911390,175,405,25,3.3185840707964602
917,4,1,-3,882911390,882911567,177,25,121,3.521212121212121
917,1,4,3,882911567,882911622,55,121,756,2.6885245901639343
932,4,3,-1,891248856,891248893,37,14,509,3.7058823529411766
932,3,4,1,891248893,891248937,44,509,1266,3.6666666666666665
932,4,4,0,891248937,891248967,30,1266,170,4.242424242424242
932,4,4,0,891248967,891248996,29,170,165,3.9130434782608696
932,4,3,-1,891248996,891249038,42,165,213,3.943396226415094
932,3,4,1,891249038,891249063,25,213,863,3.727272727272727
932,4,4,0,891249063,891249109,46,863,198,4.04
932,4,4,0,891249109,891249146,37,198,510,3.823529411764706
932,4,4,0,891249146,891249196,50,510,30,3.8181818181818183
932,4,2,-2,891249196,891249239,43,30,640,2.75
932,2,3,1,891249239,891249261,22,640,736,4.083333333333333
932,3,4,1,891249261,891249373,112,736,515,4.202898550724638
932,4,5,1,891249373,891249538,165,515,135,3.7974683544303796
932,5,5,0,891249538,891249586,48,135,100,4.0162162162162165
932,5,5,0,891249586,891249621,35,100,615,3.8333333333333335
932,5,5,0,891249621,891249649,28,615,169,4.548387096774194
932,5,5,0,891249649,891249675,26,169,524,4.166666666666667
932,5,4,-1,891249675,891249709,34,524,427,4.2025316455696204
932,4,4,0,891249709,891249710,1,427,502,3.272727272727273
932,4,5,1,891249710,891249736,26,502,136,3.764705882352941
932,5,5,0,891249736,891249794,58,136,208,3.8125
932,5,4,-1,891249794,891249849,55,208,430,4.136363636363637
932,4,5,1,891249849,891249877,28,430,654,4.119047619047619
932,5,4,-1,891249877,891249903,26,654,530,4.125
932,4,4,0,891249903,891249962,59,530,478,4.161290322580645
932,4,5,1,891249962,891249994,32,478,521,3.787878787878788
932,5,4,-1,891249994,891250017,23,521,705,3.7857142857142856
932,4,4,0,891250017,891250060,43,705,494,3.8333333333333335
932,4,4,0,891250060,891250080,20,494,523,4.159090909090909
932,4,5,1,891250080,891250142,62,523,836,4.142857142857143
932,5,4,-1,891250142,891250169,27,836,496,4.094594594594595
932,4,5,1,891250169,891250211,42,496,482,3.9444444444444446
932,5,5,0,891250211,891250258,47,482,209,3.8275862068965516
932,5,5,0,891250258,891250282,24,209,511,4.096153846153846
932,5,5,0,891250282,891250316,34,511,513,4.526315789473684
932,5,2,-3,891250316,891250317,1,513,841,2.772727272727273
932,2,3,1,891250317,891250337,20,841,173,4.1441441441441444
932,3,5,2,891250337,891250363,26,173,498,4.290909090909091
932,5,4,-1,891250363,891250392,29,498,285,4.181818181818182
932,4,5,1,891250392,891250418,26,285,474,4.172413793103448
932,5,5,0,891250418,891250472,54,474,194,4.029411764705882
932,5,4,-1,891250472,891250498,26,194,380,3.4878048780487805
932,4,4,0,891250498,891250525,27,380,131,3.731707317073171
932,4,3,-1,891250525,891250558,33,131,487,4.043478260869565
932,3,5,2,891250558,891250643,85,487,1205,4.0
932,5,5,0,891250643,891250704,61,1205,274,3.5609756097560976
932,5,5,0,891250704,891250770,66,274,659,4.027777777777778
932,5,4,-1,891250770,891250793,23,659,1397,3.6666666666666665
932,4,4,0,891250793,891250816,23,1397,968,3.75
932,4,5,1,891250816,891250862,46,968,1126,3.625
932,5,4,-1,891250862,891250891,29,1126,490,3.5454545454545454
932,4,4,0,891250891,891250943,52,490,1116,3.5714285714285716
932,4,4,0,891250943,891250944,1,1116,459,3.875
932,4,5,1,891250944,891250987,43,459,647,4.142857142857143
932,5,4,-1,891250987,891251014,27,647,180,3.9473684210526314
932,4,4,0,891251014,891251015,1,180,1050,3.6153846153846154
932,4,3,-1,891251015,891251063,48,1050,636,3.4146341463414633
932,3,4,1,891251063,891251105,42,636,428,3.744186046511628
932,4,5,1,891251105,891251153,48,428,616,3.1052631578947367
932,5,5,0,891251153,891251177,24,616,486,3.9565217391304346
932,5,4,-1,891251177,891251178,1,486,570,3.526315789473684
932,4,4,0,891251178,891251199,21,570,649,3.625
932,4,3,-1,891251199,891251225,26,649,151,3.6544117647058822
932,3,4,1,891251225,891251246,21,151,163,3.53125
932,4,4,0,891251246,891251272,26,163,778,3.5925925925925926
932,4,3,-1,891251272,891251292,20,778,226,3.378787878787879
932,3,4,1,891251292,891251395,103,226,709,4.171428571428572
932,4,4,0,891251395,891251463,68,709,566,3.543859649122807
932,4,4,0,891251463,891251485,22,566,222,3.578125
932,4,4,0,891251485,891251506,21,222,663,3.948717948717949
932,4,3,-1,891251506,891251507,1,663,161,3.5844155844155843
932,3,2,-1,891251507,891251562,55,161,1139,2.611111111111111
932,2,2,0,891251562,891251588,26,1139,448,3.466666666666667
932,2,2,0,891251588,891251611,23,448,562,3.2941176470588234
932,2,4,2,891251611,891251647,36,562,167,2.8181818181818183
932,4,3,-1,891251647,891251669,22,167,121,3.521212121212121
932,3,2,-1,891251669,891251696,27,121,38,2.784313725490196
932,2,4,2,891251696,891251738,42,38,676,3.3142857142857145
932,4,4,0,891251738,891251798,60,676,399,3.317073170731707
932,4,2,-2,891251798,891251822,24,399,755,3.085714285714286
932,2,2,0,891251822,891251869,47,755,77,3.3857142857142857
932,2,2,0,891251869,891251891,22,77,109,3.282608695652174
932,2,4,2,891251891,891251959,68,109,414,3.3076923076923075
932,4,4,0,891251959,891251985,26,414,1454,3.0
932,4,2,-2,891251985,891252058,73,1454,665,2.72972972972973
932,2,2,0,891252058,891252140,82,665,148,3.2131147540983607
932,2,2,0,891252140,891252198,58,148,576,3.125
932,2,2,0,891252198,891252260,62,576,1305,2.3333333333333335
932,2,2,0,891252260,891252338,78,1305,105,2.6176470588235294
932,2,2,0,891252338,891252412,74,105,600,2.0
932,2,2,0,891252412,891252504,92,600,441,2.4
909,5,5,0,891919232,891919599,367,300,261,2.7333333333333334
909,5,5,0,891919599,891920089,490,261,224,3.4545454545454546
909,5,5,0,891920089,891920125,36,224,86,3.869565217391304
909,5,4,-1,891920125,891920166,41,86,531,3.7435897435897436
909,4,5,1,891920166,891920211,45,531,509,3.7058823529411766
909,5,5,0,891920211,891920233,22,509,165,3.9130434782608696
909,5,5,0,891920233,891920276,43,165,170,4.242424242424242
909,5,5,0,891920276,891920327,51,170,707,3.909090909090909
909,5,3,-2,891920327,891920763,436,707,682,3.0476190476190474
934,4,4,0,891188403,891188441,38,315,303,3.75
934,4,4,0,891188441,891188580,139,303,902,3.9444444444444446
934,4,4,0,891188580,891188727,147,902,316,4.285714285714286
934,4,5,1,891188727,891189363,636,316,50,4.306532663316583
934,5,4,-1,891189363,891189511,148,50,100,4.0162162162162165
934,4,5,1,891189511,891189566,55,100,13,3.5454545454545454
934,5,4,-1,891189566,891189598,32,13,257,3.7154471544715446
934,4,3,-1,891189598,891189640,42,257,533,3.6
934,3,5,2,891189640,891189819,179,533,405,3.25
934,5,4,-1,891189819,891189879,60,405,237,3.7315436241610738
934,4,5,1,891189879,891189969,90,237,297,4.142857142857143
934,5,4,-1,891189969,891190478,509,297,254,2.7419354838709675
934,4,3,-1,891190478,891190609,131,254,483,4.475609756097561
934,3,5,2,891190609,891190695,86,483,191,4.168674698795181
934,5,4,-1,891190695,891190744,49,191,213,3.943396226415094
934,4,3,-1,891190744,891190813,69,213,156,4.017857142857143
934,3,2,-1,891190813,891190854,41,156,186,3.905263157894737
934,2,2,0,891190854,891190903,49,186,183,3.951219512195122
934,2,4,2,891190903,891190960,57,183,661,4.133333333333334
934,4,2,-2,891190960,891191108,148,661,1065,3.1578947368421053
934,2,5,3,891191108,891191206,98,1065,172,4.225225225225225
934,5,5,0,891191206,891191258,52,172,208,3.8125
934,5,3,-2,891191258,891191334,76,208,527,3.823529411764706
934,3,4,1,891191334,891191365,31,527,435,3.8933333333333335
934,4,4,0,891191365,891191402,37,435,481,3.8421052631578947
934,4,4,0,891191402,891191469,67,481,420,3.5652173913043477
934,4,1,-3,891191469,891191511,42,420,216,3.8454545454545452
934,1,5,4,891191511,891191546,35,216,514,4.033333333333333
934,5,2,-3,891191546,891191600,54,514,179,3.8823529411764706
934,2,3,1,891191600,891191660,60,179,423,3.7016129032258065
934,3,4,1,891191660,891191831,171,423,226,3.378787878787879
934,4,2,-2,891191831,891191875,44,226,234,3.7674418604651163
934,2,5,3,891191875,891191922,47,234,56,4.051724137931035
934,5,5,0,891191922,891191976,54,56,432,3.719298245614035
934,5,5,0,891191976,891192041,65,432,197,4.112676056338028
934,5,4,-1,891192041,891192087,46,197,2,3.0851063829787235
934,4,4,0,891192087,891192236,149,2,193,3.883720930232558
934,4,4,0,891192236,891192285,49,193,630,3.25
934,4,4,0,891192285,891192329,44,630,97,3.7282608695652173
934,4,4,0,891192329,891192444,115,97,204,3.6744186046511627
934,4,3,-1,891192444,891192623,179,204,177,3.875
934,3,4,1,891192623,891192914,291,177,965,3.7142857142857144
934,4,3,-1,891192914,891192965,51,965,173,4.1441441441441444
934,3,5,2,891192965,891193013,48,173,1203,4.0
934,5,4,-1,891193013,891193097,84,1203,550,3.272727272727273
934,4,5,1,891193097,891193132,35,550,202,3.730337078651685
934,5,4,-1,891193132,891193187,55,202,66,3.4705882352941178
934,4,4,0,891193187,891193290,103,66,161,3.5844155844155843
934,4,4,0,891193290,891193331,41,161,163,3.53125
934,4,4,0,891193331,891193778,447,163,228,3.7246376811594204
934,4,4,0,891193778,891194221,443,228,82,3.6741573033707864
934,4,4,0,891194221,891194303,82,82,152,3.6785714285714284
934,4,3,-1,891194303,891194379,76,152,99,3.8392857142857144
934,3,4,1,891194379,891194462,83,99,554,2.9555555555555557
934,4,2,-2,891194462,891194498,36,554,157,3.5714285714285716
934,2,4,2,891194498,891194539,41,157,229,3.185185185185185
934,4,4,0,891194539,891194661,122,229,211,3.958904109589041
934,4,4,0,891194661,891194802,141,211,239,3.423076923076923
934,4,5,1,891194802,891194836,34,239,660,3.71875
934,5,4,-1,891194836,891194900,64,660,449,2.9069767441860463
934,4,4,0,891194900,891195233,333,449,25,3.3185840707964602
934,4,4,0,891195233,891195288,55,25,605,3.3333333333333335
934,4,4,0,891195288,891195437,149,605,703,3.75
934,4,4,0,891195437,891195503,66,703,428,3.744186046511628
934,4,4,0,891195503,891195537,34,428,403,3.298507462686567
934,4,4,0,891195537,891195573,36,403,384,2.7941176470588234
934,4,4,0,891195573,891195604,31,384,495,3.65
934,4,4,0,891195604,891195713,109,495,70,3.5833333333333335
934,4,3,-1,891195713,891195811,98,70,389,3.272727272727273
934,3,3,0,891195811,891195982,171,389,72,3.175438596491228
934,3,3,0,891195982,891196117,135,72,1135,3.0526315789473686
934,3,3,0,891196117,891196314,197,1135,709,4.171428571428572
934,3,4,1,891196314,891196384,70,709,584,3.5238095238095237
934,4,3,-1,891196384,891196516,132,584,1285,3.1
934,3,4,1,891196516,891196564,48,1285,712,3.0434782608695654
934,4,2,-2,891196564,891197375,811,712,225,3.0714285714285716
934,2,3,1,891197375,891197678,303,225,388,2.5833333333333335
934,3,1,-2,891197678,891197851,173,388,1425,2.6
933,5,4,-1,874853634,874853635,1,22,357,4.063291139240507
933,4,3,-1,874853635,874853666,31,357,214,3.272727272727273
933,3,5,2,874853666,874853688,22,214,56,4.051724137931035
933,5,3,-2,874853688,874853755,67,56,160,3.4
933,3,4,1,874853755,874853779,24,160,317,3.774193548387097
933,4,3,-1,874853779,874853846,67,317,735,3.58
933,3,5,2,874853846,874853898,52,735,127,4.162790697674419
933,5,4,-1,874853898,874853957,59,127,89,3.9615384615384617
933,4,4,0,874853957,874853977,20,89,151,3.6544117647058822
933,4,4,0,874853977,874854009,32,151,69,3.8015873015873014
933,4,3,-1,874854009,874854062,53,69,166,4.0
933,3,3,0,874854062,874854081,19,166,651,3.8627450980392157
933,3,3,0,874854081,874854100,19,651,39,3.107142857142857
933,3,4,1,874854100,874854135,35,39,12,4.358974358974359
933,4,2,-2,874854135,874854161,26,12,97,3.7282608695652173
933,2,3,1,874854161,874854190,29,97,159,3.3902439024390243
933,3,3,0,874854190,874854217,27,159,583,3.4285714285714284
933,3,3,0,874854217,874854294,77,583,1,3.902439024390244
933,3,3,0,874854294,874854315,21,1,176,3.967032967032967
933,3,4,1,874854315,874854338,23,176,654,4.119047619047619
933,4,1,-3,874854338,874854383,45,654,21,2.9210526315789473
933,1,3,2,874854383,874854424,41,21,652,3.9642857142857144
933,3,4,1,874854424,874854444,20,652,175,3.8354430379746836
933,4,2,-2,874854444,874854461,17,175,164,3.6140350877192984
933,2,3,1,874854461,874854479,18,164,467,4.071428571428571
933,3,2,-1,874854479,874854589,110,467,25,3.3185840707964602
933,2,4,2,874854589,874854611,22,25,470,3.72
933,4,3,-1,874854611,874854651,40,470,732,3.6266666666666665
933,3,3,0,874854651,874854678,27,732,218,3.5555555555555554
933,3,4,1,874854678,874854723,45,218,87,3.9
933,4,2,-2,874854723,874854745,22,87,202,3.730337078651685
933,2,4,2,874854745,874854762,17,202,746,3.7560975609756095
933,4,1,-3,874854762,874854783,21,746,222,3.578125
933,1,2,1,874854783,874854813,30,222,823,2.75
933,2,4,2,874854813,874854853,40,823,182,3.842857142857143
933,4,2,-2,874854853,874854874,21,182,627,3.3823529411764706
933,2,4,2,874854874,874854932,58,627,196,3.9404761904761907
933,4,2,-2,874854932,874854953,21,196,476,3.1216216216216215
933,2,4,2,874854953,874854994,41,476,177,3.875
933,4,2,-2,874854994,874855020,26,177,70,3.5833333333333335
933,2,3,1,874855020,874855069,49,70,273,3.5238095238095237
933,3,3,0,874855069,874855104,35,273,282,3.610526315789474
933,3,3,0,874855104,874855121,17,282,58,3.543859649122807
933,3,2,-1,874855121,874938309,83188,58,710,3.41025641025641
933,2,1,-1,874938309,874938354,45,710,232,3.0789473684210527
933,1,2,1,874938354,874938371,17,232,393,3.5125
933,2,2,0,874938371,874938389,18,393,154,3.6031746031746033
933,2,3,1,874938389,874938412,23,154,239,3.423076923076923
933,3,1,-2,874938412,874938430,18,239,67,3.106382978723404
933,1,1,0,874938430,874938474,44,67,1188,2.45
933,1,1,0,874938474,874938475,1,1188,94,2.8823529411764706
933,1,2,1,874938475,874938491,16,94,167,2.8181818181818183
933,2,1,-1,874938491,874938507,16,167,451,3.207792207792208
933,1,3,2,874938507,874938538,31,451,72,3.175438596491228
933,3,4,1,874938538,874938563,25,72,186,3.905263157894737
933,4,3,-1,874938563,874938596,33,186,1183,2.5
933,3,2,-1,874938596,874938620,24,1183,1028,2.857142857142857
933,2,1,-1,874938620,874938664,44,1028,110,2.25
933,1,2,1,874938664,874938689,25,110,80,2.967741935483871
933,2,1,-1,874938689,874938705,16,80,577,1.7058823529411764
933,1,1,0,874938705,874938728,23,577,585,2.5384615384615383
933,1,3,2,874938728,874938808,80,585,561,3.1515151515151514
933,3,1,-2,874938808,874938850,42,561,569,2.4285714285714284
933,1,1,0,874938850,874938878,28,569,665,2.72972972972973
933,1,2,1,874938878,874939031,153,665,172,4.225225225225225
933,2,2,0,874939031,874939157,126,172,117,3.689189189189189
933,2,1,-1,874939157,874939185,28,117,550,3.272727272727273
933,1,1,0,874939185,874939230,45,550,578,3.066666666666667
933,1,1,0,874939230,874939247,17,578,1228,2.5
935,4,4,0,884471955,884472039,84,300,181,3.98974358974359
935,4,3,-1,884472039,884472064,25,181,1,3.902439024390244
935,3,3,0,884472064,884472110,46,1,100,4.0162162162162165
935,3,4,1,884472110,884472136,26,100,283,3.901639344262295
935,4,5,1,884472136,884472159,23,283,237,3.7315436241610738
935,5,5,0,884472159,884472177,18,237,15,3.725663716814159
935,5,4,-1,884472177,884472229,52,15,117,3.689189189189189
935,4,4,0,884472229,884472247,18,117,255,3.2027027027027026
935,4,5,1,884472247,884472266,19,255,742,3.5555555555555554
935,5,5,0,884472266,884472310,44,742,281,3.2
935,5,4,-1,884472310,884472392,82,281,924,3.3703703703703702
935,4,3,-1,884472392,884472465,73,924,1048,2.857142857142857
935,3,4,1,884472465,884472539,74,1048,282,3.610526315789474
935,4,4,0,884472539,884472575,36,282,125,3.5555555555555554
935,4,4,0,884472575,884472576,1,125,597,3.2771084337349397
935,4,2,-2,884472576,884472627,51,597,620,3.0
935,2,4,2,884472627,884472673,46,620,284,3.1547619047619047
935,4,4,0,884472673,884472704,31,284,405,3.25
935,4,4,0,884472704,884472743,39,405,546,2.9789473684210526
935,4,4,0,884472743,884472872,129,546,717,2.9696969696969697
935,4,4,0,884472872,884472892,20,717,148,3.2131147540983607
935,4,3,-1,884472892,884472942,50,148,120,2.3421052631578947
938,4,4,0,891355996,891356062,66,260,343,3.0
938,4,4,0,891356062,891356146,84,343,333,3.546666666666667
938,4,5,1,891356146,891356314,168,333,50,4.306532663316583
938,5,5,0,891356314,891356390,76,50,181,3.98974358974359
938,5,5,0,891356390,891356413,23,181,993,3.4838709677419355
938,5,3,-2,891356413,891356428,15,993,676,3.3142857142857145
938,3,5,2,891356428,891356446,18,676,127,4.162790697674419
938,5,3,-2,891356446,891356463,17,127,591,3.7169811320754715
938,3,3,0,891356463,891356500,37,591,148,3.2131147540983607
938,3,3,0,891356500,891356501,1,148,293,3.630434782608696
938,3,3,0,891356501,891356532,31,293,815,3.135135135135135
938,3,2,-1,891356532,891356549,17,815,871,2.3823529411764706
938,2,3,1,891356549,891356572,23,871,276,3.6036036036036037
938,3,4,1,891356572,891356573,1,276,298,3.779220779220779
938,4,2,-2,891356573,891356594,21,298,281,3.2
938,2,3,1,891356594,891356679,85,281,597,3.2771084337349397
938,3,1,-2,891356679,891356702,23,597,477,3.1666666666666665
938,1,3,2,891356702,891356742,40,477,125,3.5555555555555554
938,3,4,1,891356742,891356780,38,125,762,3.3962264150943398
938,4,3,-1,891356780,891356799,19,762,1016,3.559322033898305
938,3,2,-1,891356799,891356827,28,1016,284,3.1547619047619047
938,2,3,1,891356827,891356847,20,284,405,3.25
938,3,5,2,891356847,891356895,48,405,121,3.521212121212121
938,5,2,-3,891356895,891356966,71,121,929,2.8421052631578947
938,2,3,1,891356966,891357019,53,929,756,2.6885245901639343
938,3,3,0,891357019,891357060,41,756,406,2.5294117647058822
938,3,1,-2,891357060,891357085,25,406,829,2.4615384615384617
938,1,3,2,891357085,891357106,21,829,1152,3.4375
938,3,1,-2,891357106,891357137,31,1152,105,2.6176470588235294
938,1,4,3,891357137,891357161,24,105,225,3.0714285714285716
938,4,3,-1,891357161,891357190,29,225,1283,2.9
940,2,3,1,884800944,884800988,44,319,683,2.176470588235294
940,3,1,-2,884800988,884801053,65,683,264,2.65
940,1,3,2,884801053,884801144,91,264,289,2.988888888888889
940,3,2,-1,884801144,884801246,102,289,343,3.0
940,2,4,2,884801246,884801316,70,343,321,3.0172413793103448
940,4,3,-1,884801316,885921243,1119927,321,205,3.717391304347826
940,3,1,-2,885921243,885921371,128,205,1401,3.0
940,1,4,3,885921371,885921400,29,1401,173,4.1441441441441444
940,4,4,0,885921400,885921401,1,173,170,4.242424242424242
940,4,4,0,885921401,885921421,20,170,98,4.240875912408759
940,4,3,-1,885921421,885921422,1,98,183,3.951219512195122
940,3,5,2,885921422,885921451,29,183,427,4.2025316455696204
940,5,4,-1,885921451,885921471,20,427,657,4.341463414634147
940,4,4,0,885921471,885921542,71,657,436,3.5
940,4,4,0,885921542,885921577,35,436,317,3.774193548387097
940,4,4,0,885921577,885921597,20,317,213,3.943396226415094
940,4,4,0,885921597,885921628,31,213,238,3.888888888888889
940,4,4,0,885921628,885921651,23,238,692,3.56
940,4,3,-1,885921651,885921669,18,692,529,4.142857142857143
940,3,3,0,885921669,885921687,18,529,474,4.172413793103448
940,3,3,0,885921687,885921710,23,474,527,3.823529411764706
940,3,2,-1,885921710,885921741,31,527,116,3.6666666666666665
940,2,3,1,885921741,885921758,17,116,47,3.5869565217391304
940,3,5,2,885921758,885921800,42,47,95,3.8194444444444446
940,5,4,-1,885921800,885921828,28,95,89,3.9615384615384617
940,4,4,0,885921828,885921846,18,89,285,4.181818181818182
940,4,3,-1,885921846,885921870,24,285,161,3.5844155844155843
940,3,2,-1,885921870,885921892,22,161,792,3.793103448275862
940,2,3,1,885921892,885921893,1,792,193,3.883720930232558
940,3,2,-1,885921893,885921915,22,193,549,3.4871794871794872
940,2,1,-1,885921915,885921953,38,549,610,3.1818181818181817
940,1,4,3,885921953,885921979,26,610,420,3.5652173913043477
940,4,5,1,885921979,885921980,1,420,855,3.590909090909091
940,5,4,-1,885921980,885922015,35,855,204,3.6744186046511627
940,4,4,0,885922015,885922016,1,204,66,3.4705882352941178
940,4,4,0,885922016,885922040,24,66,82,3.6741573033707864
940,4,5,1,885922040,889480493,3558453,82,354,3.6923076923076925
940,5,3,-2,889480493,889480535,42,354,879,3.2291666666666665
888,4,4,0,879365004,879365054,50,100,644,3.7
888,4,4,0,879365054,879365072,18,644,111,3.5106382978723403
888,4,4,0,879365072,879365086,14,111,869,3.0
888,4,4,0,879365086,879365104,18,869,137,3.9545454545454546
888,4,5,1,879365104,879365154,50,137,514,4.033333333333333
888,5,4,-1,879365154,879365224,70,514,631,3.581818181818182
888,4,3,-1,879365224,879365475,251,631,280,3.103448275862069
925,3,4,1,884633287,884633348,61,245,324,3.2291666666666665
925,4,4,0,884633348,884633349,1,324,325,2.625
925,4,3,-1,884633349,884717478,84129,325,299,3.0
925,3,4,1,884717478,884717586,108,299,682,3.0476190476190474
925,4,3,-1,884717586,884717669,83,682,260,2.4716981132075473
925,3,3,0,884717669,884717790,121,260,678,2.8181818181818183
925,3,1,-2,884717790,884717862,72,678,773,3.1666666666666665
925,1,1,0,884717862,884718099,237,773,558,3.75
925,1,2,1,884718099,884718100,1,558,217,3.1538461538461537
925,2,3,1,884718100,884718156,56,217,567,3.272727272727273
925,3,2,-1,884718156,884718204,48,567,563,2.0
942,4,4,0,891282438,891282477,39,258,303,3.75
942,4,3,-1,891282477,891282503,26,303,328,3.4895833333333335
942,3,5,2,891282503,891282564,61,328,300,3.6861313868613137
942,5,4,-1,891282564,891282618,54,300,316,4.285714285714286
942,4,3,-1,891282618,891282644,26,316,689,3.1538461538461537
942,3,4,1,891282644,891282673,29,689,259,2.492063492063492
942,4,4,0,891282673,891282702,29,259,878,2.0
942,4,5,1,891282702,891282816,114,878,500,4.285714285714286
942,5,4,-1,891282816,891282817,1,500,969,3.8947368421052633
942,4,5,1,891282817,891282840,23,969,528,4.241379310344827
942,5,5,0,891282840,891282880,40,528,99,3.8392857142857144
942,5,5,0,891282880,891282903,23,99,318,4.5046728971962615
942,5,5,0,891282903,891282931,28,318,607,4.136363636363637
942,5,5,0,891282931,891282963,32,607,520,4.136363636363637
942,5,5,0,891282963,891283017,54,520,427,4.2025316455696204
942,5,5,0,891283017,891283043,26,427,496,4.094594594594595
942,5,4,-1,891283043,891283068,25,496,124,4.052631578947368
942,4,5,1,891283068,891283094,26,124,131,3.731707317073171
942,5,5,0,891283094,891283095,1,131,423,3.7016129032258065
942,5,5,0,891283095,891283117,22,423,215,3.662921348314607
942,5,4,-1,891283117,891283118,1,215,479,4.25
942,4,4,0,891283118,891283139,21,479,604,3.8181818181818183
942,4,4,0,891283139,891283161,22,604,234,3.7674418604651163
942,4,3,-1,891283161,891283184,23,234,183,3.951219512195122
942,3,4,1,891283184,891283209,25,183,1204,4.0
942,4,5,1,891283209,891283239,30,1204,97,3.7282608695652173
942,5,4,-1,891283239,891283517,278,97,662,3.4583333333333335
937,4,3,-1,876768813,876768956,143,300,874,3.230769230769231
937,3,2,-1,876768956,876768983,27,874,988,2.5555555555555554
937,2,4,2,876768983,876769080,97,988,14,4.101694915254237
937,4,4,0,876769080,876769213,133,14,847,3.7333333333333334
937,4,5,1,876769213,876769253,40,847,515,4.202898550724638
937,5,4,-1,876769253,876769323,70,515,275,4.087912087912088
937,4,5,1,876769323,876769373,50,275,9,3.8878504672897196
937,5,5,0,876769373,876769374,1,9,50,4.306532663316583
937,5,4,-1,876769374,876769530,156,50,293,3.630434782608696
926,4,3,-1,888351623,888351813,190,315,237,3.7315436241610738
926,3,1,-2,888351813,888636269,284456,237,325,2.625
926,1,2,1,888636269,888636270,1,325,322,3.0476190476190474
943,4,2,-2,875410099,875501756,91657,174,1067,3.533333333333333
943,2,5,3,875501756,875501774,18,1067,127,4.162790697674419
943,5,5,0,875501774,875501795,21,127,508,3.6923076923076925
943,5,4,-1,875501795,875501813,18,508,763,3.347826086956522
943,4,4,0,875501813,875501835,22,763,50,4.306532663316583
943,4,2,-2,875501835,875501856,21,50,412,2.272727272727273
943,2,5,3,875501856,875501889,33,412,475,3.956043956043956
943,5,4,-1,875501889,875501937,48,475,117,3.689189189189189
943,4,3,-1,875501937,875501960,23,117,9,3.8878504672897196
943,3,3,0,875501960,875501995,35,9,124,4.052631578947368
943,3,3,0,875501995,875502074,79,124,274,3.5609756097560976
943,3,2,-1,875502074,875502096,22,274,1028,2.857142857142857
943,2,4,2,875502096,875502116,20,1028,717,2.9696969696969697
943,4,2,-2,875502116,875502146,30,717,1047,2.6923076923076925
943,2,5,3,875502146,875502230,84,1047,282,3.610526315789474
943,5,3,-2,875502230,875502283,53,282,825,2.914285714285714
943,3,4,1,875502283,875502299,16,825,281,3.2
943,4,4,0,875502299,875502483,184,281,824,2.590909090909091
943,4,1,-3,875502483,875502576,93,824,122,2.282608695652174
943,1,2,1,875502576,875502597,21,122,595,2.9166666666666665
943,2,2,0,875502597,888638920,13136323,595,419,3.8208955223880596
943,2,4,2,888638920,888638940,20,419,172,4.225225225225225
943,4,5,1,888638940,888638960,20,172,173,4.1441441441441444
943,5,4,-1,888638960,888639000,40,173,11,3.8904109589041096
943,4,5,1,888639000,888639019,19,11,79,3.956989247311828
943,5,3,-2,888639019,888639042,23,79,568,3.5853658536585367
943,3,5,2,888639042,888639066,24,568,182,3.842857142857143
943,5,3,-2,888639066,888639117,51,182,204,3.6744186046511627
943,3,4,1,888639117,888639147,30,204,210,3.921259842519685
943,4,2,-2,888639147,888639170,23,210,202,3.730337078651685
943,2,5,3,888639170,888639192,22,202,196,3.9404761904761907
943,5,3,-2,888639192,888639231,39,196,423,3.7016129032258065
943,3,5,2,888639231,888639247,16,423,184,3.393939393939394
943,5,4,-1,888639247,888639269,22,184,655,3.7857142857142856
943,4,4,0,888639269,888639308,39,655,385,3.6129032258064515
943,4,2,-2,888639308,888639351,43,385,421,3.462962962962963
943,2,2,0,888639351,888639370,19,421,185,3.9726027397260273
943,2,4,2,888639370,888639388,18,185,200,3.8157894736842106
943,4,4,0,888639388,888639407,19,200,195,3.9072164948453607
943,4,3,-1,888639407,888639427,20,195,625,3.25
943,3,2,-1,888639427,888639445,18,625,97,3.7282608695652173
943,2,5,3,888639445,888639478,33,97,205,3.717391304347826
943,5,4,-1,888639478,888639500,22,205,68,3.5714285714285716
943,4,2,-2,888639500,888639575,75,68,468,3.380952380952381
943,2,3,1,888639575,888639598,23,468,73,3.588235294117647
943,3,5,2,888639598,888639614,16,73,943,3.6666666666666665
943,5,4,-1,888639614,888639638,24,943,559,3.477272727272727
943,4,4,0,888639638,888639679,41,559,367,3.4242424242424243
943,4,2,-2,888639679,888639702,23,367,609,3.7058823529411766
943,2,1,-1,888639702,888639772,70,609,549,3.4871794871794872
943,1,4,3,888639772,888639789,17,549,732,3.6266666666666665
943,4,2,-2,888639789,888639814,25,732,72,3.175438596491228
943,2,1,-1,888639814,888639867,53,72,401,2.6774193548387095
943,1,4,3,888639867,888639868,1,401,808,2.4444444444444446
943,4,1,-3,888639868,888639886,18,808,399,3.317073170731707
943,1,3,2,888639886,888639903,17,399,1044,3.2777777777777777
943,3,4,1,888639903,888639929,26,1044,739,3.391304347826087
943,4,5,1,888639929,888639953,24,739,2,3.0851063829787235
943,5,4,-1,888639953,888639954,1,2,27,3.235294117647059
943,4,4,0,888639954,888639972,18,27,54,3.3714285714285714
943,4,3,-1,888639972,888640003,31,54,62,3.048780487804878
943,3,1,-2,888640003,888640027,24,62,415,2.6666666666666665
943,1,1,0,888640027,888640048,21,415,720,3.2
943,1,3,2,888640048,888640067,19,720,53,2.9523809523809526
943,3,4,1,888640067,888640106,39,53,576,3.125
943,4,5,1,888640106,888640125,19,576,672,2.7222222222222223
943,5,3,-2,888640125,888640143,18,672,794,3.6
943,3,3,0,888640143,888640208,65,794,722,2.9642857142857144
943,3,3,0,888640208,888640227,19,722,765,3.0
943,3,3,0,888640227,888640250,23,765,1188,2.45
943,3,3,0,888640250,888640275,25,1188,373,3.142857142857143
943,3,2,-1,888640275,888640291,16,373,391,2.4285714285714284
943,2,3,1,888640291,888640311,20,391,796,2.923076923076923
943,3,1,-2,888640311,888693158,52847,796,450,2.2758620689655173
939,5,5,0,880260745,880260805,60,9,257,3.7154471544715446
939,5,4,-1,880260805,880260852,47,257,275,4.087912087912088
939,4,4,0,880260852,880260853,1,275,993,3.4838709677419355
939,4,5,1,880260853,880260883,30,993,1190,3.4285714285714284
939,5,5,0,880260883,880260915,32,1190,742,3.5555555555555554
939,5,5,0,880260915,880260956,41,742,222,3.578125
939,5,5,0,880260956,880260994,38,222,591,3.7169811320754715
939,5,5,0,880260994,880261094,100,591,15,3.725663716814159
939,5,5,0,880261094,880261141,47,15,508,3.6923076923076925
939,5,5,0,880261141,880261184,43,508,298,3.779220779220779
939,5,3,-2,880261184,880261185,1,298,252,2.911392405063291
939,3,5,2,880261185,880261254,69,252,471,3.5714285714285716
939,5,5,0,880261254,880261291,37,471,283,3.901639344262295
939,5,5,0,880261291,880261334,43,283,274,3.5609756097560976
939,5,5,0,880261334,880261373,39,274,121,3.521212121212121
939,5,4,-1,880261373,880261450,77,121,405,3.25
939,4,4,0,880261450,880261610,160,405,546,2.9789473684210526
939,4,5,1,880261610,880261658,48,546,220,3.433333333333333
939,5,4,-1,880261658,880261784,126,220,717,2.9696969696969697
939,4,5,1,880261784,880261868,84,717,1028,2.857142857142857
939,5,5,0,880261868,880261974,106,1028,476,3.1216216216216215
939,5,3,-2,880261974,880262019,45,476,106,2.8125
939,3,3,0,880262019,880262057,38,106,818,2.769230769230769
939,3,5,2,880262057,880262090,33,818,1051,3.625
939,5,3,-2,880262090,880262139,49,1051,934,3.0294117647058822
939,3,2,-1,880262139,880262196,57,934,931,2.2758620689655173
939,2,3,1,880262196,880262319,123,931,254,2.7419354838709675
936,5,3,-2,886831415,886831501,86,904,300,3.6861313868613137
936,3,1,-2,886831501,886831535,34,300,898,3.0869565217391304
936,1,3,2,886831535,886831576,41,898,343,3.0
936,3,3,0,886831576,886831637,61,343,995,3.0
936,3,3,0,886831637,886831679,42,995,294,3.1052631578947367
936,3,3,0,886831679,886831709,30,294,259,2.492063492063492
936,3,2,-1,886831709,886831738,29,259,748,3.1043478260869564
936,2,5,3,886831738,886831769,31,748,289,2.988888888888889
936,5,3,-2,886831769,886831820,51,289,323,3.0
936,3,4,1,886831820,886832092,272,323,100,4.0162162162162165
936,4,3,-1,886832092,886832134,42,100,1086,3.857142857142857
936,3,5,2,886832134,886832183,49,1086,1344,5.0
936,5,5,0,886832183,886832222,39,1344,813,4.055555555555555
936,5,4,-1,886832222,886832282,60,813,124,4.052631578947368
936,4,5,1,886832282,886832337,55,124,250,3.4698795180722892
936,5,4,-1,886832337,886832373,36,250,9,3.8878504672897196
936,4,4,0,886832373,886832419,46,9,287,3.4516129032258065
936,4,3,-1,886832419,886832453,34,287,273,3.5238095238095237
936,3,5,2,886832453,886832454,1,273,253,3.5
936,5,3,-2,886832454,886832502,48,253,295,3.769230769230769
936,3,4,1,886832502,886832544,42,295,121,3.521212121212121
936,4,4,0,886832544,886832596,52,121,181,3.98974358974359
936,4,4,0,886832596,886832672,76,181,237,3.7315436241610738
936,4,4,0,886832672,886832713,41,237,117,3.689189189189189
936,4,3,-1,886832713,886832714,1,117,975,3.411764705882353
936,3,4,1,886832714,886832757,43,975,125,3.5555555555555554
936,4,1,-3,886832757,886832758,1,125,628,3.573529411764706
936,1,5,4,886832758,886832808,50,628,249,3.3275862068965516
936,5,3,-2,886832808,886832858,50,249,274,3.5609756097560976
936,3,4,1,886832858,886832903,45,274,818,2.769230769230769
936,4,4,0,886832903,886832904,1,818,1068,3.2
936,4,3,-1,886832904,886832966,62,1068,1016,3.559322033898305
936,3,4,1,886832966,886833006,40,1016,845,3.661290322580645
936,4,4,0,886833006,886833052,46,845,756,2.6885245901639343
936,4,2,-2,886833052,886833053,1,756,405,3.25
936,2,5,3,886833053,886833098,45,405,1008,3.5
936,5,3,-2,886833098,886833099,1,1008,235,3.106382978723404
936,3,2,-1,886833099,886833191,92,235,827,2.4375
936,2,4,2,886833191,886833231,40,827,1009,3.2962962962962963
936,4,4,0,886833231,886833281,50,1009,1323,4.0
936,4,4,0,886833281,886833360,79,1323,864,3.2142857142857144
936,4,3,-1,886833360,886833516,156,864,118,3.2764227642276422
936,3,2,-1,886833516,886833661,145,118,1023,2.5714285714285716
936,2,3,1,886833661,886833707,46,1023,1190,3.4285714285714284
936,3,5,2,886833707,886833794,87,1190,286,3.442857142857143
936,5,5,0,886833794,886833795,1,286,127,4.162790697674419
930,3,3,0,879534165,879534335,170,245,690,3.260869565217391
930,3,2,-1,879534335,879534410,75,690,50,4.306532663316583
930,2,3,1,879534410,879534506,96,50,100,4.0162162162162165
930,3,3,0,879534506,879534525,19,100,1,3.902439024390244
930,3,4,1,879534525,879534550,25,1,275,4.087912087912088
930,4,4,0,879534550,879534667,117,275,282,3.610526315789474
930,4,1,-3,879534667,879534692,25,282,455,3.1702127659574466
930,1,2,1,879534692,879534724,32,455,151,3.6544117647058822
930,2,3,1,879534724,879534803,79,151,117,3.689189189189189
930,3,1,-2,879534803,879534886,83,117,148,3.2131147540983607
930,1,3,2,879534886,879534973,87,148,410,3.0434782608695654
930,3,1,-2,879534973,879535015,42,410,24,3.3728813559322033
930,1,4,3,879535015,879535056,41,24,281,3.2
930,4,3,-1,879535056,879535102,46,281,763,3.347826086956522
930,3,3,0,879535102,879535138,36,763,871,2.3823529411764706
930,3,3,0,879535138,879535207,69,871,107,3.45
930,3,1,-2,879535207,879535272,65,107,411,2.911764705882353
930,1,5,4,879535272,879535392,120,411,116,3.6666666666666665
930,5,4,-1,879535392,879535492,100,116,45,4.130434782608695
930,4,3,-1,879535492,879535513,21,45,174,4.253521126760563
930,3,4,1,879535513,879535544,31,174,283,3.901639344262295
930,4,5,1,879535544,879535573,29,283,113,4.25
930,5,2,-3,879535573,879535609,36,113,705,3.7857142857142856
930,2,4,2,879535609,879535641,32,705,64,4.373737373737374
930,4,4,0,879535641,879535663,22,64,709,4.171428571428572
930,4,2,-2,879535663,879535713,50,709,210,3.921259842519685
930,2,2,0,879535713,879535734,21,210,137,3.9545454545454546
920,3,4,1,884219768,884219953,185,288,1612,4.5
920,4,3,-1,884219953,884219993,40,1612,270,3.7804878048780486
920,3,3,0,884219993,884220058,65,270,292,3.6666666666666665
920,3,4,1,884220058,884220094,36,292,258,3.7547169811320753
920,4,2,-2,884220094,884220131,37,258,245,3.056179775280899
941,4,2,-2,875048532,875048581,49,294,358,2.6551724137931036
941,2,5,3,875048581,875048887,306,358,298,3.779220779220779
941,5,4,-1,875048887,875048952,65,298,257,3.7154471544715446
941,4,5,1,875048952,875048996,44,257,124,4.052631578947368
941,5,4,-1,875048996,875049038,42,124,475,3.956043956043956
941,4,4,0,875049038,875049077,39,475,147,3.3142857142857145
941,4,4,0,875049077,875049144,67,147,15,3.725663716814159
